name,nationality,position,division,opponent,match_date,phase,sets_won,sets_played,points_scored,attack_kills,attack_faults,attack_shots,attack_total,block_kills,block_faults,block_rebounds,block_total,serve_aces,serve_errors,serve_attempts,serve_total,rec_excellents,rec_faults,rec_attempts,rec_total,dig_excellents,dig_faults,dig_attempts,dig_total,set_excellents,set_faults,set_stills,set_total
Matias SANCHEZ,Argentina,Setter,Men,United States,2022-07-10,Pool,2,5,0,0,0,0,0,0,0,0,0,0,1,3,4,0,0,0,0,0,0,0,0,2,0,1,3
Joaquin GALLEGO,Argentina,Middle Blocker,Men,United States,2022-07-10,Pool,2,5,11,8,0,4,12,3,7,4,14,0,1,12,13,1,1,2,4,1,2,2,5,0,0,2,2
Agustin LOSER,Argentina,Middle Blocker,Men,United States,2022-07-10,Pool,2,5,11,9,3,7,19,2,7,3,12,0,3,16,19,0,0,1,1,4,1,3,8,0,0,0,0
Santiago DANANI,Argentina,Libero,Men,United States,2022-07-10,Pool,2,5,0,0,0,0,0,0,0,0,0,0,0,0,0,11,1,9,21,12,4,2,18,0,0,6,6
Nicolás LAZO,Argentina,Outside Hitter,Men,United States,2022-07-10,Pool,2,5,0,0,0,0,0,0,0,0,0,0,0,0,0,0,0,0,0,0,0,0,0,0,0,0,0
Manuel ARMOA,Argentina,Outside Hitter,Men,United States,2022-07-10,Pool,2,5,4,4,2,4,10,0,1,0,1,0,1,2,3,4,0,5,9,1,1,1,3,0,0,2,2
Bruno LIMA,Argentina,Opposite Spiker,Men,United States,2022-07-10,Pool,2,5,0,0,0,0,0,0,0,0,0,0,0,0,0,0,0,0,0,0,0,0,0,0,0,0,0
Ezequiel PALACIOS,Argentina,Outside Hitter,Men,United States,2022-07-10,Pool,2,5,16,16,6,14,36,0,6,2,8,0,5,11,16,3,0,16,19,4,4,2,10,1,0,2,3
Luciano DE CECCO,Argentina,Setter,Men,United States,2022-07-10,Pool,2,5,3,0,1,2,3,2,5,5,12,1,3,19,23,0,0,0,0,3,0,2,5,55,1,53,109
Luciano PALONSKY,Argentina,Outside Hitter,Men,United States,2022-07-10,Pool,2,5,24,24,3,10,37,0,4,2,6,0,5,9,14,2,0,7,9,6,3,1,10,0,0,1,1
Luciano VICENTIN,Argentina,Outside Hitter,Men,United States,2022-07-10,Pool,2,5,6,5,3,8,16,0,1,0,1,1,5,7,13,8,1,20,29,4,2,0,6,0,0,4,4
Martin RAMOS,Argentina,Middle Blocker,Men,United States,2022-07-10,Pool,2,5,0,0,0,0,0,0,0,0,0,0,0,0,0,0,0,0,0,1,0,0,1,0,0,0,0
Franco MASSIMINO,Argentina,Libero,Men,United States,2022-07-10,Pool,2,5,0,0,0,0,0,0,0,0,0,0,0,0,0,0,0,0,0,0,0,0,0,0,0,0,0
Nicolas ZERBA,Argentina,Middle Blocker,Men,United States,2022-07-10,Pool,2,5,0,0,0,0,0,0,0,0,0,0,0,0,0,0,0,0,0,0,0,0,0,0,0,0,0
Matias SANCHEZ,Argentina,Setter,Men,France,2022-07-09,Pool,3,4,0,0,0,0,0,0,0,0,0,0,0,3,3,0,0,0,0,0,0,0,0,1,0,1,2
Joaquin GALLEGO,Argentina,Middle Blocker,Men,France,2022-07-09,Pool,3,4,6,5,1,4,10,1,2,4,7,0,2,5,7,0,0,1,1,2,0,1,3,0,0,1,1
Agustin LOSER,Argentina,Middle Blocker,Men,France,2022-07-09,Pool,3,4,12,10,0,3,13,1,6,5,12,1,5,10,16,1,0,1,2,1,1,0,2,0,0,4,4
Santiago DANANI,Argentina,Libero,Men,France,2022-07-09,Pool,3,4,0,0,0,0,0,0,0,0,0,0,0,0,0,3,0,13,16,8,6,3,17,0,0,8,8
Nicolás LAZO,Argentina,Outside Hitter,Men,France,2022-07-09,Pool,3,4,0,0,0,0,0,0,0,0,0,0,0,0,0,0,0,0,0,0,0,0,0,0,0,0,0
Manuel ARMOA,Argentina,Outside Hitter,Men,France,2022-07-09,Pool,3,4,0,0,0,1,1,0,0,0,0,0,0,0,0,0,0,0,0,0,0,0,0,0,0,2,2
Bruno LIMA,Argentina,Opposite Spiker,Men,France,2022-07-09,Pool,3,4,0,0,0,0,0,0,0,0,0,0,0,1,1,0,0,0,0,0,0,0,0,0,0,0,0
Ezequiel PALACIOS,Argentina,Outside Hitter,Men,France,2022-07-09,Pool,3,4,17,15,3,11,29,1,3,9,13,1,6,8,15,3,2,15,20,10,2,4,16,0,0,2,2
Luciano DE CECCO,Argentina,Setter,Men,France,2022-07-09,Pool,3,4,2,2,1,1,4,0,2,2,4,0,3,9,12,0,0,0,0,4,3,2,9,28,0,60,88
Luciano PALONSKY,Argentina,Outside Hitter,Men,France,2022-07-09,Pool,3,4,14,12,2,11,25,1,1,1,3,1,3,10,14,0,0,1,1,10,2,0,12,0,0,1,1
Luciano VICENTIN,Argentina,Outside Hitter,Men,France,2022-07-09,Pool,3,4,17,15,5,11,31,0,4,5,9,2,6,12,20,6,1,21,28,8,1,2,11,0,1,5,6
Martin RAMOS,Argentina,Middle Blocker,Men,France,2022-07-09,Pool,3,4,3,3,0,1,4,0,1,0,1,0,0,9,9,0,0,0,0,1,0,1,2,0,0,1,1
Franco MASSIMINO,Argentina,Libero,Men,France,2022-07-09,Pool,3,4,0,0,0,0,0,0,0,0,0,0,0,0,0,0,0,0,0,1,0,0,1,0,0,0,0
Nicolas ZERBA,Argentina,Middle Blocker,Men,France,2022-07-09,Pool,3,4,0,0,0,0,0,0,0,0,0,0,0,0,0,0,0,0,0,0,0,0,0,0,0,0,0
Matias SANCHEZ,Argentina,Setter,Men,Australia,2022-07-08,Pool,3,4,0,0,0,0,0,0,0,0,0,0,0,0,0,0,0,0,0,0,0,0,0,0,0,0,0
Joaquin GALLEGO,Argentina,Middle Blocker,Men,Australia,2022-07-08,Pool,3,4,15,10,0,7,17,5,3,5,13,0,1,16,17,0,0,0,0,1,2,0,3,0,0,0,0
Agustin LOSER,Argentina,Middle Blocker,Men,Australia,2022-07-08,Pool,3,4,7,5,2,1,8,2,2,2,6,0,2,4,6,0,0,0,0,2,0,0,2,0,0,0,0
Santiago DANANI,Argentina,Libero,Men,Australia,2022-07-08,Pool,3,4,0,0,0,0,0,0,0,0,0,0,0,0,0,13,0,2,15,10,1,1,12,0,0,6,6
Nicolás LAZO,Argentina,Outside Hitter,Men,Australia,2022-07-08,Pool,3,4,0,0,0,0,0,0,0,0,0,0,0,0,0,0,0,0,0,0,0,0,0,0,0,0,0
Manuel ARMOA,Argentina,Outside Hitter,Men,Australia,2022-07-08,Pool,3,4,2,2,3,4,9,0,0,0,0,0,0,3,3,3,0,5,8,1,0,1,2,0,0,0,0
Bruno LIMA,Argentina,Opposite Spiker,Men,Australia,2022-07-08,Pool,3,4,19,16,5,3,24,0,6,3,9,3,3,10,16,0,0,0,0,6,5,1,12,1,0,0,1
Ezequiel PALACIOS,Argentina,Outside Hitter,Men,Australia,2022-07-08,Pool,3,4,12,10,3,3,16,1,2,0,3,1,3,8,12,7,2,15,24,6,2,4,12,0,0,1,1
Luciano DE CECCO,Argentina,Setter,Men,Australia,2022-07-08,Pool,3,4,3,0,0,1,1,0,3,2,5,3,1,12,16,0,0,1,1,3,5,3,11,46,0,42,88
Luciano PALONSKY,Argentina,Outside Hitter,Men,Australia,2022-07-08,Pool,3,4,1,1,2,2,5,0,0,0,0,0,1,2,3,2,1,4,7,0,1,0,1,0,0,0,0
Luciano VICENTIN,Argentina,Outside Hitter,Men,Australia,2022-07-08,Pool,3,4,8,7,4,4,15,1,0,0,1,0,2,11,13,8,0,5,13,5,0,1,6,0,0,2,2
Martin RAMOS,Argentina,Middle Blocker,Men,Australia,2022-07-08,Pool,3,4,7,3,0,4,7,3,1,3,7,1,1,7,9,0,0,0,0,0,1,0,1,1,0,1,2
Franco MASSIMINO,Argentina,Libero,Men,Australia,2022-07-08,Pool,3,4,0,0,0,0,0,0,0,0,0,0,0,0,0,0,0,0,0,0,0,0,0,0,0,0,0
Nicolas ZERBA,Argentina,Middle Blocker,Men,Australia,2022-07-08,Pool,3,4,0,0,0,0,0,0,0,0,0,0,0,0,0,0,0,0,0,0,0,0,0,0,0,0,0
Matias SANCHEZ,Argentina,Setter,Men,Canada,2022-07-05,Pool,3,4,0,0,0,0,0,0,0,0,0,0,0,0,0,0,0,0,0,0,0,0,0,0,0,7,7
Joaquin GALLEGO,Argentina,Middle Blocker,Men,Canada,2022-07-05,Pool,3,4,0,0,0,0,0,0,0,0,0,0,0,0,0,0,0,0,0,0,0,0,0,0,0,0,0
Agustin LOSER,Argentina,Middle Blocker,Men,Canada,2022-07-05,Pool,3,4,12,11,2,6,19,1,4,1,6,0,4,14,18,1,0,1,2,0,0,1,1,0,1,0,1
Santiago DANANI,Argentina,Libero,Men,Canada,2022-07-05,Pool,3,4,0,0,0,0,0,0,0,0,0,0,0,0,0,7,0,6,13,5,7,2,14,0,0,3,3
Nicolás LAZO,Argentina,Outside Hitter,Men,Canada,2022-07-05,Pool,3,4,0,0,0,0,0,0,0,0,0,0,1,1,2,0,0,0,0,0,0,0,0,0,0,0,0
Manuel ARMOA,Argentina,Outside Hitter,Men,Canada,2022-07-05,Pool,3,4,1,1,1,1,3,0,0,0,0,0,0,0,0,0,0,0,0,0,0,0,0,0,0,0,0
Bruno LIMA,Argentina,Opposite Spiker,Men,Canada,2022-07-05,Pool,3,4,3,2,5,2,9,1,1,0,2,0,3,4,7,0,0,0,0,2,0,0,2,0,0,0,0
Ezequiel PALACIOS,Argentina,Outside Hitter,Men,Canada,2022-07-05,Pool,3,4,18,15,1,15,31,2,3,8,13,1,5,7,13,5,1,26,32,7,2,0,9,0,0,2,2
Luciano DE CECCO,Argentina,Setter,Men,Canada,2022-07-05,Pool,3,4,2,0,0,0,0,1,2,3,6,1,4,14,19,0,0,0,0,5,0,0,5,28,0,63,91
Luciano PALONSKY,Argentina,Outside Hitter,Men,Canada,2022-07-05,Pool,3,4,13,13,2,11,26,0,2,2,4,0,1,12,13,3,1,7,11,6,1,2,9,0,0,2,2
Luciano VICENTIN,Argentina,Outside Hitter,Men,Canada,2022-07-05,Pool,3,4,2,2,1,4,7,0,0,1,1,0,1,7,8,4,1,7,12,5,1,0,6,0,0,2,2
Martin RAMOS,Argentina,Middle Blocker,Men,Canada,2022-07-05,Pool,3,4,0,0,0,0,0,0,0,0,0,0,0,0,0,0,0,0,0,0,0,0,0,0,0,0,0
Franco MASSIMINO,Argentina,Libero,Men,Canada,2022-07-05,Pool,3,4,0,0,0,0,0,0,0,0,0,0,0,0,0,0,0,0,0,0,0,0,0,0,0,0,0
Nicolas ZERBA,Argentina,Middle Blocker,Men,Canada,2022-07-05,Pool,3,4,10,6,1,5,12,2,9,8,19,2,1,14,17,0,0,0,0,1,0,2,3,0,0,1,1
Matias SANCHEZ,Argentina,Setter,Men,Netherlands,2022-06-25,Pool,2,5,1,1,0,1,2,0,3,7,10,0,1,14,15,0,1,1,2,4,7,4,15,35,0,59,94
Joaquin GALLEGO,Argentina,Middle Blocker,Men,Netherlands,2022-06-25,Pool,2,5,0,0,0,0,0,0,0,0,0,0,0,0,0,0,0,0,0,0,0,0,0,0,0,0,0
Agustin LOSER,Argentina,Middle Blocker,Men,Netherlands,2022-06-25,Pool,2,5,16,10,1,4,15,6,7,6,19,0,4,10,14,1,0,5,6,1,1,0,2,0,0,1,1
Santiago DANANI,Argentina,Libero,Men,Netherlands,2022-06-25,Pool,2,5,0,0,0,0,0,0,0,0,0,0,0,0,0,8,2,6,16,12,7,0,19,0,0,3,3
Nicolás LAZO,Argentina,Outside Hitter,Men,Netherlands,2022-06-25,Pool,2,5,0,0,0,0,0,0,0,0,0,0,0,2,2,0,0,0,0,1,0,0,1,0,0,0,0
Manuel ARMOA,Argentina,Outside Hitter,Men,Netherlands,2022-06-25,Pool,2,5,0,0,0,0,0,0,0,0,0,0,0,0,0,0,0,0,0,0,0,0,0,0,0,0,0
Bruno LIMA,Argentina,Opposite Spiker,Men,Netherlands,2022-06-25,Pool,2,5,21,19,3,9,31,1,7,2,10,1,6,12,19,0,1,0,1,6,2,1,9,0,0,0,0
Ezequiel PALACIOS,Argentina,Outside Hitter,Men,Netherlands,2022-06-25,Pool,2,5,19,15,2,10,27,1,2,5,8,3,5,11,19,11,2,13,26,2,4,0,6,0,0,3,3
Luciano PALONSKY,Argentina,Outside Hitter,Men,Netherlands,2022-06-25,Pool,2,5,0,0,0,0,0,0,0,0,0,0,0,0,0,0,0,0,0,0,0,0,0,0,0,0,0
Luciano VICENTIN,Argentina,Outside Hitter,Men,Netherlands,2022-06-25,Pool,2,5,14,11,7,7,25,3,7,3,13,0,2,15,17,8,2,24,34,5,2,2,9,0,0,1,1
Martin RAMOS,Argentina,Middle Blocker,Men,Netherlands,2022-06-25,Pool,2,5,0,0,0,0,0,0,0,0,0,0,0,0,0,0,0,0,0,0,0,0,0,0,0,0,0
Franco MASSIMINO,Argentina,Libero,Men,Netherlands,2022-06-25,Pool,2,5,0,0,0,0,0,0,0,0,0,0,0,0,0,0,0,0,0,0,0,0,0,0,0,0,0
Nicolas ZERBA,Argentina,Middle Blocker,Men,Netherlands,2022-06-25,Pool,2,5,6,6,1,3,10,0,3,6,9,0,0,19,19,0,0,0,0,2,1,1,4,1,0,0,1
Matias GIRAUDO,Argentina,Setter,Men,Netherlands,2022-06-25,Pool,2,5,0,0,1,0,1,0,0,0,0,0,0,1,1,0,0,0,0,0,0,0,0,0,0,4,4
Matias SANCHEZ,Argentina,Setter,Men,China,2022-06-24,Pool,3,4,1,1,0,0,1,0,1,1,2,0,0,17,17,0,0,0,0,6,1,1,8,36,0,41,77
Joaquin GALLEGO,Argentina,Middle Blocker,Men,China,2022-06-24,Pool,3,4,0,0,0,0,0,0,0,0,0,0,0,0,0,0,0,0,0,0,0,0,0,0,0,0,0
Agustin LOSER,Argentina,Middle Blocker,Men,China,2022-06-24,Pool,3,4,13,12,1,5,18,1,8,3,12,0,4,13,17,1,0,0,1,2,0,1,3,0,0,2,2
Santiago DANANI,Argentina,Libero,Men,China,2022-06-24,Pool,3,4,0,0,0,0,0,0,0,0,0,0,0,0,0,12,0,12,24,11,3,1,15,1,0,9,10
Nicolás LAZO,Argentina,Outside Hitter,Men,China,2022-06-24,Pool,3,4,0,0,0,0,0,0,0,0,0,0,0,0,0,0,0,0,0,0,0,0,0,0,0,0,0
Manuel ARMOA,Argentina,Outside Hitter,Men,China,2022-06-24,Pool,3,4,0,0,0,0,0,0,0,0,0,0,0,0,0,0,0,0,0,0,0,0,0,0,0,0,0
Bruno LIMA,Argentina,Opposite Spiker,Men,China,2022-06-24,Pool,3,4,25,20,1,8,29,3,3,2,8,2,4,15,21,0,0,0,0,5,5,0,10,0,1,0,1
Ezequiel PALACIOS,Argentina,Outside Hitter,Men,China,2022-06-24,Pool,3,4,13,12,2,8,22,0,5,1,6,1,5,8,14,8,1,28,37,6,1,2,9,0,0,2,2
Luciano PALONSKY,Argentina,Outside Hitter,Men,China,2022-06-24,Pool,3,4,0,0,0,0,0,0,0,0,0,0,0,0,0,0,0,0,0,0,0,0,0,0,0,0,0
Luciano VICENTIN,Argentina,Outside Hitter,Men,China,2022-06-24,Pool,3,4,11,10,6,5,21,1,3,2,6,0,5,10,15,3,1,8,12,4,4,1,9,0,0,2,2
Martin RAMOS,Argentina,Middle Blocker,Men,China,2022-06-24,Pool,3,4,5,4,2,1,7,1,5,7,13,0,3,6,9,0,0,0,0,0,1,2,3,0,0,0,0
Franco MASSIMINO,Argentina,Libero,Men,China,2022-06-24,Pool,3,4,0,0,0,0,0,0,0,0,0,0,0,0,0,0,0,0,0,0,0,0,0,0,0,0,0
Nicolas ZERBA,Argentina,Middle Blocker,Men,China,2022-06-24,Pool,3,4,1,1,1,2,4,0,0,2,2,0,0,3,3,0,0,0,0,1,0,0,1,0,0,0,0
Matias GIRAUDO,Argentina,Setter,Men,China,2022-06-24,Pool,3,4,1,1,0,0,1,0,0,0,0,0,0,0,0,0,0,0,0,0,0,0,0,0,0,7,7
Matias SANCHEZ,Argentina,Setter,Men,Slovenia,2022-06-23,Pool,1,4,2,1,1,0,2,1,1,1,3,0,2,6,8,0,0,0,0,7,2,0,9,25,0,42,67
Joaquin GALLEGO,Argentina,Middle Blocker,Men,Slovenia,2022-06-23,Pool,1,4,0,0,0,0,0,0,0,0,0,0,0,0,0,0,0,0,0,0,0,0,0,0,0,0,0
Agustin LOSER,Argentina,Middle Blocker,Men,Slovenia,2022-06-23,Pool,1,4,12,6,2,7,15,5,5,4,14,1,4,9,14,2,0,0,2,3,0,1,4,0,0,1,1
Santiago DANANI,Argentina,Libero,Men,Slovenia,2022-06-23,Pool,1,4,0,0,0,0,0,0,0,0,0,0,0,0,0,7,1,8,16,12,10,1,23,1,1,7,9
Nicolás LAZO,Argentina,Outside Hitter,Men,Slovenia,2022-06-23,Pool,1,4,0,0,0,0,0,0,0,0,0,0,0,1,1,0,0,0,0,0,0,0,0,0,0,0,0
Manuel ARMOA,Argentina,Outside Hitter,Men,Slovenia,2022-06-23,Pool,1,4,3,2,3,3,8,1,0,1,2,0,0,4,4,1,1,4,6,2,1,0,3,0,0,0,0
Bruno LIMA,Argentina,Opposite Spiker,Men,Slovenia,2022-06-23,Pool,1,4,12,11,5,13,29,0,2,2,4,1,5,7,13,2,0,3,5,6,0,1,7,0,0,0,0
Ezequiel PALACIOS,Argentina,Outside Hitter,Men,Slovenia,2022-06-23,Pool,1,4,12,11,3,10,24,1,4,4,9,0,4,10,14,9,3,16,28,6,3,1,10,0,0,3,3
Luciano PALONSKY,Argentina,Outside Hitter,Men,Slovenia,2022-06-23,Pool,1,4,0,0,1,2,3,0,0,0,0,0,1,0,1,0,0,0,0,1,0,0,1,0,0,0,0
Luciano VICENTIN,Argentina,Outside Hitter,Men,Slovenia,2022-06-23,Pool,1,4,13,10,7,14,31,1,1,3,5,2,2,11,15,7,1,20,28,4,1,0,5,0,0,2,2
Martin RAMOS,Argentina,Middle Blocker,Men,Slovenia,2022-06-23,Pool,1,4,1,1,0,1,2,0,0,2,2,0,0,6,6,0,0,0,0,0,1,0,1,0,0,0,0
Franco MASSIMINO,Argentina,Libero,Men,Slovenia,2022-06-23,Pool,1,4,0,0,0,0,0,0,0,0,0,0,0,0,0,0,0,0,0,0,0,0,0,0,0,0,0
Nicolas ZERBA,Argentina,Middle Blocker,Men,Slovenia,2022-06-23,Pool,1,4,5,4,2,2,8,1,6,4,11,0,1,3,4,0,0,1,1,0,0,0,0,0,0,0,0
Matias GIRAUDO,Argentina,Setter,Men,Slovenia,2022-06-23,Pool,1,4,1,1,0,0,1,0,0,1,1,0,0,4,4,0,0,0,0,3,0,0,3,6,0,31,37
Matias SANCHEZ,Argentina,Setter,Men,Japan,2022-06-21,Pool,1,4,1,1,0,0,1,0,1,0,1,0,2,13,15,0,0,1,1,4,0,1,5,25,0,44,69
Joaquin GALLEGO,Argentina,Middle Blocker,Men,Japan,2022-06-21,Pool,1,4,1,0,2,2,4,1,3,3,7,0,0,4,4,0,0,0,0,1,0,0,1,0,0,0,0
Agustin LOSER,Argentina,Middle Blocker,Men,Japan,2022-06-21,Pool,1,4,11,8,1,3,12,3,7,10,20,0,3,11,14,1,0,2,3,3,2,2,7,0,0,1,1
Santiago DANANI,Argentina,Libero,Men,Japan,2022-06-21,Pool,1,4,0,0,0,0,0,0,0,0,0,0,0,0,0,4,2,10,16,12,3,0,15,0,0,2,2
Nicolás LAZO,Argentina,Outside Hitter,Men,Japan,2022-06-21,Pool,1,4,8,7,2,6,15,0,2,1,3,1,3,14,18,7,0,11,18,1,3,0,4,0,0,5,5
Manuel ARMOA,Argentina,Outside Hitter,Men,Japan,2022-06-21,Pool,1,4,0,0,0,0,0,0,0,0,0,0,0,0,0,0,0,0,0,0,0,0,0,0,0,0,0
Bruno LIMA,Argentina,Opposite Spiker,Men,Japan,2022-06-21,Pool,1,4,18,17,4,9,30,1,2,0,3,0,7,6,13,0,1,1,2,3,1,0,4,0,0,0,0
Ezequiel PALACIOS,Argentina,Outside Hitter,Men,Japan,2022-06-21,Pool,1,4,13,13,2,8,23,0,4,7,11,0,0,12,12,9,6,14,29,4,2,2,8,0,0,1,1
Luciano PALONSKY,Argentina,Outside Hitter,Men,Japan,2022-06-21,Pool,1,4,0,0,0,0,0,0,0,0,0,0,1,0,1,0,0,0,0,0,0,0,0,0,0,0,0
Luciano VICENTIN,Argentina,Outside Hitter,Men,Japan,2022-06-21,Pool,1,4,3,3,0,2,5,0,0,0,0,0,0,1,1,0,0,3,3,1,0,0,1,0,0,0,0
Martin RAMOS,Argentina,Middle Blocker,Men,Japan,2022-06-21,Pool,1,4,0,0,0,0,0,0,0,0,0,0,0,0,0,0,0,0,0,0,0,0,0,0,0,0,0
Franco MASSIMINO,Argentina,Libero,Men,Japan,2022-06-21,Pool,1,4,0,0,0,0,0,0,0,0,0,0,0,0,0,0,0,0,0,0,0,0,0,0,0,0,0
Nicolas ZERBA,Argentina,Middle Blocker,Men,Japan,2022-06-21,Pool,1,4,0,0,0,2,2,0,2,6,8,0,1,5,6,0,0,1,1,1,0,0,1,0,0,0,0
Matias GIRAUDO,Argentina,Setter,Men,Japan,2022-06-21,Pool,1,4,0,0,0,0,0,0,0,0,0,0,1,0,1,0,0,0,0,0,0,0,0,3,0,8,11
Matias SANCHEZ,Argentina,Setter,Men,Italy,2022-06-12,Pool,1,4,0,0,0,1,1,0,4,0,4,0,1,9,10,0,0,0,0,7,0,4,11,47,0,30,77
Joaquin GALLEGO,Argentina,Middle Blocker,Men,Italy,2022-06-12,Pool,1,4,8,3,0,2,5,5,3,1,9,0,3,10,13,1,0,1,2,1,0,2,3,0,0,0,0
Agustin LOSER,Argentina,Middle Blocker,Men,Italy,2022-06-12,Pool,1,4,16,12,2,7,21,2,7,9,18,2,6,14,22,1,0,3,4,4,0,4,8,0,0,2,2
Santiago DANANI,Argentina,Libero,Men,Italy,2022-06-12,Pool,1,4,0,0,0,0,0,0,0,0,0,0,0,0,0,6,1,13,20,11,5,6,22,0,0,5,5
Nicolás LAZO,Argentina,Outside Hitter,Men,Italy,2022-06-12,Pool,1,4,3,3,0,4,7,0,0,2,2,0,1,5,6,0,0,4,4,2,1,2,5,0,0,2,2
Manuel ARMOA,Argentina,Outside Hitter,Men,Italy,2022-06-12,Pool,1,4,2,1,4,3,8,1,0,0,1,0,0,2,2,3,1,3,7,0,2,0,2,0,0,1,1
Bruno LIMA,Argentina,Opposite Spiker,Men,Italy,2022-06-12,Pool,1,4,18,17,6,11,34,1,7,4,12,0,5,9,14,0,2,2,4,2,1,6,9,0,0,2,2
Ezequiel PALACIOS,Argentina,Outside Hitter,Men,Italy,2022-06-12,Pool,1,4,7,7,0,7,14,0,5,4,9,0,3,11,14,0,0,10,10,7,1,3,11,1,0,3,4
Luciano PALONSKY,Argentina,Outside Hitter,Men,Italy,2022-06-12,Pool,1,4,8,8,6,11,25,0,2,3,5,0,1,7,8,1,3,16,20,2,1,2,5,0,0,4,4
Luciano VICENTIN,Argentina,Outside Hitter,Men,Italy,2022-06-12,Pool,1,4,0,0,0,0,0,0,0,0,0,0,0,0,0,0,0,0,0,0,0,0,0,0,0,0,0
Martin RAMOS,Argentina,Middle Blocker,Men,Italy,2022-06-12,Pool,1,4,0,0,0,0,0,0,0,0,0,0,0,0,0,0,0,0,0,0,0,0,0,0,0,0,0
Franco MASSIMINO,Argentina,Libero,Men,Italy,2022-06-12,Pool,1,4,0,0,0,0,0,0,0,0,0,0,0,0,0,0,0,0,0,0,0,0,0,0,0,0,0
Nicolas ZERBA,Argentina,Middle Blocker,Men,Italy,2022-06-12,Pool,1,4,0,0,2,1,3,0,0,1,1,0,0,2,2,0,0,2,2,0,0,0,0,0,0,0,0
Matias GIRAUDO,Argentina,Setter,Men,Italy,2022-06-12,Pool,1,4,0,0,0,0,0,0,1,0,1,0,1,3,4,0,0,0,0,1,2,2,5,11,0,5,16
Matias SANCHEZ,Argentina,Setter,Men,Serbia,2022-06-10,Pool,2,5,1,0,1,0,1,1,0,0,1,0,0,4,4,0,0,0,0,3,0,0,3,27,0,19,46
Joaquin GALLEGO,Argentina,Middle Blocker,Men,Serbia,2022-06-10,Pool,2,5,0,0,0,0,0,0,0,0,0,0,0,0,0,0,0,0,0,0,0,0,0,0,0,0,0
Agustin LOSER,Argentina,Middle Blocker,Men,Serbia,2022-06-10,Pool,2,5,0,0,0,0,0,0,0,0,0,0,0,0,0,0,0,0,0,0,0,0,0,0,0,0,0
Santiago DANANI,Argentina,Libero,Men,Serbia,2022-06-10,Pool,2,5,0,0,0,0,0,0,0,0,0,0,0,0,0,3,0,19,22,6,1,4,11,0,0,4,4
Nicolás LAZO,Argentina,Outside Hitter,Men,Serbia,2022-06-10,Pool,2,5,1,1,0,0,1,0,0,0,0,0,0,2,2,1,3,3,7,0,0,0,0,0,0,1,1
Manuel ARMOA,Argentina,Outside Hitter,Men,Serbia,2022-06-10,Pool,2,5,13,8,5,8,21,3,3,1,7,2,2,9,13,5,0,15,20,1,1,2,4,1,0,3,4
Bruno LIMA,Argentina,Opposite Spiker,Men,Serbia,2022-06-10,Pool,2,5,15,11,7,12,30,2,2,2,6,2,4,6,12,1,0,0,1,3,4,1,8,0,0,1,1
Ezequiel PALACIOS,Argentina,Outside Hitter,Men,Serbia,2022-06-10,Pool,2,5,2,2,2,2,6,0,2,2,4,0,2,1,3,3,1,9,13,1,0,3,4,0,0,0,0
Luciano PALONSKY,Argentina,Outside Hitter,Men,Serbia,2022-06-10,Pool,2,5,18,18,3,11,32,0,5,2,7,0,6,9,15,4,2,13,19,2,3,2,7,0,0,4,4
Luciano VICENTIN,Argentina,Outside Hitter,Men,Serbia,2022-06-10,Pool,2,5,0,0,1,0,1,0,0,0,0,0,0,1,1,0,0,0,0,0,0,0,0,0,0,0,0
Martin RAMOS,Argentina,Middle Blocker,Men,Serbia,2022-06-10,Pool,2,5,8,7,2,6,15,1,3,6,10,0,1,11,12,0,0,3,3,3,1,2,6,0,0,3,3
Franco MASSIMINO,Argentina,Libero,Men,Serbia,2022-06-10,Pool,2,5,0,0,0,0,0,0,0,0,0,0,0,0,0,0,0,0,0,0,0,0,0,0,0,0,0
Nicolas ZERBA,Argentina,Middle Blocker,Men,Serbia,2022-06-10,Pool,2,5,9,6,0,1,7,2,4,10,16,1,1,14,16,0,0,0,0,2,2,0,4,0,0,0,0
Matias GIRAUDO,Argentina,Setter,Men,Serbia,2022-06-10,Pool,2,5,6,2,0,0,2,1,1,1,3,3,3,7,13,0,0,0,0,5,1,2,8,29,0,17,46
Matias SANCHEZ,Argentina,Setter,Men,Germany,2022-06-09,Pool,3,4,0,0,0,2,2,0,1,0,1,0,0,10,10,0,0,1,1,6,0,2,8,23,0,44,67
Joaquin GALLEGO,Argentina,Middle Blocker,Men,Germany,2022-06-09,Pool,3,4,0,0,0,0,0,0,0,0,0,0,0,0,0,0,0,0,0,0,0,0,0,0,0,0,0
Agustin LOSER,Argentina,Middle Blocker,Men,Germany,2022-06-09,Pool,3,4,13,8,2,3,13,2,14,5,21,3,2,18,23,0,0,0,0,1,0,1,2,0,0,1,1
Santiago DANANI,Argentina,Libero,Men,Germany,2022-06-09,Pool,3,4,0,0,0,0,0,0,0,0,0,0,0,0,0,7,2,8,17,14,2,2,18,0,0,7,7
Nicolás LAZO,Argentina,Outside Hitter,Men,Germany,2022-06-09,Pool,3,4,10,10,2,6,18,0,3,2,5,0,1,16,17,3,5,12,20,5,0,1,6,0,0,4,4
Manuel ARMOA,Argentina,Outside Hitter,Men,Germany,2022-06-09,Pool,3,4,3,1,3,5,9,2,1,1,4,0,1,2,3,1,0,4,5,0,1,1,2,0,0,0,0
Bruno LIMA,Argentina,Opposite Spiker,Men,Germany,2022-06-09,Pool,3,4,19,16,5,10,31,2,4,0,6,1,4,11,16,0,0,1,1,2,5,2,9,0,0,1,1
Ezequiel PALACIOS,Argentina,Outside Hitter,Men,Germany,2022-06-09,Pool,3,4,14,10,1,13,24,2,3,1,6,2,0,10,12,5,2,15,22,1,1,2,4,0,0,2,2
Luciano PALONSKY,Argentina,Outside Hitter,Men,Germany,2022-06-09,Pool,3,4,0,0,0,0,0,0,0,0,0,0,0,0,0,0,0,0,0,0,0,0,0,0,0,0,0
Luciano VICENTIN,Argentina,Outside Hitter,Men,Germany,2022-06-09,Pool,3,4,0,0,0,0,0,0,0,0,0,0,0,0,0,0,0,0,0,0,0,0,0,0,0,0,0
Martin RAMOS,Argentina,Middle Blocker,Men,Germany,2022-06-09,Pool,3,4,0,0,0,0,0,0,0,0,0,0,0,0,0,0,0,0,0,0,0,0,0,0,0,0,0
Franco MASSIMINO,Argentina,Libero,Men,Germany,2022-06-09,Pool,3,4,0,0,0,0,0,0,0,0,0,0,0,0,0,0,0,0,0,0,0,0,0,0,0,0,0
Nicolas ZERBA,Argentina,Middle Blocker,Men,Germany,2022-06-09,Pool,3,4,3,2,1,0,3,1,3,11,15,0,1,7,8,1,0,0,1,0,1,4,5,0,0,0,0
Matias GIRAUDO,Argentina,Setter,Men,Germany,2022-06-09,Pool,3,4,1,0,0,1,1,1,0,0,1,0,3,0,3,0,0,0,0,1,2,1,4,3,0,9,12
Matias SANCHEZ,Argentina,Setter,Men,Poland,2022-06-08,Pool,0,3,2,1,0,0,1,0,0,0,0,1,1,8,10,0,0,0,0,4,3,3,10,31,0,31,62
Joaquin GALLEGO,Argentina,Middle Blocker,Men,Poland,2022-06-08,Pool,0,3,0,0,0,0,0,0,0,0,0,0,0,0,0,0,0,0,0,0,0,0,0,0,0,0,0
Agustin LOSER,Argentina,Middle Blocker,Men,Poland,2022-06-08,Pool,0,3,6,4,1,5,10,1,3,5,9,1,3,9,13,0,0,0,0,0,0,0,0,0,0,0,0
Santiago DANANI,Argentina,Libero,Men,Poland,2022-06-08,Pool,0,3,0,0,0,0,0,0,0,0,0,0,0,0,0,6,1,10,17,4,3,2,9,0,0,9,9
Nicolás LAZO,Argentina,Outside Hitter,Men,Poland,2022-06-08,Pool,0,3,10,9,3,13,25,0,0,4,4,1,1,7,9,1,0,13,14,7,3,0,10,0,0,1,1
Manuel ARMOA,Argentina,Outside Hitter,Men,Poland,2022-06-08,Pool,0,3,3,3,0,2,5,0,3,0,3,0,0,4,4,2,1,7,10,1,3,0,4,0,0,0,0
Bruno LIMA,Argentina,Opposite Spiker,Men,Poland,2022-06-08,Pool,0,3,8,7,3,12,22,1,3,5,9,0,5,8,13,0,0,1,1,2,2,0,4,0,0,1,1
Ezequiel PALACIOS,Argentina,Outside Hitter,Men,Poland,2022-06-08,Pool,0,3,5,4,2,7,13,1,2,0,3,0,1,4,5,0,1,12,13,2,3,1,6,0,0,3,3
Luciano PALONSKY,Argentina,Outside Hitter,Men,Poland,2022-06-08,Pool,0,3,0,0,0,0,0,0,0,0,0,0,1,0,1,0,0,0,0,0,0,0,0,0,0,0,0
Luciano VICENTIN,Argentina,Outside Hitter,Men,Poland,2022-06-08,Pool,0,3,0,0,0,0,0,0,0,0,0,0,0,0,0,0,0,0,0,0,0,0,0,0,0,0,0
Martin RAMOS,Argentina,Middle Blocker,Men,Poland,2022-06-08,Pool,0,3,3,2,0,2,4,1,1,2,4,0,1,7,8,0,0,0,0,3,0,2,5,0,0,0,0
Franco MASSIMINO,Argentina,Libero,Men,Poland,2022-06-08,Pool,0,3,0,0,0,0,0,0,0,0,0,0,0,0,0,0,0,0,0,0,0,0,0,0,0,0,0
Nicolas ZERBA,Argentina,Middle Blocker,Men,Poland,2022-06-08,Pool,0,3,3,1,1,2,4,2,4,2,8,0,1,2,3,0,0,2,2,0,1,2,3,0,0,1,1
Matias GIRAUDO,Argentina,Setter,Men,Poland,2022-06-08,Pool,0,3,0,0,0,0,0,0,0,2,2,0,1,0,1,0,0,0,0,0,0,0,0,0,0,6,6
Beau GRAHAM,Australia,Middle Blocker,Men,France,2022-07-10,Pool,0,3,6,4,0,0,4,2,1,4,7,0,3,4,7,1,0,0,1,0,0,0,0,0,0,0,0
Arshdeep DOSANJH,Australia,Setter,Men,France,2022-07-10,Pool,0,3,1,0,0,2,2,0,1,0,1,1,0,4,5,0,0,0,0,1,2,0,3,9,1,20,30
Lorenzo POPE,Australia,Outside Hitter,Men,France,2022-07-10,Pool,0,3,0,0,0,0,0,0,0,0,0,0,0,0,0,0,0,0,0,0,0,0,0,0,0,0,0
Jackson HOLLAND,Australia,Libero,Men,France,2022-07-10,Pool,0,3,0,0,0,0,0,0,0,0,0,0,0,0,0,2,1,13,16,4,5,0,9,0,0,7,7
Malachi MURCH,Australia,Outside Hitter,Men,France,2022-07-10,Pool,0,3,0,0,1,2,3,0,0,0,0,0,1,1,2,0,1,3,4,1,0,1,2,0,0,3,3
Trent O'DEA,Australia,Middle Blocker,Men,France,2022-07-10,Pool,0,3,5,3,0,2,5,1,3,1,5,1,1,8,10,0,0,2,2,0,1,2,3,0,0,3,3
Thomas HEPTINSTALL,Australia,Opposite Spiker,Men,France,2022-07-10,Pool,0,3,5,5,2,5,12,0,0,1,1,0,2,7,9,0,0,4,4,4,1,0,5,0,1,3,4
Conal Tain MCAINSH,Australia,Middle Blocker,Men,France,2022-07-10,Pool,0,3,0,0,0,0,0,0,0,0,0,0,0,0,0,0,0,0,0,0,0,0,0,0,0,0,0
Korben PHILLIPS,Australia,Middle Blocker,Men,France,2022-07-10,Pool,0,3,0,0,0,0,0,0,0,0,0,0,0,0,0,0,0,0,0,0,0,0,0,0,0,0,0
Nicholas BUTLER,Australia,Setter,Men,France,2022-07-10,Pool,0,3,1,1,0,0,1,0,1,0,1,0,2,4,6,0,0,1,1,2,0,0,2,4,0,9,13
Sam FLOWERDAY,Australia,Outside Hitter,Men,France,2022-07-10,Pool,0,3,4,4,7,3,14,0,1,0,1,0,3,5,8,0,1,9,10,3,3,1,7,0,0,4,4
Max SENICA,Australia,Outside Hitter,Men,France,2022-07-10,Pool,0,3,2,2,1,1,4,0,2,1,3,0,0,2,2,1,3,4,8,1,0,2,3,0,0,0,0
Ethan GARRETT,Australia,Outside Hitter,Men,France,2022-07-10,Pool,0,3,2,2,1,2,5,0,2,2,4,0,0,3,3,0,0,9,9,1,1,0,2,0,0,3,3
Matthew AUBREY,Australia,Opposite Spiker,Men,France,2022-07-10,Pool,0,3,2,2,3,3,8,0,2,1,3,0,0,3,3,0,0,0,0,1,2,0,3,0,0,1,1
Beau GRAHAM,Australia,Middle Blocker,Men,Argentina,2022-07-08,Pool,1,4,9,7,1,4,12,2,4,4,10,0,1,12,13,0,0,0,0,1,0,2,3,0,0,1,1
Arshdeep DOSANJH,Australia,Setter,Men,Argentina,2022-07-08,Pool,1,4,0,0,0,0,0,0,0,0,0,0,0,0,0,0,0,0,0,0,0,0,0,0,0,0,0
Lorenzo POPE,Australia,Outside Hitter,Men,Argentina,2022-07-08,Pool,1,4,12,11,4,5,20,0,4,1,5,1,2,15,18,12,4,15,31,6,3,3,12,0,0,0,0
Jackson HOLLAND,Australia,Libero,Men,Argentina,2022-07-08,Pool,1,4,0,0,0,0,0,0,0,0,0,0,0,0,0,13,1,17,31,7,2,1,10,0,0,1,1
Malachi MURCH,Australia,Outside Hitter,Men,Argentina,2022-07-08,Pool,1,4,16,13,4,13,30,3,3,2,8,0,3,8,11,4,3,11,18,4,2,4,10,1,0,0,1
Trent O'DEA,Australia,Middle Blocker,Men,Argentina,2022-07-08,Pool,1,4,5,4,1,4,9,1,3,3,7,0,0,13,13,1,0,0,1,1,0,2,3,0,0,4,4
Thomas HEPTINSTALL,Australia,Opposite Spiker,Men,Argentina,2022-07-08,Pool,1,4,0,0,1,0,1,0,0,0,0,0,1,0,1,0,0,0,0,0,1,0,1,0,0,0,0
Conal Tain MCAINSH,Australia,Middle Blocker,Men,Argentina,2022-07-08,Pool,1,4,0,0,0,0,0,0,0,0,0,0,0,0,0,0,0,0,0,0,0,0,0,0,0,0,0
Korben PHILLIPS,Australia,Middle Blocker,Men,Argentina,2022-07-08,Pool,1,4,0,0,0,0,0,0,0,0,0,0,0,0,0,0,0,0,0,0,0,0,0,0,0,0,0
Nicholas BUTLER,Australia,Setter,Men,Argentina,2022-07-08,Pool,1,4,2,0,0,1,1,0,2,2,4,2,4,9,15,0,0,0,0,0,3,1,4,32,1,51,84
Sam FLOWERDAY,Australia,Outside Hitter,Men,Argentina,2022-07-08,Pool,1,4,0,0,0,0,0,0,0,0,0,0,0,0,0,0,0,0,0,0,0,0,0,0,0,0,0
Max SENICA,Australia,Outside Hitter,Men,Argentina,2022-07-08,Pool,1,4,0,0,1,0,1,0,0,0,0,0,0,1,1,0,0,0,0,0,0,0,0,0,0,0,0
Ethan GARRETT,Australia,Outside Hitter,Men,Argentina,2022-07-08,Pool,1,4,0,0,0,0,0,0,0,0,0,0,0,0,0,0,0,0,0,0,0,0,0,0,0,0,0
Matthew AUBREY,Australia,Opposite Spiker,Men,Argentina,2022-07-08,Pool,1,4,12,11,6,3,20,1,1,4,6,0,4,7,11,0,0,0,0,2,0,1,3,0,0,0,0
Beau GRAHAM,Australia,Middle Blocker,Men,Germany,2022-07-07,Pool,1,4,7,4,2,0,6,1,2,4,7,2,3,11,16,1,0,3,4,2,4,1,7,0,0,2,2
Arshdeep DOSANJH,Australia,Setter,Men,Germany,2022-07-07,Pool,1,4,2,2,0,2,4,0,2,4,6,0,1,13,14,0,0,2,2,7,1,2,10,25,1,40,66
Lorenzo POPE,Australia,Outside Hitter,Men,Germany,2022-07-07,Pool,1,4,17,16,3,7,26,1,3,3,7,0,5,11,16,10,3,23,36,3,0,3,6,1,0,4,5
Jackson HOLLAND,Australia,Libero,Men,Germany,2022-07-07,Pool,1,4,0,0,0,0,0,0,0,0,0,0,0,0,0,7,1,8,16,4,5,3,12,0,0,7,7
Malachi MURCH,Australia,Outside Hitter,Men,Germany,2022-07-07,Pool,1,4,5,5,1,4,10,0,0,1,1,0,2,6,8,3,0,7,10,1,2,0,3,0,0,1,1
Trent O'DEA,Australia,Middle Blocker,Men,Germany,2022-07-07,Pool,1,4,11,7,3,1,11,3,1,4,8,1,2,12,15,0,0,2,2,2,2,0,4,0,0,5,5
Thomas HEPTINSTALL,Australia,Opposite Spiker,Men,Germany,2022-07-07,Pool,1,4,3,3,1,3,7,0,1,0,1,0,3,2,5,0,0,0,0,0,1,0,1,0,0,0,0
Conal Tain MCAINSH,Australia,Middle Blocker,Men,Germany,2022-07-07,Pool,1,4,0,0,0,0,0,0,0,0,0,0,0,0,0,0,0,0,0,0,0,0,0,0,0,0,0
Korben PHILLIPS,Australia,Middle Blocker,Men,Germany,2022-07-07,Pool,1,4,0,0,0,0,0,0,0,0,0,0,0,0,0,0,0,0,0,0,0,0,0,0,0,0,0
Nicholas BUTLER,Australia,Setter,Men,Germany,2022-07-07,Pool,1,4,0,0,0,0,0,0,0,0,0,0,0,0,0,0,0,0,0,0,0,0,0,0,0,0,0
Sam FLOWERDAY,Australia,Outside Hitter,Men,Germany,2022-07-07,Pool,1,4,0,0,0,0,0,0,0,0,0,0,0,0,0,0,0,0,0,0,0,0,0,0,0,0,0
Max SENICA,Australia,Outside Hitter,Men,Germany,2022-07-07,Pool,1,4,3,3,2,1,6,0,0,1,1,0,1,4,5,2,1,4,7,1,1,0,2,0,0,0,0
Ethan GARRETT,Australia,Outside Hitter,Men,Germany,2022-07-07,Pool,1,4,0,0,0,0,0,0,0,0,0,0,0,0,0,0,0,0,0,0,0,0,0,0,0,0,0
Matthew AUBREY,Australia,Opposite Spiker,Men,Germany,2022-07-07,Pool,1,4,9,8,3,9,20,0,2,5,7,1,4,3,8,0,0,0,0,2,2,1,5,0,0,2,2
Beau GRAHAM,Australia,Middle Blocker,Men,Japan,2022-07-06,Pool,1,4,5,4,1,4,9,1,3,2,6,0,3,11,14,1,0,0,1,0,1,0,1,0,0,2,2
Arshdeep DOSANJH,Australia,Setter,Men,Japan,2022-07-06,Pool,1,4,3,2,0,3,5,1,2,3,6,0,1,10,11,0,1,0,1,3,2,0,5,21,1,45,67
Lorenzo POPE,Australia,Outside Hitter,Men,Japan,2022-07-06,Pool,1,4,22,21,5,6,32,1,2,2,5,0,4,8,12,13,4,19,36,5,2,0,7,0,0,2,2
Jackson HOLLAND,Australia,Libero,Men,Japan,2022-07-06,Pool,1,4,0,0,0,0,0,0,0,0,0,0,0,0,0,8,4,9,21,6,3,1,10,0,0,3,3
Malachi MURCH,Australia,Outside Hitter,Men,Japan,2022-07-06,Pool,1,4,9,8,2,5,15,1,2,1,4,0,2,11,13,3,1,11,15,4,0,1,5,0,0,2,2
Trent O'DEA,Australia,Middle Blocker,Men,Japan,2022-07-06,Pool,1,4,6,6,0,6,12,0,6,2,8,0,0,11,11,0,0,1,1,0,3,0,3,2,0,1,3
Thomas HEPTINSTALL,Australia,Opposite Spiker,Men,Japan,2022-07-06,Pool,1,4,10,9,3,3,15,0,1,1,2,1,1,13,15,1,2,0,3,2,3,3,8,1,0,1,2
Conal Tain MCAINSH,Australia,Middle Blocker,Men,Japan,2022-07-06,Pool,1,4,0,0,0,0,0,0,0,0,0,0,0,0,0,0,0,0,0,0,0,0,0,0,0,0,0
Korben PHILLIPS,Australia,Middle Blocker,Men,Japan,2022-07-06,Pool,1,4,0,0,0,0,0,0,0,0,0,0,0,0,0,0,0,0,0,0,0,0,0,0,0,0,0
Nicholas BUTLER,Australia,Setter,Men,Japan,2022-07-06,Pool,1,4,0,0,0,0,0,0,0,0,0,0,0,0,0,0,0,0,0,0,0,1,1,1,0,1,2
Sam FLOWERDAY,Australia,Outside Hitter,Men,Japan,2022-07-06,Pool,1,4,0,0,0,0,0,0,0,0,0,0,0,0,0,0,0,0,0,0,0,0,0,0,0,0,0
Max SENICA,Australia,Outside Hitter,Men,Japan,2022-07-06,Pool,1,4,1,1,0,0,1,0,0,1,1,0,0,1,1,2,1,0,3,0,1,0,1,0,0,0,0
Ethan GARRETT,Australia,Outside Hitter,Men,Japan,2022-07-06,Pool,1,4,0,0,0,0,0,0,0,0,0,0,0,0,0,0,0,0,0,0,0,0,0,0,0,0,0
Matthew AUBREY,Australia,Opposite Spiker,Men,Japan,2022-07-06,Pool,1,4,0,0,0,0,0,0,0,0,0,0,0,1,1,0,0,0,0,0,0,0,0,1,0,0,1
Beau GRAHAM,Australia,Middle Blocker,Men,Serbia,2022-06-26,Pool,0,3,2,2,0,1,3,0,2,0,2,0,1,6,7,0,0,0,0,1,2,0,3,0,0,0,0
Arshdeep DOSANJH,Australia,Setter,Men,Serbia,2022-06-26,Pool,0,3,2,1,1,1,3,1,6,1,8,0,2,5,7,0,0,0,0,1,0,0,1,14,0,45,59
Lorenzo POPE,Australia,Outside Hitter,Men,Serbia,2022-06-26,Pool,0,3,13,11,4,4,19,2,0,2,4,0,3,6,9,10,1,16,27,0,2,0,2,0,0,0,0
Jackson HOLLAND,Australia,Libero,Men,Serbia,2022-06-26,Pool,0,3,0,0,0,0,0,0,0,0,0,0,0,0,0,0,0,0,0,0,0,0,0,0,0,0,0
James WEIR,Australia,Middle Blocker,Men,Serbia,2022-06-26,Pool,0,3,9,8,0,4,12,1,5,4,10,0,2,9,11,0,0,0,0,0,1,0,1,0,0,0,0
Trent O'DEA,Australia,Middle Blocker,Men,Serbia,2022-06-26,Pool,0,3,2,2,0,1,3,0,3,1,4,0,1,3,4,0,0,1,1,0,0,0,0,0,0,1,1
Max STAPLES,Australia,Outside Hitter,Men,Serbia,2022-06-26,Pool,0,3,6,3,1,8,12,2,3,1,6,1,3,4,8,4,1,9,14,0,2,0,2,0,0,0,0
Luke PERRY,Australia,Libero,Men,Serbia,2022-06-26,Pool,0,3,0,0,0,0,0,0,0,0,0,0,0,0,0,6,0,10,16,0,2,0,2,0,0,2,2
Thomas HEPTINSTALL,Australia,Opposite Spiker,Men,Serbia,2022-06-26,Pool,0,3,9,9,3,1,13,0,1,1,2,0,1,13,14,0,0,3,3,0,1,0,1,0,0,0,0
Hamish HAZELDEN,Australia,Opposite Spiker,Men,Serbia,2022-06-26,Pool,0,3,0,0,0,0,0,0,0,0,0,0,0,0,0,0,0,0,0,0,0,0,0,0,0,0,0
Nicholas BUTLER,Australia,Setter,Men,Serbia,2022-06-26,Pool,0,3,0,0,0,0,0,0,0,0,0,0,0,0,0,0,0,0,0,0,0,0,0,0,0,0,0
Sam FLOWERDAY,Australia,Outside Hitter,Men,Serbia,2022-06-26,Pool,0,3,0,0,0,0,0,0,0,0,0,0,0,0,0,0,0,0,0,0,0,0,0,0,0,0,0
Max SENICA,Australia,Outside Hitter,Men,Serbia,2022-06-26,Pool,0,3,1,1,0,0,1,0,0,1,1,0,0,1,1,0,0,2,2,0,0,0,0,0,0,0,0
Ethan GARRETT,Australia,Outside Hitter,Men,Serbia,2022-06-26,Pool,0,3,0,0,0,0,0,0,0,0,0,0,0,0,0,0,0,0,0,0,0,0,0,0,0,0,0
Beau GRAHAM,Australia,Middle Blocker,Men,Poland,2022-06-25,Pool,0,3,3,1,3,3,7,2,2,0,4,0,0,5,5,0,0,0,0,0,0,0,0,0,0,0,0
Arshdeep DOSANJH,Australia,Setter,Men,Poland,2022-06-25,Pool,0,3,0,0,0,0,0,0,0,0,0,0,0,0,0,0,0,0,0,0,0,0,0,0,0,0,0
Lorenzo POPE,Australia,Outside Hitter,Men,Poland,2022-06-25,Pool,0,3,0,0,0,0,0,0,0,0,0,0,0,0,0,0,0,0,0,0,0,0,0,0,0,0,0
Jackson HOLLAND,Australia,Libero,Men,Poland,2022-06-25,Pool,0,3,0,0,0,0,0,0,0,0,0,0,0,0,0,0,2,3,5,0,0,0,0,0,0,0,0
James WEIR,Australia,Middle Blocker,Men,Poland,2022-06-25,Pool,0,3,1,0,1,3,4,1,1,1,3,0,1,1,2,0,0,0,0,0,1,0,1,0,0,0,0
Trent O'DEA,Australia,Middle Blocker,Men,Poland,2022-06-25,Pool,0,3,6,5,2,3,10,1,1,1,3,0,0,9,9,2,0,2,4,0,0,0,0,0,0,1,1
Max STAPLES,Australia,Outside Hitter,Men,Poland,2022-06-25,Pool,0,3,0,0,0,0,0,0,0,0,0,0,0,0,0,0,0,0,0,0,0,0,0,0,0,0,0
Luke PERRY,Australia,Libero,Men,Poland,2022-06-25,Pool,0,3,0,0,0,0,0,0,0,0,0,0,0,0,0,6,0,2,8,6,3,3,12,0,0,4,4
Thomas HEPTINSTALL,Australia,Opposite Spiker,Men,Poland,2022-06-25,Pool,0,3,8,8,3,13,24,0,0,0,0,0,1,6,7,0,0,3,3,2,1,0,3,0,0,0,0
Hamish HAZELDEN,Australia,Opposite Spiker,Men,Poland,2022-06-25,Pool,0,3,0,0,0,0,0,0,0,0,0,0,0,0,0,0,0,0,0,0,0,0,0,0,0,0,0
Nicholas BUTLER,Australia,Setter,Men,Poland,2022-06-25,Pool,0,3,1,0,0,2,2,0,1,0,1,1,2,4,7,0,0,0,0,1,2,0,3,20,0,55,75
Sam FLOWERDAY,Australia,Outside Hitter,Men,Poland,2022-06-25,Pool,0,3,0,0,2,0,2,0,0,0,0,0,0,1,1,0,0,0,0,0,0,0,0,0,0,0,0
Max SENICA,Australia,Outside Hitter,Men,Poland,2022-06-25,Pool,0,3,6,6,4,9,19,0,0,0,0,0,0,10,10,4,1,14,19,0,1,0,1,0,1,0,1
Ethan GARRETT,Australia,Outside Hitter,Men,Poland,2022-06-25,Pool,0,3,7,7,3,5,15,0,1,2,3,0,3,7,10,5,1,20,26,0,0,1,1,0,0,0,0
Beau GRAHAM,Australia,Middle Blocker,Men,Bulgaria,2022-06-24,Pool,3,5,13,11,0,4,15,1,3,1,5,1,0,10,11,0,0,0,0,1,1,0,2,1,0,0,1
Arshdeep DOSANJH,Australia,Setter,Men,Bulgaria,2022-06-24,Pool,3,5,7,2,1,1,4,3,2,2,7,2,2,20,24,0,0,0,0,1,4,1,6,19,2,91,112
Lorenzo POPE,Australia,Outside Hitter,Men,Bulgaria,2022-06-24,Pool,3,5,21,20,7,8,35,0,2,1,3,1,2,14,17,8,3,20,31,8,4,0,12,0,1,1,2
Jackson HOLLAND,Australia,Libero,Men,Bulgaria,2022-06-24,Pool,3,5,0,0,0,0,0,0,0,0,0,0,0,0,0,0,0,0,0,0,0,0,0,0,0,0,0
James WEIR,Australia,Middle Blocker,Men,Bulgaria,2022-06-24,Pool,3,5,15,11,0,5,16,3,2,7,12,1,2,16,19,0,1,3,4,2,0,1,3,0,0,0,0
Trent O'DEA,Australia,Middle Blocker,Men,Bulgaria,2022-06-24,Pool,3,5,0,0,0,0,0,0,0,0,0,0,0,0,0,0,0,0,0,0,0,0,0,0,0,0,0
Max STAPLES,Australia,Outside Hitter,Men,Bulgaria,2022-06-24,Pool,3,5,12,10,9,14,33,1,3,0,4,1,4,14,19,5,2,17,24,0,2,1,3,0,0,2,2
Luke PERRY,Australia,Libero,Men,Bulgaria,2022-06-24,Pool,3,5,0,0,0,0,0,0,0,0,0,0,0,0,0,6,1,16,23,5,4,1,10,1,0,3,4
Thomas HEPTINSTALL,Australia,Opposite Spiker,Men,Bulgaria,2022-06-24,Pool,3,5,8,7,5,11,23,0,2,0,2,1,4,12,17,0,0,4,4,3,1,2,6,0,0,1,1
Hamish HAZELDEN,Australia,Opposite Spiker,Men,Bulgaria,2022-06-24,Pool,3,5,0,0,0,0,0,0,0,0,0,0,0,0,0,0,0,0,0,0,0,0,0,0,0,0,0
Nicholas BUTLER,Australia,Setter,Men,Bulgaria,2022-06-24,Pool,3,5,0,0,0,0,0,0,0,0,0,0,0,0,0,0,0,0,0,0,0,0,0,0,0,0,0
Sam FLOWERDAY,Australia,Outside Hitter,Men,Bulgaria,2022-06-24,Pool,3,5,0,0,0,0,0,0,0,0,0,0,0,1,1,0,0,0,0,0,0,0,0,0,0,0,0
Max SENICA,Australia,Outside Hitter,Men,Bulgaria,2022-06-24,Pool,3,5,0,0,0,0,0,0,0,0,0,0,0,0,0,0,0,0,0,0,0,0,0,0,0,0,0
Ethan GARRETT,Australia,Outside Hitter,Men,Bulgaria,2022-06-24,Pool,3,5,0,0,0,0,0,0,0,0,0,0,0,0,0,0,0,0,0,0,0,0,0,0,0,0,0
Beau GRAHAM,Australia,Middle Blocker,Men,Canada,2022-06-21,Pool,1,4,11,9,1,1,11,1,2,4,7,1,1,13,15,2,0,0,2,0,1,1,2,0,0,0,0
Arshdeep DOSANJH,Australia,Setter,Men,Canada,2022-06-21,Pool,1,4,7,5,0,1,6,1,4,1,6,1,3,8,12,0,0,0,0,1,3,0,4,18,2,78,98
Lorenzo POPE,Australia,Outside Hitter,Men,Canada,2022-06-21,Pool,1,4,15,13,5,17,35,2,1,2,5,0,3,11,14,6,2,12,20,4,4,1,9,0,0,1,1
Jackson HOLLAND,Australia,Libero,Men,Canada,2022-06-21,Pool,1,4,0,0,0,0,0,0,0,0,0,0,0,0,0,0,0,0,0,0,0,0,0,0,0,0,0
James WEIR,Australia,Middle Blocker,Men,Canada,2022-06-21,Pool,1,4,14,10,1,6,17,2,3,4,9,2,1,10,13,0,0,1,1,0,1,0,1,0,0,2,2
Trent O'DEA,Australia,Middle Blocker,Men,Canada,2022-06-21,Pool,1,4,0,0,0,0,0,0,0,0,0,0,0,0,0,0,0,0,0,0,0,0,0,0,0,0,0
Max STAPLES,Australia,Outside Hitter,Men,Canada,2022-06-21,Pool,1,4,10,9,2,8,19,1,2,0,3,0,5,12,17,9,3,11,23,5,0,1,6,0,0,1,1
Luke PERRY,Australia,Libero,Men,Canada,2022-06-21,Pool,1,4,0,0,0,0,0,0,0,0,0,0,0,0,0,12,2,11,25,11,4,4,19,0,0,6,6
Thomas HEPTINSTALL,Australia,Opposite Spiker,Men,Canada,2022-06-21,Pool,1,4,10,6,6,5,17,0,0,1,1,4,2,14,20,2,0,3,5,1,1,0,2,0,0,0,0
Hamish HAZELDEN,Australia,Opposite Spiker,Men,Canada,2022-06-21,Pool,1,4,0,0,0,0,0,0,0,0,0,0,0,0,0,0,0,0,0,0,0,0,0,0,0,0,0
Nicholas BUTLER,Australia,Setter,Men,Canada,2022-06-21,Pool,1,4,0,0,0,0,0,0,0,0,0,0,0,0,0,0,0,0,0,0,0,0,0,0,0,0,0
Sam FLOWERDAY,Australia,Outside Hitter,Men,Canada,2022-06-21,Pool,1,4,0,0,0,0,0,0,0,0,0,0,1,0,1,0,0,0,0,0,0,0,0,0,0,0,0
Max SENICA,Australia,Outside Hitter,Men,Canada,2022-06-21,Pool,1,4,2,2,2,0,4,0,0,0,0,0,0,1,1,0,0,2,2,1,0,0,1,0,0,0,0
Ethan GARRETT,Australia,Outside Hitter,Men,Canada,2022-06-21,Pool,1,4,0,0,0,0,0,0,0,0,0,0,0,0,0,0,0,0,0,0,0,0,0,0,0,0,0
Beau GRAHAM,Australia,Middle Blocker,Men,Netherlands,2022-06-12,Pool,0,3,0,0,0,1,1,0,2,3,5,0,1,9,10,0,1,0,1,0,1,0,1,2,0,0,2
Arshdeep DOSANJH,Australia,Setter,Men,Netherlands,2022-06-12,Pool,0,3,1,1,1,0,2,0,1,1,2,0,0,8,8,0,0,0,0,3,0,1,4,12,1,15,28
Lorenzo POPE,Australia,Outside Hitter,Men,Netherlands,2022-06-12,Pool,0,3,18,16,2,5,23,1,6,0,7,1,4,6,11,1,5,8,14,3,0,0,3,1,0,2,3
Jackson HOLLAND,Australia,Libero,Men,Netherlands,2022-06-12,Pool,0,3,0,0,0,0,0,0,0,0,0,0,0,0,0,0,0,0,0,0,0,0,0,0,0,0,0
James WEIR,Australia,Middle Blocker,Men,Netherlands,2022-06-12,Pool,0,3,7,5,1,2,8,2,5,3,10,0,3,6,9,0,0,0,0,0,0,0,0,0,0,0,0
Trent O'DEA,Australia,Middle Blocker,Men,Netherlands,2022-06-12,Pool,0,3,0,0,0,0,0,0,0,0,0,0,0,0,0,0,0,0,0,0,0,0,0,0,0,0,0
Luke PERRY,Australia,Libero,Men,Netherlands,2022-06-12,Pool,0,3,0,0,0,0,0,0,0,0,0,0,0,0,0,2,0,12,14,6,3,1,10,5,0,1,6
Thomas HEPTINSTALL,Australia,Opposite Spiker,Men,Netherlands,2022-06-12,Pool,0,3,1,1,0,2,3,0,0,2,2,0,1,1,2,0,0,0,0,4,0,0,4,1,0,0,1
Hamish HAZELDEN,Australia,Opposite Spiker,Men,Netherlands,2022-06-12,Pool,0,3,7,6,3,3,12,1,3,2,6,0,4,3,7,0,0,0,0,0,0,0,0,0,0,0,0
Conal Tain MCAINSH,Australia,Middle Blocker,Men,Netherlands,2022-06-12,Pool,0,3,0,0,0,0,0,0,0,0,0,0,0,0,0,0,0,0,0,0,0,0,0,0,0,0,0
Nicholas BUTLER,Australia,Setter,Men,Netherlands,2022-06-12,Pool,0,3,0,0,0,0,0,0,1,1,2,0,2,3,5,0,1,0,1,1,1,0,2,8,1,13,22
Sam FLOWERDAY,Australia,Outside Hitter,Men,Netherlands,2022-06-12,Pool,0,3,0,0,0,0,0,0,0,0,0,0,0,0,0,0,0,0,0,0,0,0,0,0,0,0,0
Max SENICA,Australia,Outside Hitter,Men,Netherlands,2022-06-12,Pool,0,3,4,4,0,4,8,0,1,0,1,0,0,6,6,5,1,10,16,2,1,0,3,0,0,0,0
Ethan GARRETT,Australia,Outside Hitter,Men,Netherlands,2022-06-12,Pool,0,3,1,1,1,1,3,0,0,0,0,0,0,2,2,2,1,8,11,2,0,1,3,0,0,0,0
Beau GRAHAM,Australia,Middle Blocker,Men,Iran,2022-06-12,Pool,1,4,11,7,1,7,15,3,3,5,11,1,2,9,12,0,0,4,4,1,0,0,1,1,0,0,1
Arshdeep DOSANJH,Australia,Setter,Men,Iran,2022-06-12,Pool,1,4,0,0,0,0,0,0,0,0,0,0,0,0,0,0,0,0,0,0,0,0,0,0,0,0,0
Lorenzo POPE,Australia,Outside Hitter,Men,Iran,2022-06-12,Pool,1,4,0,0,0,0,0,0,0,0,0,0,0,0,0,0,0,0,0,0,0,0,0,0,0,0,0
Jackson HOLLAND,Australia,Libero,Men,Iran,2022-06-12,Pool,1,4,0,0,0,0,0,0,0,0,0,0,0,0,0,0,0,0,0,0,0,0,0,0,0,0,0
James WEIR,Australia,Middle Blocker,Men,Iran,2022-06-12,Pool,1,4,0,0,0,0,0,0,0,0,0,0,0,0,0,0,0,0,0,0,0,0,0,0,0,0,0
Trent O'DEA,Australia,Middle Blocker,Men,Iran,2022-06-12,Pool,1,4,6,4,1,9,14,2,2,4,8,0,1,14,15,0,0,0,0,4,0,0,4,0,1,0,1
Luke PERRY,Australia,Libero,Men,Iran,2022-06-12,Pool,1,4,0,0,0,0,0,0,0,0,0,0,0,0,0,8,0,8,16,12,3,2,17,7,0,2,9
Thomas HEPTINSTALL,Australia,Opposite Spiker,Men,Iran,2022-06-12,Pool,1,4,4,2,2,7,11,2,3,1,6,0,3,8,11,1,1,8,10,3,2,0,5,0,0,0,0
Hamish HAZELDEN,Australia,Opposite Spiker,Men,Iran,2022-06-12,Pool,1,4,17,15,8,9,32,1,3,2,6,1,4,10,15,0,0,0,0,3,3,1,7,0,0,1,1
Conal Tain MCAINSH,Australia,Middle Blocker,Men,Iran,2022-06-12,Pool,1,4,0,0,0,0,0,0,0,0,0,0,0,0,0,0,0,0,0,0,0,0,0,0,0,0,0
Nicholas BUTLER,Australia,Setter,Men,Iran,2022-06-12,Pool,1,4,1,1,0,1,2,0,2,4,6,0,2,12,14,0,0,0,0,3,1,1,5,44,0,46,90
Sam FLOWERDAY,Australia,Outside Hitter,Men,Iran,2022-06-12,Pool,1,4,0,0,0,0,0,0,0,0,0,0,0,1,1,0,0,0,0,0,0,0,0,0,0,0,0
Max SENICA,Australia,Outside Hitter,Men,Iran,2022-06-12,Pool,1,4,8,7,10,5,22,1,1,0,2,0,2,3,5,15,2,14,31,6,3,0,9,0,0,0,0
Ethan GARRETT,Australia,Outside Hitter,Men,Iran,2022-06-12,Pool,1,4,4,4,1,3,8,0,0,1,1,0,1,3,4,3,2,10,15,0,0,0,0,0,0,0,0
Beau GRAHAM,Australia,Middle Blocker,Men,Slovenia,2022-06-11,Pool,0,3,4,4,0,6,10,0,1,1,2,0,1,8,9,0,0,1,1,2,1,0,3,1,0,0,1
Arshdeep DOSANJH,Australia,Setter,Men,Slovenia,2022-06-11,Pool,0,3,3,3,1,1,5,0,1,0,1,0,1,9,10,0,1,0,1,1,1,0,2,25,2,42,69
Lorenzo POPE,Australia,Outside Hitter,Men,Slovenia,2022-06-11,Pool,0,3,12,11,2,8,21,1,0,0,1,0,3,9,12,14,0,13,27,5,4,1,10,0,0,0,0
Jackson HOLLAND,Australia,Libero,Men,Slovenia,2022-06-11,Pool,0,3,0,0,0,0,0,0,0,0,0,0,0,0,0,0,0,0,0,0,0,0,0,0,0,0,0
James WEIR,Australia,Middle Blocker,Men,Slovenia,2022-06-11,Pool,0,3,7,5,1,4,10,1,1,2,4,1,2,6,9,0,0,0,0,1,0,0,1,0,0,1,1
Trent O'DEA,Australia,Middle Blocker,Men,Slovenia,2022-06-11,Pool,0,3,1,1,0,0,1,0,0,0,0,0,0,1,1,0,0,0,0,0,0,0,0,0,0,0,0
Luke PERRY,Australia,Libero,Men,Slovenia,2022-06-11,Pool,0,3,0,0,0,0,0,0,0,0,0,0,0,0,0,2,0,7,9,13,1,2,16,5,0,0,5
Thomas HEPTINSTALL,Australia,Opposite Spiker,Men,Slovenia,2022-06-11,Pool,0,3,5,5,2,1,8,0,2,0,2,0,1,3,4,0,0,0,0,1,1,1,3,0,0,0,0
Hamish HAZELDEN,Australia,Opposite Spiker,Men,Slovenia,2022-06-11,Pool,0,3,3,3,3,4,10,0,1,2,3,0,2,2,4,0,0,0,0,3,1,0,4,0,0,0,0
Conal Tain MCAINSH,Australia,Middle Blocker,Men,Slovenia,2022-06-11,Pool,0,3,0,0,0,0,0,0,0,0,0,0,0,0,0,0,0,0,0,0,0,0,0,0,0,0,0
Nicholas BUTLER,Australia,Setter,Men,Slovenia,2022-06-11,Pool,0,3,0,0,0,0,0,0,0,0,0,0,1,0,1,0,0,0,0,0,0,0,0,0,0,1,1
Sam FLOWERDAY,Australia,Outside Hitter,Men,Slovenia,2022-06-11,Pool,0,3,0,0,0,0,0,0,0,0,0,0,1,0,1,0,0,0,0,0,0,0,0,0,0,0,0
Max SENICA,Australia,Outside Hitter,Men,Slovenia,2022-06-11,Pool,0,3,1,1,1,1,3,0,1,0,1,0,0,4,4,1,1,4,6,0,0,1,1,0,0,1,1
Ethan GARRETT,Australia,Outside Hitter,Men,Slovenia,2022-06-11,Pool,0,3,5,3,3,3,9,1,1,1,3,1,1,7,9,4,1,9,14,0,1,0,1,0,0,0,0
Beau GRAHAM,Australia,Middle Blocker,Men,Brazil,2022-06-09,Pool,0,3,3,3,1,3,7,0,2,4,6,0,2,3,5,2,1,1,4,0,0,0,0,0,0,0,0
Arshdeep DOSANJH,Australia,Setter,Men,Brazil,2022-06-09,Pool,0,3,4,4,1,2,7,0,0,4,4,0,3,4,7,0,1,1,2,8,1,2,11,20,2,51,73
Lorenzo POPE,Australia,Outside Hitter,Men,Brazil,2022-06-09,Pool,0,3,18,15,6,10,31,3,0,2,5,0,4,5,9,1,1,10,12,1,1,0,2,0,0,1,1
Jackson HOLLAND,Australia,Libero,Men,Brazil,2022-06-09,Pool,0,3,0,0,0,0,0,0,0,0,0,0,0,0,0,0,0,0,0,0,0,0,0,0,0,0,0
James WEIR,Australia,Middle Blocker,Men,Brazil,2022-06-09,Pool,0,3,7,7,0,4,11,0,1,7,8,0,2,4,6,2,0,0,2,2,0,0,2,0,0,1,1
Trent O'DEA,Australia,Middle Blocker,Men,Brazil,2022-06-09,Pool,0,3,0,0,0,0,0,0,0,0,0,0,0,4,4,0,0,0,0,0,0,0,0,0,0,0,0
Luke PERRY,Australia,Libero,Men,Brazil,2022-06-09,Pool,0,3,0,0,0,0,0,0,0,0,0,0,0,0,0,8,1,10,19,11,3,3,17,6,0,3,9
Thomas HEPTINSTALL,Australia,Opposite Spiker,Men,Brazil,2022-06-09,Pool,0,3,6,3,5,5,13,2,1,4,7,1,4,4,9,0,0,1,1,5,1,0,6,1,0,0,1
Hamish HAZELDEN,Australia,Opposite Spiker,Men,Brazil,2022-06-09,Pool,0,3,0,0,0,0,0,0,0,0,0,0,0,0,0,0,0,0,0,0,0,0,0,0,0,0,0
Conal Tain MCAINSH,Australia,Middle Blocker,Men,Brazil,2022-06-09,Pool,0,3,0,0,0,0,0,0,0,0,0,0,0,0,0,0,0,0,0,0,0,0,0,0,0,0,0
Nicholas BUTLER,Australia,Setter,Men,Brazil,2022-06-09,Pool,0,3,0,0,0,0,0,0,0,0,0,0,0,0,0,0,0,0,0,0,0,0,0,0,0,0,0
Sam FLOWERDAY,Australia,Outside Hitter,Men,Brazil,2022-06-09,Pool,0,3,0,0,0,0,0,0,0,0,0,0,1,2,3,0,0,0,0,0,0,0,0,0,0,0,0
Max SENICA,Australia,Outside Hitter,Men,Brazil,2022-06-09,Pool,0,3,3,3,6,6,15,0,3,0,3,0,1,8,9,3,1,20,24,8,1,1,10,1,0,1,2
Ethan GARRETT,Australia,Outside Hitter,Men,Brazil,2022-06-09,Pool,0,3,0,0,1,5,6,0,1,0,1,0,1,1,2,0,0,2,2,0,1,0,1,0,0,0,0
Bruno Mossa REZENDE,Brazil,Setter,Men,United States,2022-07-20,Quarterfinals,1,4,0,0,0,0,0,0,3,1,4,0,3,8,11,0,0,0,0,3,1,1,5,29,0,63,92
Adriano FERNANDES P.X.CAVALCANTE,Brazil,Outside Hitter,Men,United States,2022-07-20,Quarterfinals,1,4,1,1,1,3,5,0,1,0,1,0,0,5,5,0,0,0,0,2,0,0,2,0,0,0,0
Yoandy LEAL HIDALGO,Brazil,Outside Hitter,Men,United States,2022-07-20,Quarterfinals,1,4,18,18,7,12,37,0,1,0,1,0,4,7,11,10,1,19,30,6,2,1,9,0,0,1,1
Rodrigo LEAO,Brazil,Outside Hitter,Men,United States,2022-07-20,Quarterfinals,1,4,0,0,0,0,0,0,0,0,0,0,0,0,0,1,0,1,2,0,0,0,0,0,0,0,0
Isac SANTOS,Brazil,Middle Blocker,Men,United States,2022-07-20,Quarterfinals,1,4,1,1,0,6,7,0,1,1,2,0,2,5,7,0,0,0,0,3,1,0,4,0,0,0,0
Fernando GIL KRELING,Brazil,Setter,Men,United States,2022-07-20,Quarterfinals,1,4,0,0,0,0,0,0,2,1,3,0,0,4,4,0,0,0,0,0,0,0,0,3,0,18,21
Maique Reis NASCIMENTO,Brazil,Libero,Men,United States,2022-07-20,Quarterfinals,1,4,0,0,0,0,0,0,0,0,0,0,0,0,0,0,0,0,0,1,3,0,4,0,0,2,2
Lucas SAATKAMP,Brazil,Middle Blocker,Men,United States,2022-07-20,Quarterfinals,1,4,8,8,0,2,10,0,4,2,6,0,2,6,8,0,0,1,1,0,2,0,2,0,0,0,0
Thales HOSS,Brazil,Libero,Men,United States,2022-07-20,Quarterfinals,1,4,0,0,0,0,0,0,0,0,0,0,0,0,0,16,0,7,23,6,2,1,9,1,0,1,2
Ricardo Lucarelli SOUZA,Brazil,Outside Hitter,Men,United States,2022-07-20,Quarterfinals,1,4,16,15,4,8,27,0,3,1,4,1,1,16,18,12,3,9,24,8,4,2,14,0,0,0,0
Leandro SANTOS,Brazil,Middle Blocker,Men,United States,2022-07-20,Quarterfinals,1,4,0,0,0,0,0,0,0,0,0,0,0,0,0,0,0,0,0,0,0,0,0,0,0,0,0
Henrique Dantas Nóbrega HONORATO,Brazil,Outside Hitter,Men,United States,2022-07-20,Quarterfinals,1,4,0,0,0,0,0,0,0,0,0,0,0,0,0,0,0,0,0,0,0,0,0,0,0,0,0
Flavio RESENDE GUALBERTO,Brazil,Middle Blocker,Men,United States,2022-07-20,Quarterfinals,1,4,9,7,1,2,10,2,3,3,8,0,3,9,12,1,0,0,1,1,2,1,4,0,0,1,1
Darlan FERREIRA SOUZA,Brazil,Opposite Spiker,Men,United States,2022-07-20,Quarterfinals,1,4,13,11,3,7,21,1,2,5,8,1,4,7,12,0,0,0,0,5,3,0,8,0,0,0,0
Bruno Mossa REZENDE,Brazil,Setter,Men,Japan,2022-07-10,Pool,3,3,2,0,0,1,1,1,2,2,5,1,2,12,15,0,0,0,0,2,0,2,4,30,0,35,65
Leonardo Henrique ANDRADE,Brazil,Middle Blocker,Men,Japan,2022-07-10,Pool,3,3,0,0,0,0,0,0,0,0,0,0,0,0,0,0,0,0,0,0,0,0,0,0,0,0,0
Adriano FERNANDES P.X.CAVALCANTE,Brazil,Outside Hitter,Men,Japan,2022-07-10,Pool,3,3,3,3,0,2,5,0,1,0,1,0,0,1,1,3,0,4,7,0,0,0,0,0,0,0,0
Yoandy LEAL HIDALGO,Brazil,Outside Hitter,Men,Japan,2022-07-10,Pool,3,3,7,7,2,4,13,0,4,0,4,0,3,5,8,3,1,8,12,2,2,0,4,0,0,1,1
Rodrigo LEAO,Brazil,Outside Hitter,Men,Japan,2022-07-10,Pool,3,3,0,0,0,0,0,0,0,0,0,0,0,0,0,0,0,1,1,1,0,0,1,0,0,1,1
Isac SANTOS,Brazil,Middle Blocker,Men,Japan,2022-07-10,Pool,3,3,8,4,1,5,10,2,7,7,16,2,3,12,17,0,0,1,1,2,0,0,2,0,0,0,0
Fernando GIL KRELING,Brazil,Setter,Men,Japan,2022-07-10,Pool,3,3,0,0,0,0,0,0,0,0,0,0,0,1,1,0,0,0,0,0,1,0,1,0,0,0,0
Maique Reis NASCIMENTO,Brazil,Libero,Men,Japan,2022-07-10,Pool,3,3,0,0,0,0,0,0,0,0,0,0,0,0,0,0,0,0,0,3,1,0,4,0,0,0,0
Thales HOSS,Brazil,Libero,Men,Japan,2022-07-10,Pool,3,3,0,0,0,0,0,0,0,0,0,0,0,0,0,4,0,6,10,2,2,2,6,1,0,0,1
Ricardo Lucarelli SOUZA,Brazil,Outside Hitter,Men,Japan,2022-07-10,Pool,3,3,9,7,4,3,14,1,1,2,4,1,4,9,14,9,2,13,24,10,1,3,14,0,0,6,6
Leandro SANTOS,Brazil,Middle Blocker,Men,Japan,2022-07-10,Pool,3,3,0,0,0,0,0,0,0,0,0,0,0,0,0,0,0,0,0,0,0,0,0,0,0,0,0
Henrique Dantas Nóbrega HONORATO,Brazil,Outside Hitter,Men,Japan,2022-07-10,Pool,3,3,0,0,0,0,0,0,0,0,0,0,0,0,0,0,0,0,0,0,0,0,0,0,0,0,0
Flavio RESENDE GUALBERTO,Brazil,Middle Blocker,Men,Japan,2022-07-10,Pool,3,3,5,4,1,3,8,1,5,6,12,0,0,9,9,0,0,1,1,0,0,1,1,0,0,0,0
Darlan FERREIRA SOUZA,Brazil,Opposite Spiker,Men,Japan,2022-07-10,Pool,3,3,19,17,4,5,26,2,1,2,5,0,1,7,8,0,0,0,0,0,0,2,2,0,0,2,2
Bruno Mossa REZENDE,Brazil,Setter,Men,France,2022-07-08,Pool,0,3,0,0,0,1,1,0,0,0,0,0,0,4,4,0,0,1,1,1,0,0,1,2,0,9,11
Leonardo Henrique ANDRADE,Brazil,Middle Blocker,Men,France,2022-07-08,Pool,0,3,0,0,0,0,0,0,0,0,0,0,0,0,0,0,0,0,0,0,0,0,0,0,0,0,0
Adriano FERNANDES P.X.CAVALCANTE,Brazil,Outside Hitter,Men,France,2022-07-08,Pool,0,3,7,6,0,4,10,0,3,1,4,1,1,8,10,3,6,4,13,4,2,1,7,0,0,4,4
Yoandy LEAL HIDALGO,Brazil,Outside Hitter,Men,France,2022-07-08,Pool,0,3,5,5,3,11,19,0,4,2,6,0,1,10,11,3,3,12,18,1,1,2,4,0,0,5,5
Rodrigo LEAO,Brazil,Outside Hitter,Men,France,2022-07-08,Pool,0,3,3,3,1,1,5,0,0,1,1,0,1,2,3,1,0,2,3,4,1,1,6,0,0,1,1
Isac SANTOS,Brazil,Middle Blocker,Men,France,2022-07-08,Pool,0,3,4,1,0,2,3,1,4,5,10,2,0,10,12,0,0,0,0,2,1,1,4,0,0,0,0
Fernando GIL KRELING,Brazil,Setter,Men,France,2022-07-08,Pool,0,3,1,1,1,0,2,0,0,0,0,0,1,5,6,0,0,0,0,4,0,0,4,10,0,33,43
Maique Reis NASCIMENTO,Brazil,Libero,Men,France,2022-07-08,Pool,0,3,0,0,0,0,0,0,0,0,0,0,0,0,0,0,0,0,0,1,0,0,1,0,0,0,0
Thales HOSS,Brazil,Libero,Men,France,2022-07-08,Pool,0,3,0,0,0,0,0,0,0,0,0,0,0,0,0,3,1,10,14,5,2,0,7,0,0,7,7
Ricardo Lucarelli SOUZA,Brazil,Outside Hitter,Men,France,2022-07-08,Pool,0,3,0,0,0,0,0,0,0,0,0,0,0,0,0,0,0,0,0,0,0,0,0,0,0,0,0
Leandro SANTOS,Brazil,Middle Blocker,Men,France,2022-07-08,Pool,0,3,1,1,0,0,1,0,1,0,1,0,0,4,4,0,0,0,0,0,0,0,0,0,0,0,0
Henrique Dantas Nóbrega HONORATO,Brazil,Outside Hitter,Men,France,2022-07-08,Pool,0,3,0,0,0,0,0,0,0,0,0,0,0,2,2,0,0,0,0,0,0,0,0,0,0,1,1
Flavio RESENDE GUALBERTO,Brazil,Middle Blocker,Men,France,2022-07-08,Pool,0,3,8,6,2,4,12,1,6,3,10,1,0,6,7,0,1,2,3,2,1,2,5,0,0,1,1
Darlan FERREIRA SOUZA,Brazil,Opposite Spiker,Men,France,2022-07-08,Pool,0,3,9,8,2,7,17,0,4,5,9,1,2,4,7,0,0,0,0,1,1,0,2,0,0,0,0
Bruno Mossa REZENDE,Brazil,Setter,Men,Canada,2022-07-07,Pool,3,3,1,1,0,0,1,0,1,2,3,0,1,9,10,0,0,0,0,6,2,1,9,11,0,50,61
Leonardo Henrique ANDRADE,Brazil,Middle Blocker,Men,Canada,2022-07-07,Pool,3,3,0,0,0,0,0,0,0,0,0,0,0,0,0,0,0,0,0,0,0,0,0,0,0,0,0
Adriano FERNANDES P.X.CAVALCANTE,Brazil,Outside Hitter,Men,Canada,2022-07-07,Pool,3,3,0,0,0,0,0,0,0,0,0,0,0,0,0,0,0,2,2,0,0,0,0,0,0,0,0
Yoandy LEAL HIDALGO,Brazil,Outside Hitter,Men,Canada,2022-07-07,Pool,3,3,15,13,0,6,19,1,2,1,4,1,3,11,15,2,5,6,13,0,0,1,1,0,0,1,1
Rodrigo LEAO,Brazil,Outside Hitter,Men,Canada,2022-07-07,Pool,3,3,0,0,0,0,0,0,0,0,0,0,0,0,0,0,0,0,0,0,0,0,0,0,0,0,0
Isac SANTOS,Brazil,Middle Blocker,Men,Canada,2022-07-07,Pool,3,3,10,7,0,2,9,0,3,6,9,3,0,17,20,1,0,0,1,4,1,1,6,0,0,1,1
Fernando GIL KRELING,Brazil,Setter,Men,Canada,2022-07-07,Pool,3,3,0,0,0,0,0,0,0,0,0,0,0,0,0,0,0,0,0,0,0,0,0,0,0,1,1
Maique Reis NASCIMENTO,Brazil,Libero,Men,Canada,2022-07-07,Pool,3,3,0,0,0,0,0,0,0,0,0,0,0,0,0,0,0,0,0,0,0,0,0,0,0,0,0
Thales HOSS,Brazil,Libero,Men,Canada,2022-07-07,Pool,3,3,0,0,0,0,0,0,0,0,0,0,0,0,0,3,0,10,13,11,2,1,14,0,0,1,1
Ricardo Lucarelli SOUZA,Brazil,Outside Hitter,Men,Canada,2022-07-07,Pool,3,3,4,4,1,10,15,0,1,2,3,0,1,8,9,3,0,12,15,4,2,2,8,0,0,6,6
Leandro SANTOS,Brazil,Middle Blocker,Men,Canada,2022-07-07,Pool,3,3,0,0,0,0,0,0,0,0,0,0,0,0,0,0,0,0,0,0,0,0,0,0,0,0,0
Henrique Dantas Nóbrega HONORATO,Brazil,Outside Hitter,Men,Canada,2022-07-07,Pool,3,3,0,0,0,0,0,0,0,0,0,0,0,3,3,0,0,0,0,0,0,0,0,0,0,0,0
Flavio RESENDE GUALBERTO,Brazil,Middle Blocker,Men,Canada,2022-07-07,Pool,3,3,10,7,0,1,8,3,4,6,13,0,0,7,7,0,0,1,1,3,2,0,5,0,0,1,1
Darlan FERREIRA SOUZA,Brazil,Opposite Spiker,Men,Canada,2022-07-07,Pool,3,3,12,11,3,8,22,1,3,3,7,0,1,8,9,0,0,0,0,3,2,1,6,0,0,1,1
Bruno Mossa REZENDE,Brazil,Setter,Men,Germany,2022-07-06,Pool,3,4,2,1,0,0,1,1,1,2,4,0,2,16,18,0,0,0,0,8,0,4,12,37,1,44,82
Leonardo Henrique ANDRADE,Brazil,Middle Blocker,Men,Germany,2022-07-06,Pool,3,4,0,0,0,0,0,0,0,0,0,0,0,0,0,0,0,0,0,0,0,0,0,0,0,0,0
Adriano FERNANDES P.X.CAVALCANTE,Brazil,Outside Hitter,Men,Germany,2022-07-06,Pool,3,4,0,0,0,0,0,0,0,1,1,0,0,0,0,0,0,0,0,0,0,0,0,0,0,1,1
Yoandy LEAL HIDALGO,Brazil,Outside Hitter,Men,Germany,2022-07-06,Pool,3,4,21,19,2,8,29,1,6,4,11,1,3,12,16,2,0,17,19,3,4,0,7,0,0,6,6
Rodrigo LEAO,Brazil,Outside Hitter,Men,Germany,2022-07-06,Pool,3,4,1,0,0,0,0,0,0,0,0,1,0,0,1,0,0,0,0,0,0,0,0,0,0,0,0
Isac SANTOS,Brazil,Middle Blocker,Men,Germany,2022-07-06,Pool,3,4,12,10,0,3,13,1,10,5,16,1,1,16,18,1,0,0,1,2,0,0,2,0,0,1,1
Fernando GIL KRELING,Brazil,Setter,Men,Germany,2022-07-06,Pool,3,4,1,0,0,0,0,0,0,0,0,1,0,2,3,0,0,0,0,1,1,0,2,2,0,3,5
Maique Reis NASCIMENTO,Brazil,Libero,Men,Germany,2022-07-06,Pool,3,4,0,0,0,0,0,0,0,0,0,0,0,0,0,0,0,0,0,0,0,0,0,0,0,0,0
Thales HOSS,Brazil,Libero,Men,Germany,2022-07-06,Pool,3,4,0,0,0,0,0,0,0,0,0,0,0,0,0,5,2,8,15,13,3,1,17,0,0,5,5
Ricardo Lucarelli SOUZA,Brazil,Outside Hitter,Men,Germany,2022-07-06,Pool,3,4,15,13,5,6,24,0,3,5,8,2,3,14,19,11,1,17,29,4,4,0,8,0,0,4,4
Leandro SANTOS,Brazil,Middle Blocker,Men,Germany,2022-07-06,Pool,3,4,0,0,0,0,0,0,0,0,0,0,0,0,0,0,0,0,0,0,0,0,0,0,0,0,0
Henrique Dantas Nóbrega HONORATO,Brazil,Outside Hitter,Men,Germany,2022-07-06,Pool,3,4,0,0,0,0,0,0,0,0,0,0,0,0,0,0,0,2,2,0,0,0,0,0,0,1,1
Flavio RESENDE GUALBERTO,Brazil,Middle Blocker,Men,Germany,2022-07-06,Pool,3,4,10,7,1,4,12,3,2,8,13,0,3,10,13,1,0,1,2,3,1,1,5,0,0,1,1
Darlan FERREIRA SOUZA,Brazil,Opposite Spiker,Men,Germany,2022-07-06,Pool,3,4,13,13,5,5,23,0,3,5,8,0,2,9,11,0,0,1,1,4,2,1,7,0,0,0,0
Bruno Mossa REZENDE,Brazil,Setter,Men,Bulgaria,2022-06-26,Pool,3,3,3,1,0,0,1,1,4,1,6,1,0,11,12,0,0,0,0,0,1,0,1,20,0,40,60
Adriano FERNANDES P.X.CAVALCANTE,Brazil,Outside Hitter,Men,Bulgaria,2022-06-26,Pool,3,3,0,0,0,0,0,0,0,0,0,0,0,0,0,0,1,1,2,0,0,0,0,0,0,0,0
Yoandy LEAL HIDALGO,Brazil,Outside Hitter,Men,Bulgaria,2022-06-26,Pool,3,3,12,11,2,4,17,0,3,0,3,1,2,7,10,3,2,16,21,1,2,0,3,0,0,1,1
Rodrigo LEAO,Brazil,Outside Hitter,Men,Bulgaria,2022-06-26,Pool,3,3,0,0,0,0,0,0,0,0,0,0,0,0,0,0,0,0,0,0,0,0,0,0,0,0,0
Isac SANTOS,Brazil,Middle Blocker,Men,Bulgaria,2022-06-26,Pool,3,3,11,8,1,1,10,2,1,2,5,1,4,9,14,0,0,2,2,0,1,2,3,0,0,0,0
Fernando GIL KRELING,Brazil,Setter,Men,Bulgaria,2022-06-26,Pool,3,3,0,0,0,0,0,0,0,0,0,0,0,2,2,0,0,0,0,0,0,0,0,2,0,1,3
Maique Reis NASCIMENTO,Brazil,Libero,Men,Bulgaria,2022-06-26,Pool,3,3,0,0,0,0,0,0,0,0,0,0,0,0,0,0,0,1,1,0,0,1,1,0,0,0,0
Thales HOSS,Brazil,Libero,Men,Bulgaria,2022-06-26,Pool,3,3,0,0,0,0,0,0,0,0,0,0,0,0,0,4,0,6,10,5,4,0,9,0,0,1,1
Ricardo Lucarelli SOUZA,Brazil,Outside Hitter,Men,Bulgaria,2022-06-26,Pool,3,3,11,8,3,1,12,2,0,2,4,1,3,10,14,1,0,11,12,3,4,1,8,0,0,1,1
Leandro SANTOS,Brazil,Middle Blocker,Men,Bulgaria,2022-06-26,Pool,3,3,0,0,0,0,0,0,0,0,0,0,0,0,0,0,0,0,0,0,0,0,0,0,0,0,0
Flavio RESENDE GUALBERTO,Brazil,Middle Blocker,Men,Bulgaria,2022-06-26,Pool,3,3,10,6,0,3,9,4,0,2,6,0,0,11,11,1,0,2,3,0,0,0,0,0,0,0,0
Darlan FERREIRA SOUZA,Brazil,Opposite Spiker,Men,Bulgaria,2022-06-26,Pool,3,3,10,10,4,5,19,0,1,3,4,0,2,8,10,0,0,1,1,0,1,0,1,0,0,0,0
Bruno Mossa REZENDE,Brazil,Setter,Men,Iran,2022-06-24,Pool,3,3,4,1,0,0,1,0,3,1,4,3,1,13,17,0,0,1,1,0,3,0,3,23,0,38,61
Adriano FERNANDES P.X.CAVALCANTE,Brazil,Outside Hitter,Men,Iran,2022-06-24,Pool,3,3,0,0,1,0,1,0,0,0,0,0,0,0,0,1,0,0,1,1,0,0,1,0,0,0,0
Yoandy LEAL HIDALGO,Brazil,Outside Hitter,Men,Iran,2022-06-24,Pool,3,3,13,11,3,5,19,1,3,0,4,1,1,13,15,1,2,10,13,4,1,0,5,0,0,0,0
Rodrigo LEAO,Brazil,Outside Hitter,Men,Iran,2022-06-24,Pool,3,3,0,0,0,0,0,0,0,0,0,0,0,0,0,0,0,2,2,0,0,0,0,0,0,0,0
Isac SANTOS,Brazil,Middle Blocker,Men,Iran,2022-06-24,Pool,3,3,14,9,0,2,11,4,3,5,12,1,3,8,12,0,0,0,0,0,0,0,0,0,0,1,1
Fernando GIL KRELING,Brazil,Setter,Men,Iran,2022-06-24,Pool,3,3,0,0,0,0,0,0,0,0,0,0,1,1,2,0,0,0,0,0,0,0,0,5,0,9,14
Maique Reis NASCIMENTO,Brazil,Libero,Men,Iran,2022-06-24,Pool,3,3,0,0,0,0,0,0,0,0,0,0,0,0,0,0,0,0,0,0,0,0,0,0,0,0,0
Lucas SAATKAMP,Brazil,Middle Blocker,Men,Iran,2022-06-24,Pool,3,3,0,0,0,0,0,0,0,0,0,0,0,0,0,0,0,0,0,0,0,0,0,0,0,0,0
Thales HOSS,Brazil,Libero,Men,Iran,2022-06-24,Pool,3,3,0,0,0,0,0,0,0,0,0,0,0,0,0,4,2,9,15,3,0,0,3,1,0,3,4
Ricardo Lucarelli SOUZA,Brazil,Outside Hitter,Men,Iran,2022-06-24,Pool,3,3,15,15,2,5,22,0,2,2,4,0,3,6,9,11,0,15,26,1,1,1,3,0,0,2,2
Leandro SANTOS,Brazil,Middle Blocker,Men,Iran,2022-06-24,Pool,3,3,0,0,0,0,0,0,0,0,0,0,0,0,0,0,0,0,0,0,0,0,0,0,0,0,0
Alan SOUZA,Brazil,Opposite Spiker,Men,Iran,2022-06-24,Pool,3,3,3,3,1,2,6,0,2,0,2,0,2,1,3,0,0,0,0,1,1,0,2,0,0,1,1
Flavio RESENDE GUALBERTO,Brazil,Middle Blocker,Men,Iran,2022-06-24,Pool,3,3,8,6,1,0,7,2,2,1,5,0,3,10,13,1,0,0,1,1,2,1,4,0,0,0,0
Darlan FERREIRA SOUZA,Brazil,Opposite Spiker,Men,Iran,2022-06-24,Pool,3,3,5,5,2,5,12,0,1,1,2,0,5,3,8,0,0,0,0,1,0,0,1,0,0,0,0
Bruno Mossa REZENDE,Brazil,Setter,Men,Serbia,2022-06-23,Pool,3,3,2,0,0,0,0,0,0,0,0,2,1,10,13,0,0,0,0,2,2,0,4,21,1,47,69
Adriano FERNANDES P.X.CAVALCANTE,Brazil,Outside Hitter,Men,Serbia,2022-06-23,Pool,3,3,1,1,0,0,1,0,0,0,0,0,0,0,0,2,0,3,5,0,0,0,0,0,0,0,0
Yoandy LEAL HIDALGO,Brazil,Outside Hitter,Men,Serbia,2022-06-23,Pool,3,3,11,8,0,7,15,2,4,1,7,1,2,9,12,1,1,13,15,0,2,1,3,0,0,1,1
Rodrigo LEAO,Brazil,Outside Hitter,Men,Serbia,2022-06-23,Pool,3,3,0,0,0,0,0,0,0,0,0,0,0,0,0,0,0,0,0,0,0,0,0,0,0,0,0
Isac SANTOS,Brazil,Middle Blocker,Men,Serbia,2022-06-23,Pool,3,3,0,0,0,0,0,0,0,0,0,0,0,0,0,0,0,0,0,0,0,0,0,0,0,0,0
Fernando GIL KRELING,Brazil,Setter,Men,Serbia,2022-06-23,Pool,3,3,0,0,0,0,0,0,0,0,0,0,0,0,0,0,0,0,0,0,0,0,0,0,0,0,0
Maique Reis NASCIMENTO,Brazil,Libero,Men,Serbia,2022-06-23,Pool,3,3,0,0,0,0,0,0,0,0,0,0,0,0,0,0,0,0,0,0,0,0,0,0,0,0,0
Lucas SAATKAMP,Brazil,Middle Blocker,Men,Serbia,2022-06-23,Pool,3,3,3,2,0,6,8,1,5,3,9,0,4,3,7,0,0,0,0,0,1,0,1,0,0,0,0
Thales HOSS,Brazil,Libero,Men,Serbia,2022-06-23,Pool,3,3,0,0,0,0,0,0,0,0,0,0,0,0,0,5,0,4,9,5,2,1,8,1,0,3,4
Ricardo Lucarelli SOUZA,Brazil,Outside Hitter,Men,Serbia,2022-06-23,Pool,3,3,14,10,2,7,19,2,2,0,4,2,1,10,13,4,2,10,16,2,3,1,6,1,0,0,1
Leandro SANTOS,Brazil,Middle Blocker,Men,Serbia,2022-06-23,Pool,3,3,1,0,0,0,0,1,1,0,2,0,0,2,2,0,0,0,0,0,0,0,0,0,0,0,0
Alan SOUZA,Brazil,Opposite Spiker,Men,Serbia,2022-06-23,Pool,3,3,13,10,3,9,22,0,0,1,1,3,3,11,17,0,0,0,0,2,1,0,3,0,0,0,0
Flavio RESENDE GUALBERTO,Brazil,Middle Blocker,Men,Serbia,2022-06-23,Pool,3,3,6,5,1,0,6,1,3,4,8,0,2,9,11,0,0,1,1,0,0,0,0,0,0,0,0
Darlan FERREIRA SOUZA,Brazil,Opposite Spiker,Men,Serbia,2022-06-23,Pool,3,3,0,0,0,0,0,0,0,0,0,0,0,0,0,0,0,0,0,0,0,0,0,0,0,0,0
Bruno Mossa REZENDE,Brazil,Setter,Men,Poland,2022-06-22,Pool,1,4,0,0,0,1,1,0,2,1,3,0,0,8,8,0,0,1,1,4,1,3,8,21,0,52,73
Adriano FERNANDES P.X.CAVALCANTE,Brazil,Outside Hitter,Men,Poland,2022-06-22,Pool,1,4,0,0,1,0,1,0,0,0,0,0,0,0,0,0,0,1,1,0,0,0,0,0,0,0,0
Yoandy LEAL HIDALGO,Brazil,Outside Hitter,Men,Poland,2022-06-22,Pool,1,4,10,8,5,9,22,1,3,1,5,1,2,15,18,3,5,23,31,4,2,2,8,0,0,2,2
Rodrigo LEAO,Brazil,Outside Hitter,Men,Poland,2022-06-22,Pool,1,4,6,6,2,7,15,0,0,0,0,0,1,5,6,1,2,2,5,1,0,0,1,0,0,1,1
Isac SANTOS,Brazil,Middle Blocker,Men,Poland,2022-06-22,Pool,1,4,3,3,1,2,6,0,1,1,2,0,2,1,3,0,0,0,0,0,0,0,0,0,0,0,0
Fernando GIL KRELING,Brazil,Setter,Men,Poland,2022-06-22,Pool,1,4,0,0,0,0,0,0,1,2,3,0,0,4,4,0,0,0,0,1,0,0,1,8,0,17,25
Maique Reis NASCIMENTO,Brazil,Libero,Men,Poland,2022-06-22,Pool,1,4,0,0,0,0,0,0,0,0,0,0,0,0,0,1,3,11,15,4,5,1,10,1,1,1,3
Lucas SAATKAMP,Brazil,Middle Blocker,Men,Poland,2022-06-22,Pool,1,4,5,3,0,1,4,2,3,3,8,0,3,9,12,0,0,0,0,1,0,1,2,0,0,0,0
Thales HOSS,Brazil,Libero,Men,Poland,2022-06-22,Pool,1,4,0,0,0,0,0,0,0,0,0,0,0,0,0,3,1,2,6,1,1,1,3,0,0,4,4
Ricardo Lucarelli SOUZA,Brazil,Outside Hitter,Men,Poland,2022-06-22,Pool,1,4,4,3,2,8,13,1,0,0,1,0,2,7,9,3,1,16,20,1,1,0,2,0,0,2,2
Leandro SANTOS,Brazil,Middle Blocker,Men,Poland,2022-06-22,Pool,1,4,0,0,0,0,0,0,0,0,0,0,0,0,0,0,0,0,0,0,0,0,0,0,0,0,0
Alan SOUZA,Brazil,Opposite Spiker,Men,Poland,2022-06-22,Pool,1,4,19,19,4,11,34,0,3,2,5,0,6,5,11,0,1,0,1,1,2,2,5,0,0,1,1
Flavio RESENDE GUALBERTO,Brazil,Middle Blocker,Men,Poland,2022-06-22,Pool,1,4,7,6,0,7,13,1,6,5,12,0,1,8,9,0,0,0,0,1,1,0,2,0,0,0,0
Darlan FERREIRA SOUZA,Brazil,Opposite Spiker,Men,Poland,2022-06-22,Pool,1,4,0,0,1,0,1,0,0,0,0,0,0,0,0,0,0,0,0,0,0,0,0,0,0,0,0
Bruno Mossa REZENDE,Brazil,Setter,Men,China,2022-06-12,Pool,0,3,1,0,0,0,0,0,2,2,4,1,2,8,11,0,0,0,0,3,2,0,5,33,1,38,72
Franco Willian CARGNIN PAESE,Brazil,Opposite Spiker,Men,China,2022-06-12,Pool,0,3,0,0,0,2,2,0,1,0,1,0,0,0,0,0,0,0,0,0,0,0,0,1,0,1,2
Adriano FERNANDES P.X.CAVALCANTE,Brazil,Outside Hitter,Men,China,2022-06-12,Pool,0,3,8,8,2,3,13,0,1,2,3,0,2,7,9,13,1,17,31,3,1,0,4,3,0,1,4
Rodrigo LEAO,Brazil,Outside Hitter,Men,China,2022-06-12,Pool,0,3,4,4,4,4,12,0,4,2,6,0,4,7,11,8,1,8,17,1,2,3,6,0,0,0,0
Isac SANTOS,Brazil,Middle Blocker,Men,China,2022-06-12,Pool,0,3,0,0,0,0,0,0,0,0,0,0,0,0,0,0,0,0,0,0,0,0,0,0,0,0,0
Gabriel KAVALKIEVICZ,Brazil,Outside Hitter,Men,China,2022-06-12,Pool,0,3,0,0,0,0,0,0,0,0,0,0,0,0,0,0,0,0,0,0,0,0,0,0,0,0,0
Fernando GIL KRELING,Brazil,Setter,Men,China,2022-06-12,Pool,0,3,0,0,0,0,0,0,0,0,0,0,0,1,1,0,0,0,0,1,1,0,2,1,1,1,3
Maique Reis NASCIMENTO,Brazil,Libero,Men,China,2022-06-12,Pool,0,3,0,0,0,0,0,0,0,0,0,0,0,0,0,0,0,0,0,3,3,0,6,1,0,0,1
Lucas SAATKAMP,Brazil,Middle Blocker,Men,China,2022-06-12,Pool,0,3,12,8,2,0,10,1,3,1,5,3,2,18,23,0,0,0,0,1,1,1,3,0,0,1,1
Thales HOSS,Brazil,Libero,Men,China,2022-06-12,Pool,0,3,0,0,0,0,0,0,0,0,0,0,0,0,0,5,1,11,17,3,1,0,4,1,0,0,1
Leandro SANTOS,Brazil,Middle Blocker,Men,China,2022-06-12,Pool,0,3,0,0,0,0,0,0,0,0,0,0,0,0,0,0,0,0,0,0,0,0,0,0,0,0,0
Alan SOUZA,Brazil,Opposite Spiker,Men,China,2022-06-12,Pool,0,3,19,16,5,8,29,3,1,4,8,0,3,9,12,0,0,0,0,4,2,0,6,0,0,1,1
Flavio RESENDE GUALBERTO,Brazil,Middle Blocker,Men,China,2022-06-12,Pool,0,3,13,11,3,2,16,2,0,2,4,0,0,9,9,0,0,0,0,1,0,0,1,1,1,0,2
Victor Alexsander ALMEIDA CARDOSO,Brazil,Outside Hitter,Men,China,2022-06-12,Pool,0,3,0,0,1,0,1,0,0,0,0,0,0,1,1,1,1,1,3,0,0,1,1,0,0,0,0
Bruno Mossa REZENDE,Brazil,Setter,Men,United States,2022-06-11,Pool,1,4,1,1,0,0,1,0,2,4,6,0,2,9,11,0,0,1,1,4,4,1,9,28,1,38,67
Franco Willian CARGNIN PAESE,Brazil,Opposite Spiker,Men,United States,2022-06-11,Pool,1,4,3,3,1,1,5,0,0,2,2,0,0,0,0,0,0,0,0,0,0,0,0,0,0,0,0
Adriano FERNANDES P.X.CAVALCANTE,Brazil,Outside Hitter,Men,United States,2022-06-11,Pool,1,4,2,2,2,6,10,0,1,0,1,0,3,9,12,6,2,10,18,2,1,1,4,1,0,0,1
Rodrigo LEAO,Brazil,Outside Hitter,Men,United States,2022-06-11,Pool,1,4,13,10,2,7,19,1,2,4,7,2,3,9,14,17,1,13,31,4,1,3,8,2,0,1,3
Isac SANTOS,Brazil,Middle Blocker,Men,United States,2022-06-11,Pool,1,4,4,4,1,1,6,0,1,1,2,0,2,3,5,0,0,0,0,0,0,0,0,0,0,0,0
Gabriel KAVALKIEVICZ,Brazil,Outside Hitter,Men,United States,2022-06-11,Pool,1,4,7,7,2,5,14,0,0,1,1,0,1,4,5,1,0,9,10,0,1,0,1,0,0,0,0
Fernando GIL KRELING,Brazil,Setter,Men,United States,2022-06-11,Pool,1,4,0,0,0,0,0,0,0,2,2,0,1,4,5,0,0,0,0,1,1,0,2,11,0,15,26
Maique Reis NASCIMENTO,Brazil,Libero,Men,United States,2022-06-11,Pool,1,4,0,0,0,0,0,0,0,0,0,0,0,0,0,1,0,5,6,7,1,2,10,2,0,1,3
Lucas SAATKAMP,Brazil,Middle Blocker,Men,United States,2022-06-11,Pool,1,4,9,5,2,2,9,4,4,4,12,0,5,9,14,0,0,0,0,1,0,0,1,0,0,0,0
Thales HOSS,Brazil,Libero,Men,United States,2022-06-11,Pool,1,4,0,0,0,0,0,0,0,0,0,0,0,0,0,4,2,9,15,4,0,0,4,2,0,0,2
Leandro SANTOS,Brazil,Middle Blocker,Men,United States,2022-06-11,Pool,1,4,0,0,0,0,0,0,0,0,0,0,0,0,0,0,0,0,0,0,0,0,0,0,0,0,0
Alan SOUZA,Brazil,Opposite Spiker,Men,United States,2022-06-11,Pool,1,4,23,21,4,9,34,1,5,2,8,1,4,11,16,0,0,0,0,5,2,2,9,2,0,0,2
Flavio RESENDE GUALBERTO,Brazil,Middle Blocker,Men,United States,2022-06-11,Pool,1,4,5,3,0,2,5,2,3,3,8,0,1,8,9,0,0,0,0,2,0,0,2,0,0,0,0
Victor Alexsander ALMEIDA CARDOSO,Brazil,Outside Hitter,Men,United States,2022-06-11,Pool,1,4,0,0,0,0,0,0,0,0,0,0,0,0,0,0,0,0,0,0,0,0,0,0,0,0,0
Bruno Mossa REZENDE,Brazil,Setter,Men,Slovenia,2022-06-10,Pool,3,4,0,0,0,0,0,0,5,3,8,0,1,13,14,0,0,1,1,4,1,2,7,43,0,28,71
Franco Willian CARGNIN PAESE,Brazil,Opposite Spiker,Men,Slovenia,2022-06-10,Pool,3,4,0,0,0,0,0,0,1,0,1,0,0,0,0,0,0,0,0,0,0,0,0,0,0,0,0
Adriano FERNANDES P.X.CAVALCANTE,Brazil,Outside Hitter,Men,Slovenia,2022-06-10,Pool,3,4,13,8,0,6,14,2,1,0,3,3,3,13,19,4,2,16,22,3,1,2,6,0,0,0,0
Rodrigo LEAO,Brazil,Outside Hitter,Men,Slovenia,2022-06-10,Pool,3,4,15,9,2,6,17,2,3,0,5,4,3,11,18,3,1,13,17,5,1,0,6,0,0,1,1
Isac SANTOS,Brazil,Middle Blocker,Men,Slovenia,2022-06-10,Pool,3,4,0,0,0,0,0,0,0,0,0,0,0,0,0,0,0,0,0,0,0,0,0,0,0,0,0
Gabriel KAVALKIEVICZ,Brazil,Outside Hitter,Men,Slovenia,2022-06-10,Pool,3,4,0,0,0,0,0,0,0,0,0,0,0,0,0,0,0,0,0,0,0,0,0,0,0,1,1
Fernando GIL KRELING,Brazil,Setter,Men,Slovenia,2022-06-10,Pool,3,4,0,0,0,0,0,0,0,0,0,0,0,0,0,0,0,0,0,0,0,0,0,1,0,5,6
Maique Reis NASCIMENTO,Brazil,Libero,Men,Slovenia,2022-06-10,Pool,3,4,0,0,0,0,0,0,0,0,0,0,0,0,0,0,0,1,1,7,2,1,10,1,0,0,1
Lucas SAATKAMP,Brazil,Middle Blocker,Men,Slovenia,2022-06-10,Pool,3,4,12,9,2,5,16,2,2,3,7,1,4,14,19,0,0,0,0,2,0,4,6,0,0,0,0
Thales HOSS,Brazil,Libero,Men,Slovenia,2022-06-10,Pool,3,4,0,0,0,0,0,0,0,0,0,0,0,0,0,8,3,8,19,5,1,0,6,0,0,0,0
Leandro SANTOS,Brazil,Middle Blocker,Men,Slovenia,2022-06-10,Pool,3,4,0,0,0,0,0,0,0,0,0,0,0,0,0,0,0,0,0,0,0,0,0,0,0,0,0
Alan SOUZA,Brazil,Opposite Spiker,Men,Slovenia,2022-06-10,Pool,3,4,18,16,3,9,28,2,6,3,11,0,2,11,13,0,0,0,0,5,0,0,5,1,0,0,1
Flavio RESENDE GUALBERTO,Brazil,Middle Blocker,Men,Slovenia,2022-06-10,Pool,3,4,8,5,1,3,9,3,2,6,11,0,1,11,12,0,0,0,0,2,0,0,2,1,0,1,2
Victor Alexsander ALMEIDA CARDOSO,Brazil,Outside Hitter,Men,Slovenia,2022-06-10,Pool,3,4,0,0,0,0,0,0,0,0,0,0,0,0,0,0,0,0,0,0,0,0,0,0,0,0,0
Bruno Mossa REZENDE,Brazil,Setter,Men,Australia,2022-06-09,Pool,3,3,0,0,0,1,1,0,0,5,5,0,0,11,11,0,0,0,0,10,1,1,12,30,1,31,62
Franco Willian CARGNIN PAESE,Brazil,Opposite Spiker,Men,Australia,2022-06-09,Pool,3,3,0,0,0,0,0,0,0,0,0,0,0,0,0,0,0,0,0,0,0,0,0,0,0,0,0
Adriano FERNANDES P.X.CAVALCANTE,Brazil,Outside Hitter,Men,Australia,2022-06-09,Pool,3,3,6,5,2,4,11,0,4,0,4,1,2,11,14,5,0,6,11,6,3,4,13,3,0,1,4
Rodrigo LEAO,Brazil,Outside Hitter,Men,Australia,2022-06-09,Pool,3,3,7,3,1,10,14,3,1,2,6,1,1,7,9,4,1,9,14,5,0,1,6,2,0,1,3
Isac SANTOS,Brazil,Middle Blocker,Men,Australia,2022-06-09,Pool,3,3,0,0,0,0,0,0,0,0,0,0,0,0,0,0,0,0,0,0,0,0,0,0,0,0,0
Gabriel KAVALKIEVICZ,Brazil,Outside Hitter,Men,Australia,2022-06-09,Pool,3,3,0,0,1,0,1,0,0,0,0,0,1,0,1,0,0,0,0,0,0,0,0,0,0,0,0
Fernando GIL KRELING,Brazil,Setter,Men,Australia,2022-06-09,Pool,3,3,0,0,0,0,0,0,0,0,0,0,0,2,2,0,0,0,0,0,0,0,0,1,0,0,1
Maique Reis NASCIMENTO,Brazil,Libero,Men,Australia,2022-06-09,Pool,3,3,0,0,0,0,0,0,0,0,0,0,0,0,0,0,0,0,0,1,1,0,2,2,0,0,2
Lucas SAATKAMP,Brazil,Middle Blocker,Men,Australia,2022-06-09,Pool,3,3,5,3,1,5,9,1,5,2,8,1,3,15,19,0,0,0,0,4,1,0,5,0,0,0,0
Thales HOSS,Brazil,Libero,Men,Australia,2022-06-09,Pool,3,3,0,0,0,0,0,0,0,0,0,0,0,0,0,7,0,4,11,5,0,0,5,2,0,0,2
Leandro SANTOS,Brazil,Middle Blocker,Men,Australia,2022-06-09,Pool,3,3,0,0,0,0,0,0,0,0,0,0,0,0,0,0,0,0,0,0,0,0,0,0,0,0,0
Alan SOUZA,Brazil,Opposite Spiker,Men,Australia,2022-06-09,Pool,3,3,18,13,2,11,26,3,3,3,9,2,1,8,11,0,0,0,0,4,0,0,4,0,0,0,0
Flavio RESENDE GUALBERTO,Brazil,Middle Blocker,Men,Australia,2022-06-09,Pool,3,3,9,5,0,6,11,4,5,10,19,0,0,7,7,0,0,0,0,2,0,1,3,0,0,0,0
Victor Alexsander ALMEIDA CARDOSO,Brazil,Outside Hitter,Men,Australia,2022-06-09,Pool,3,3,0,0,0,0,0,0,0,0,0,0,0,0,0,0,0,0,0,0,0,0,0,0,0,0,0
Denis KARYAGIN,Bulgaria,Opposite Spiker,Men,China,2022-07-09,Pool,1,4,15,15,6,1,22,0,0,0,0,0,4,13,17,0,0,0,0,0,0,1,1,0,0,0,0
Stefan CHAVDAROV,Bulgaria,Middle Blocker,Men,China,2022-07-09,Pool,1,4,5,4,0,3,7,0,3,0,3,1,1,8,10,0,0,1,1,0,1,0,1,0,0,0,0
Nikolay KOLEV,Bulgaria,Middle Blocker,Men,China,2022-07-09,Pool,1,4,7,5,0,1,6,2,2,0,4,0,0,9,9,0,0,1,1,0,0,0,0,0,0,0,0
Martin ATANASOV,Bulgaria,Outside Hitter,Men,China,2022-07-09,Pool,1,4,10,10,3,4,17,0,2,0,2,0,3,8,11,2,1,21,24,0,2,0,2,0,1,2,3
Svetoslav GOTSEV,Bulgaria,Middle Blocker,Men,China,2022-07-09,Pool,1,4,11,7,0,3,10,4,5,1,10,0,1,11,12,0,1,0,1,0,1,1,2,0,0,0,0
Dobromir DIMITROV,Bulgaria,Setter,Men,China,2022-07-09,Pool,1,4,1,0,1,0,1,0,0,0,0,1,1,5,7,0,0,0,0,1,1,0,2,6,0,15,21
Georgi SEGANOV,Bulgaria,Setter,Men,China,2022-07-09,Pool,1,4,0,0,2,0,2,0,2,0,2,0,1,8,9,0,0,0,0,1,0,0,1,13,0,49,62
Asparuh ASPARUHOV,Bulgaria,Outside Hitter,Men,China,2022-07-09,Pool,1,4,2,1,1,2,4,1,1,0,2,0,1,1,2,1,0,5,6,1,0,0,1,0,0,2,2
Radoslav PARAPUNOV,Bulgaria,Opposite Spiker,Men,China,2022-07-09,Pool,1,4,0,0,0,0,0,0,0,0,0,0,0,0,0,0,0,0,0,0,0,0,0,0,0,0,0
Vladislav IVANOV,Bulgaria,Libero,Men,China,2022-07-09,Pool,1,4,0,0,0,0,0,0,0,0,0,0,0,0,0,4,3,9,16,5,2,2,9,0,0,5,5
Samuil VALCHINOV,Bulgaria,Outside Hitter,Men,China,2022-07-09,Pool,1,4,0,0,0,0,0,0,0,0,0,0,0,0,0,0,0,0,0,0,0,0,0,0,0,0,0
Svetoslav IVANOV,Bulgaria,Outside Hitter,Men,China,2022-07-09,Pool,1,4,3,2,1,1,4,0,1,0,1,1,1,3,5,0,0,8,8,1,0,0,1,0,0,0,0
Iliya PETKOV,Bulgaria,Middle Blocker,Men,China,2022-07-09,Pool,1,4,0,0,0,0,0,0,0,0,0,0,0,0,0,0,0,0,0,0,0,0,0,0,0,0,0
Aleksandar NIKOLOV,Bulgaria,Outside Hitter,Men,China,2022-07-09,Pool,1,4,11,11,2,7,20,0,2,0,2,0,0,10,10,1,2,24,27,2,0,0,2,0,0,1,1
Denis KARYAGIN,Bulgaria,Opposite Spiker,Men,Netherlands,2022-07-08,Pool,3,4,12,10,4,4,18,0,1,0,1,2,3,8,13,0,0,0,0,4,0,0,4,0,0,2,2
Stefan CHAVDAROV,Bulgaria,Middle Blocker,Men,Netherlands,2022-07-08,Pool,3,4,0,0,0,0,0,0,0,0,0,0,0,0,0,0,0,0,0,0,0,0,0,0,0,0,0
Nikolay KOLEV,Bulgaria,Middle Blocker,Men,Netherlands,2022-07-08,Pool,3,4,7,5,2,1,8,2,3,0,5,0,0,17,17,0,0,0,0,0,0,0,0,1,0,0,1
Martin ATANASOV,Bulgaria,Outside Hitter,Men,Netherlands,2022-07-08,Pool,3,4,20,17,1,15,33,1,3,0,4,2,1,7,10,1,1,17,19,0,0,0,0,0,0,0,0
Svetoslav GOTSEV,Bulgaria,Middle Blocker,Men,Netherlands,2022-07-08,Pool,3,4,12,6,0,4,10,6,5,0,11,0,2,8,10,0,0,0,0,2,1,0,3,0,0,0,0
Dobromir DIMITROV,Bulgaria,Setter,Men,Netherlands,2022-07-08,Pool,3,4,0,0,0,0,0,0,0,0,0,0,0,3,3,0,0,0,0,0,0,0,0,0,0,0,0
Georgi SEGANOV,Bulgaria,Setter,Men,Netherlands,2022-07-08,Pool,3,4,3,0,0,1,1,2,2,0,4,1,0,15,16,0,0,0,0,0,1,1,2,19,2,77,98
Asparuh ASPARUHOV,Bulgaria,Outside Hitter,Men,Netherlands,2022-07-08,Pool,3,4,0,0,0,0,0,0,0,0,0,0,0,0,0,0,0,0,0,0,0,0,0,0,0,0,0
Radoslav PARAPUNOV,Bulgaria,Opposite Spiker,Men,Netherlands,2022-07-08,Pool,3,4,2,1,2,5,8,1,1,0,2,0,2,7,9,0,0,1,1,0,0,0,0,0,0,1,1
Vladislav IVANOV,Bulgaria,Libero,Men,Netherlands,2022-07-08,Pool,3,4,0,0,0,0,0,0,0,0,0,0,0,0,0,5,2,13,20,4,3,2,9,0,0,1,1
Samuil VALCHINOV,Bulgaria,Outside Hitter,Men,Netherlands,2022-07-08,Pool,3,4,0,0,0,0,0,0,0,0,0,0,0,0,0,0,0,0,0,0,0,0,0,0,0,0,0
Svetoslav IVANOV,Bulgaria,Outside Hitter,Men,Netherlands,2022-07-08,Pool,3,4,0,0,0,0,0,0,0,0,0,0,0,0,0,0,0,2,2,0,0,1,1,0,0,0,0
Iliya PETKOV,Bulgaria,Middle Blocker,Men,Netherlands,2022-07-08,Pool,3,4,0,0,0,0,0,0,0,0,0,0,0,0,0,0,0,0,0,0,0,0,0,0,0,0,0
Aleksandar NIKOLOV,Bulgaria,Outside Hitter,Men,Netherlands,2022-07-08,Pool,3,4,14,14,3,7,24,0,3,0,3,0,4,14,18,4,3,24,31,0,2,0,2,0,0,1,1
Denis KARYAGIN,Bulgaria,Opposite Spiker,Men,Slovenia,2022-07-07,Pool,1,4,0,0,0,0,0,0,0,0,0,0,0,0,0,0,0,0,0,0,0,0,0,0,0,0,0
Stefan CHAVDAROV,Bulgaria,Middle Blocker,Men,Slovenia,2022-07-07,Pool,1,4,0,0,1,0,1,0,0,0,0,0,2,0,2,0,0,0,0,0,0,0,0,0,0,0,0
Nikolay KOLEV,Bulgaria,Middle Blocker,Men,Slovenia,2022-07-07,Pool,1,4,8,7,0,1,8,1,4,0,5,0,0,12,12,0,0,1,1,0,1,1,2,0,0,0,0
Martin ATANASOV,Bulgaria,Outside Hitter,Men,Slovenia,2022-07-07,Pool,1,4,15,12,2,11,25,1,3,0,4,2,3,9,14,6,2,21,29,1,2,0,3,0,1,0,1
Svetoslav GOTSEV,Bulgaria,Middle Blocker,Men,Slovenia,2022-07-07,Pool,1,4,8,4,3,2,9,3,4,0,7,1,2,8,11,0,0,0,0,0,1,0,1,0,0,1,1
Dobromir DIMITROV,Bulgaria,Setter,Men,Slovenia,2022-07-07,Pool,1,4,0,0,0,1,1,0,1,0,1,0,0,4,4,0,0,0,0,0,1,0,1,6,0,8,14
Georgi SEGANOV,Bulgaria,Setter,Men,Slovenia,2022-07-07,Pool,1,4,2,1,0,0,1,1,1,0,2,0,1,10,11,0,0,0,0,0,1,0,1,16,0,64,80
Asparuh ASPARUHOV,Bulgaria,Outside Hitter,Men,Slovenia,2022-07-07,Pool,1,4,4,4,6,5,15,0,1,0,1,0,2,5,7,0,0,1,1,0,0,0,0,0,0,1,1
Radoslav PARAPUNOV,Bulgaria,Opposite Spiker,Men,Slovenia,2022-07-07,Pool,1,4,7,6,3,7,16,0,1,0,1,1,2,3,6,0,0,1,1,1,0,0,1,0,0,1,1
Vladislav IVANOV,Bulgaria,Libero,Men,Slovenia,2022-07-07,Pool,1,4,0,0,0,0,0,0,0,0,0,0,0,0,0,1,0,22,23,2,0,0,2,0,0,1,1
Samuil VALCHINOV,Bulgaria,Outside Hitter,Men,Slovenia,2022-07-07,Pool,1,4,0,0,0,0,0,0,0,0,0,0,0,0,0,0,0,0,0,0,0,0,0,0,0,0,0
Svetoslav IVANOV,Bulgaria,Outside Hitter,Men,Slovenia,2022-07-07,Pool,1,4,1,1,0,0,1,0,0,0,0,0,0,0,0,0,0,3,3,0,1,0,1,0,0,0,0
Iliya PETKOV,Bulgaria,Middle Blocker,Men,Slovenia,2022-07-07,Pool,1,4,0,0,0,0,0,0,0,0,0,0,0,0,0,0,0,0,0,0,0,0,0,0,0,0,0
Aleksandar NIKOLOV,Bulgaria,Outside Hitter,Men,Slovenia,2022-07-07,Pool,1,4,13,10,6,7,23,3,3,0,6,0,6,9,15,2,1,22,25,1,0,0,1,0,0,0,0
Denis KARYAGIN,Bulgaria,Opposite Spiker,Men,Italy,2022-07-05,Pool,0,3,2,2,2,2,6,0,0,0,0,0,2,0,2,0,0,0,0,0,0,0,0,0,0,0,0
Stefan CHAVDAROV,Bulgaria,Middle Blocker,Men,Italy,2022-07-05,Pool,0,3,3,3,2,3,8,0,0,1,1,0,0,4,4,0,0,1,1,1,0,0,1,0,0,0,0
Nikolay KOLEV,Bulgaria,Middle Blocker,Men,Italy,2022-07-05,Pool,0,3,2,2,1,0,3,0,0,0,0,0,1,6,7,0,0,0,0,1,1,0,2,0,0,0,0
Martin ATANASOV,Bulgaria,Outside Hitter,Men,Italy,2022-07-05,Pool,0,3,14,13,5,6,24,0,1,1,2,1,3,8,12,2,0,10,12,0,1,0,1,0,0,0,0
Svetoslav GOTSEV,Bulgaria,Middle Blocker,Men,Italy,2022-07-05,Pool,0,3,4,2,0,2,4,2,1,0,3,0,0,9,9,0,0,1,1,2,1,0,3,0,0,0,0
Dobromir DIMITROV,Bulgaria,Setter,Men,Italy,2022-07-05,Pool,0,3,0,0,0,0,0,0,0,0,0,0,0,0,0,0,0,0,0,0,0,0,0,0,0,0,0
Georgi SEGANOV,Bulgaria,Setter,Men,Italy,2022-07-05,Pool,0,3,0,0,0,0,0,0,0,0,0,0,1,8,9,0,0,0,0,0,0,0,0,11,1,71,83
Asparuh ASPARUHOV,Bulgaria,Outside Hitter,Men,Italy,2022-07-05,Pool,0,3,0,0,2,1,3,0,0,0,0,0,0,0,0,0,0,1,1,0,0,0,0,0,0,0,0
Radoslav PARAPUNOV,Bulgaria,Opposite Spiker,Men,Italy,2022-07-05,Pool,0,3,5,4,5,9,18,0,1,0,1,1,2,5,8,0,1,2,3,0,0,0,0,0,0,0,0
Vladislav IVANOV,Bulgaria,Libero,Men,Italy,2022-07-05,Pool,0,3,0,0,0,0,0,0,0,0,0,0,0,0,0,3,3,10,16,2,0,2,4,0,0,1,1
Samuil VALCHINOV,Bulgaria,Outside Hitter,Men,Italy,2022-07-05,Pool,0,3,0,0,0,0,0,0,0,0,0,0,0,0,0,0,0,0,0,0,0,0,0,0,0,0,0
Svetoslav IVANOV,Bulgaria,Outside Hitter,Men,Italy,2022-07-05,Pool,0,3,0,0,0,0,0,0,0,0,0,0,0,0,0,0,0,0,0,0,0,0,0,0,0,0,0
Iliya PETKOV,Bulgaria,Middle Blocker,Men,Italy,2022-07-05,Pool,0,3,0,0,0,0,0,0,0,0,0,0,0,0,0,0,0,0,0,0,0,0,0,0,0,0,0
Aleksandar NIKOLOV,Bulgaria,Outside Hitter,Men,Italy,2022-07-05,Pool,0,3,11,11,2,5,18,0,0,0,0,0,2,6,8,5,2,24,31,0,1,0,1,0,0,0,0
Denis KARYAGIN,Bulgaria,Opposite Spiker,Men,Brazil,2022-06-26,Pool,0,3,1,1,0,1,2,0,0,1,1,0,0,2,2,0,0,0,0,0,0,0,0,0,0,0,0
Stefan CHAVDAROV,Bulgaria,Middle Blocker,Men,Brazil,2022-06-26,Pool,0,3,7,6,0,1,7,1,1,3,5,0,2,5,7,0,0,0,0,0,2,1,3,0,0,0,0
Nikolay KOLEV,Bulgaria,Middle Blocker,Men,Brazil,2022-06-26,Pool,0,3,5,1,1,3,5,3,2,2,7,1,0,11,12,1,0,3,4,2,0,0,2,0,0,0,0
Martin ATANASOV,Bulgaria,Outside Hitter,Men,Brazil,2022-06-26,Pool,0,3,12,12,3,7,22,0,1,0,1,0,1,7,8,11,0,11,22,3,0,0,3,0,0,1,1
Svetoslav GOTSEV,Bulgaria,Middle Blocker,Men,Brazil,2022-06-26,Pool,0,3,0,0,0,0,0,0,0,0,0,0,0,0,0,0,0,0,0,0,0,0,0,0,0,0,0
Dobromir DIMITROV,Bulgaria,Setter,Men,Brazil,2022-06-26,Pool,0,3,2,2,1,0,3,0,3,0,3,0,2,10,12,0,0,0,0,1,1,0,2,19,2,51,72
Georgi SEGANOV,Bulgaria,Setter,Men,Brazil,2022-06-26,Pool,0,3,0,0,0,0,0,0,0,0,0,0,0,0,0,0,0,0,0,0,0,0,0,0,0,0,0
Asparuh ASPARUHOV,Bulgaria,Outside Hitter,Men,Brazil,2022-06-26,Pool,0,3,9,6,3,5,14,2,2,1,5,1,3,1,5,5,0,10,15,0,1,0,1,0,0,0,0
Radoslav PARAPUNOV,Bulgaria,Opposite Spiker,Men,Brazil,2022-06-26,Pool,0,3,8,6,3,7,16,2,2,0,4,0,4,5,9,1,0,2,3,2,2,0,4,0,0,0,0
Vladislav IVANOV,Bulgaria,Libero,Men,Brazil,2022-06-26,Pool,0,3,0,0,0,0,0,0,0,0,0,0,0,0,0,2,1,7,10,2,0,0,2,0,0,2,2
Svetoslav IVANOV,Bulgaria,Outside Hitter,Men,Brazil,2022-06-26,Pool,0,3,0,0,0,0,0,0,0,0,0,0,0,2,2,0,0,1,1,0,0,0,0,0,0,0,0
Iliya PETKOV,Bulgaria,Middle Blocker,Men,Brazil,2022-06-26,Pool,0,3,0,0,0,0,0,0,0,0,0,0,0,0,0,0,0,0,0,0,0,0,0,0,0,0,0
Aleksandar NIKOLOV,Bulgaria,Outside Hitter,Men,Brazil,2022-06-26,Pool,0,3,5,4,2,2,8,0,1,0,1,1,0,6,7,1,3,3,7,0,0,0,0,0,0,0,0
Martin IVANOV,Bulgaria,Libero,Men,Brazil,2022-06-26,Pool,0,3,0,0,0,0,0,0,0,0,0,0,0,0,0,0,0,0,0,0,0,0,0,0,0,0,0
Denis KARYAGIN,Bulgaria,Opposite Spiker,Men,United States,2022-06-25,Pool,1,4,0,0,0,0,0,0,0,0,0,0,0,0,0,0,0,0,0,0,0,0,0,0,0,0,0
Stefan CHAVDAROV,Bulgaria,Middle Blocker,Men,United States,2022-06-25,Pool,1,4,5,3,0,2,5,1,2,3,6,1,4,9,14,0,0,1,1,1,0,0,1,0,0,0,0
Nikolay KOLEV,Bulgaria,Middle Blocker,Men,United States,2022-06-25,Pool,1,4,4,4,0,1,5,0,1,1,2,0,1,4,5,0,0,2,2,0,0,0,0,0,0,0,0
Martin ATANASOV,Bulgaria,Outside Hitter,Men,United States,2022-06-25,Pool,1,4,11,9,5,13,27,0,2,1,3,2,4,11,17,9,2,16,27,2,0,0,2,1,0,1,2
Svetoslav GOTSEV,Bulgaria,Middle Blocker,Men,United States,2022-06-25,Pool,1,4,6,4,0,3,7,2,4,3,9,0,1,7,8,0,0,1,1,1,0,0,1,1,0,0,1
Dobromir DIMITROV,Bulgaria,Setter,Men,United States,2022-06-25,Pool,1,4,0,0,0,0,0,0,0,0,0,0,0,2,2,0,0,0,0,0,0,0,0,1,0,9,10
Georgi SEGANOV,Bulgaria,Setter,Men,United States,2022-06-25,Pool,1,4,0,0,0,1,1,0,1,1,2,0,1,11,12,0,0,1,1,1,1,1,3,22,1,63,86
Asparuh ASPARUHOV,Bulgaria,Outside Hitter,Men,United States,2022-06-25,Pool,1,4,0,0,0,0,0,0,0,0,0,0,0,0,0,0,0,0,0,0,0,0,0,0,0,0,0
Radoslav PARAPUNOV,Bulgaria,Opposite Spiker,Men,United States,2022-06-25,Pool,1,4,15,13,6,8,27,2,3,3,8,0,2,9,11,1,0,1,2,3,1,0,4,0,0,0,0
Vladislav IVANOV,Bulgaria,Libero,Men,United States,2022-06-25,Pool,1,4,0,0,0,0,0,0,0,0,0,0,0,0,0,1,1,12,14,2,4,0,6,0,0,2,2
Svetoslav IVANOV,Bulgaria,Outside Hitter,Men,United States,2022-06-25,Pool,1,4,0,0,0,0,0,0,0,0,0,0,0,0,0,1,0,1,2,0,0,0,0,0,0,0,0
Iliya PETKOV,Bulgaria,Middle Blocker,Men,United States,2022-06-25,Pool,1,4,0,0,0,0,0,0,0,0,0,0,0,0,0,0,0,0,0,0,0,0,0,0,0,0,0
Aleksandar NIKOLOV,Bulgaria,Outside Hitter,Men,United States,2022-06-25,Pool,1,4,17,14,4,14,32,0,4,0,4,3,3,10,16,10,5,12,27,2,3,0,5,0,0,0,0
Martin IVANOV,Bulgaria,Libero,Men,United States,2022-06-25,Pool,1,4,0,0,0,0,0,0,0,0,0,0,0,0,0,0,0,0,0,0,0,0,0,0,0,0,0
Denis KARYAGIN,Bulgaria,Opposite Spiker,Men,Australia,2022-06-24,Pool,2,5,1,1,2,2,5,0,0,0,0,0,0,1,1,0,0,0,0,0,0,0,0,0,0,0,0
Stefan CHAVDAROV,Bulgaria,Middle Blocker,Men,Australia,2022-06-24,Pool,2,5,4,2,1,1,4,1,1,0,2,1,1,7,9,0,0,0,0,0,0,0,0,0,0,0,0
Nikolay KOLEV,Bulgaria,Middle Blocker,Men,Australia,2022-06-24,Pool,2,5,7,5,3,5,13,2,2,0,4,0,0,6,6,0,0,0,0,0,0,0,0,0,0,1,1
Martin ATANASOV,Bulgaria,Outside Hitter,Men,Australia,2022-06-24,Pool,2,5,14,11,6,11,28,0,3,0,3,3,5,13,21,13,1,15,29,3,2,0,5,0,0,0,0
Svetoslav GOTSEV,Bulgaria,Middle Blocker,Men,Australia,2022-06-24,Pool,2,5,17,10,0,5,15,7,2,10,19,0,1,10,11,0,0,1,1,1,0,0,1,0,0,1,1
Dobromir DIMITROV,Bulgaria,Setter,Men,Australia,2022-06-24,Pool,2,5,1,0,0,0,0,0,0,1,1,1,1,5,7,0,0,0,0,0,0,0,0,1,0,4,5
Georgi SEGANOV,Bulgaria,Setter,Men,Australia,2022-06-24,Pool,2,5,4,2,1,1,4,2,4,3,9,0,1,14,15,0,0,0,0,1,1,1,3,40,1,61,102
Asparuh ASPARUHOV,Bulgaria,Outside Hitter,Men,Australia,2022-06-24,Pool,2,5,6,4,0,4,8,2,3,1,6,0,2,7,9,0,0,0,0,2,0,0,2,0,0,0,0
Radoslav PARAPUNOV,Bulgaria,Opposite Spiker,Men,Australia,2022-06-24,Pool,2,5,5,5,7,3,15,0,1,4,5,0,1,4,5,0,0,0,0,2,1,0,3,0,0,0,0
Vladislav IVANOV,Bulgaria,Libero,Men,Australia,2022-06-24,Pool,2,5,0,0,0,0,0,0,0,0,0,0,0,0,0,6,1,14,21,4,2,5,11,2,0,5,7
Svetoslav IVANOV,Bulgaria,Outside Hitter,Men,Australia,2022-06-24,Pool,2,5,1,1,0,0,1,0,0,1,1,0,0,0,0,2,0,2,4,0,0,0,0,0,0,0,0
Iliya PETKOV,Bulgaria,Middle Blocker,Men,Australia,2022-06-24,Pool,2,5,0,0,0,0,0,0,0,0,0,0,0,0,0,0,0,0,0,0,0,0,0,0,0,0,0
Aleksandar NIKOLOV,Bulgaria,Outside Hitter,Men,Australia,2022-06-24,Pool,2,5,17,12,4,9,25,3,3,3,9,2,2,12,16,9,5,25,39,4,2,1,7,2,0,0,2
Martin IVANOV,Bulgaria,Libero,Men,Australia,2022-06-24,Pool,2,5,0,0,0,0,0,0,0,0,0,0,0,0,0,0,0,0,0,0,0,0,0,0,0,0,0
Denis KARYAGIN,Bulgaria,Opposite Spiker,Men,Iran,2022-06-21,Pool,3,3,0,0,0,0,0,0,0,0,0,0,0,0,0,0,0,0,0,0,0,0,0,0,0,0,0
Stefan CHAVDAROV,Bulgaria,Middle Blocker,Men,Iran,2022-06-21,Pool,3,3,0,0,0,0,0,0,0,0,0,0,0,0,0,0,0,0,0,0,0,0,0,0,0,0,0
Nikolay KOLEV,Bulgaria,Middle Blocker,Men,Iran,2022-06-21,Pool,3,3,7,5,3,2,10,1,5,3,9,1,0,13,14,0,0,2,2,1,0,0,1,0,0,0,0
Martin ATANASOV,Bulgaria,Outside Hitter,Men,Iran,2022-06-21,Pool,3,3,14,10,2,5,17,0,3,2,5,4,2,11,17,8,0,8,16,0,0,1,1,0,0,2,2
Svetoslav GOTSEV,Bulgaria,Middle Blocker,Men,Iran,2022-06-21,Pool,3,3,10,4,1,1,6,6,8,2,16,0,0,11,11,1,1,0,2,3,0,0,3,0,0,0,0
Dobromir DIMITROV,Bulgaria,Setter,Men,Iran,2022-06-21,Pool,3,3,0,0,0,0,0,0,0,0,0,0,0,0,0,0,0,0,0,0,0,0,0,0,0,0,0
Georgi SEGANOV,Bulgaria,Setter,Men,Iran,2022-06-21,Pool,3,3,1,1,0,0,1,0,0,5,5,0,3,10,13,0,0,0,0,5,1,0,6,19,0,50,69
Asparuh ASPARUHOV,Bulgaria,Outside Hitter,Men,Iran,2022-06-21,Pool,3,3,0,0,0,0,0,0,0,0,0,0,0,0,0,0,0,0,0,0,0,0,0,0,0,0,0
Radoslav PARAPUNOV,Bulgaria,Opposite Spiker,Men,Iran,2022-06-21,Pool,3,3,6,4,3,5,12,1,2,0,3,1,2,8,11,0,0,0,0,1,0,0,1,1,0,0,1
Vladislav IVANOV,Bulgaria,Libero,Men,Iran,2022-06-21,Pool,3,3,0,0,0,0,0,0,0,0,0,0,0,0,0,9,0,9,18,3,2,0,5,1,0,3,4
Svetoslav IVANOV,Bulgaria,Outside Hitter,Men,Iran,2022-06-21,Pool,3,3,0,0,0,0,0,0,0,0,0,0,0,0,0,0,0,0,0,0,0,0,0,0,0,0,0
Iliya PETKOV,Bulgaria,Middle Blocker,Men,Iran,2022-06-21,Pool,3,3,0,0,0,0,0,0,0,0,0,0,0,0,0,0,0,0,0,0,0,0,0,0,0,0,0
Aleksandar NIKOLOV,Bulgaria,Outside Hitter,Men,Iran,2022-06-21,Pool,3,3,20,20,4,7,31,0,2,1,3,0,4,5,9,6,0,13,19,0,1,1,2,0,0,1,1
Martin IVANOV,Bulgaria,Libero,Men,Iran,2022-06-21,Pool,3,3,0,0,0,0,0,0,0,0,0,0,0,0,0,0,0,0,0,0,0,0,0,0,0,0,0
Denis KARYAGIN,Bulgaria,Opposite Spiker,Men,Canada,2022-06-12,Pool,2,5,0,0,0,0,0,0,0,0,0,0,0,0,0,0,0,0,0,0,0,0,0,0,0,0,0
Stefan CHAVDAROV,Bulgaria,Middle Blocker,Men,Canada,2022-06-12,Pool,2,5,0,0,0,0,0,0,0,0,0,0,0,0,0,0,0,0,0,0,0,0,0,0,0,0,0
Nikolay KOLEV,Bulgaria,Middle Blocker,Men,Canada,2022-06-12,Pool,2,5,11,9,0,1,10,1,1,4,6,1,1,14,16,1,0,2,3,1,0,0,1,0,0,2,2
Martin ATANASOV,Bulgaria,Outside Hitter,Men,Canada,2022-06-12,Pool,2,5,4,4,4,5,13,0,1,0,1,0,1,6,7,3,1,10,14,0,1,0,1,0,0,0,0
Svetoslav GOTSEV,Bulgaria,Middle Blocker,Men,Canada,2022-06-12,Pool,2,5,0,0,0,0,0,0,0,0,0,0,0,0,0,0,0,0,0,0,0,0,0,0,0,0,0
Dobromir DIMITROV,Bulgaria,Setter,Men,Canada,2022-06-12,Pool,2,5,0,0,0,0,0,0,1,1,2,0,0,1,1,0,0,0,0,0,0,0,0,1,0,0,1
Georgi SEGANOV,Bulgaria,Setter,Men,Canada,2022-06-12,Pool,2,5,2,1,0,2,3,1,7,3,11,0,2,10,12,0,0,1,1,8,4,4,16,54,0,36,90
Aleks GROZDANOV,Bulgaria,Middle Blocker,Men,Canada,2022-06-12,Pool,2,5,6,4,1,6,11,2,6,6,14,0,1,14,15,2,0,0,2,3,3,1,7,0,0,1,1
Asparuh ASPARUHOV,Bulgaria,Outside Hitter,Men,Canada,2022-06-12,Pool,2,5,15,12,3,7,22,0,5,2,7,3,1,6,10,1,0,12,13,0,0,1,1,1,0,1,2
Radoslav PARAPUNOV,Bulgaria,Opposite Spiker,Men,Canada,2022-06-12,Pool,2,5,13,9,6,7,22,3,4,5,12,1,4,15,20,1,0,2,3,5,2,1,8,0,0,2,2
Samuil VALCHINOV,Bulgaria,Outside Hitter,Men,Canada,2022-06-12,Pool,2,5,0,0,0,0,0,0,0,0,0,0,0,0,0,0,0,0,0,0,0,0,0,0,0,0,0
Svetoslav IVANOV,Bulgaria,Outside Hitter,Men,Canada,2022-06-12,Pool,2,5,0,0,0,0,0,0,0,0,0,0,0,0,0,0,0,0,0,0,0,0,0,0,0,0,0
Aleksandar NIKOLOV,Bulgaria,Outside Hitter,Men,Canada,2022-06-12,Pool,2,5,17,13,6,13,32,2,5,3,10,2,3,12,17,5,3,22,30,8,1,1,10,0,0,7,7
Martin IVANOV,Bulgaria,Libero,Men,Canada,2022-06-12,Pool,2,5,0,0,0,0,0,0,0,0,0,0,0,0,0,8,3,12,23,3,3,3,9,1,1,5,7
Denis KARYAGIN,Bulgaria,Opposite Spiker,Men,Poland,2022-06-11,Pool,0,3,3,2,4,5,11,1,1,2,4,0,2,1,3,1,0,0,1,2,2,0,4,0,0,0,0
Stefan CHAVDAROV,Bulgaria,Middle Blocker,Men,Poland,2022-06-11,Pool,0,3,3,3,0,1,4,0,1,2,3,0,2,6,8,0,0,1,1,1,1,2,4,0,0,0,0
Nikolay KOLEV,Bulgaria,Middle Blocker,Men,Poland,2022-06-11,Pool,0,3,13,9,0,2,11,4,4,7,15,0,0,9,9,0,0,1,1,3,2,0,5,1,0,2,3
Martin ATANASOV,Bulgaria,Outside Hitter,Men,Poland,2022-06-11,Pool,0,3,1,1,0,4,5,0,1,0,1,0,2,1,3,3,1,5,9,1,0,0,1,0,0,0,0
Svetoslav GOTSEV,Bulgaria,Middle Blocker,Men,Poland,2022-06-11,Pool,0,3,0,0,0,0,0,0,0,0,0,0,0,0,0,0,0,0,0,0,0,0,0,0,0,0,0
Dobromir DIMITROV,Bulgaria,Setter,Men,Poland,2022-06-11,Pool,0,3,0,0,0,0,0,0,0,0,0,0,0,5,5,0,0,0,0,0,2,0,2,13,0,6,19
Georgi SEGANOV,Bulgaria,Setter,Men,Poland,2022-06-11,Pool,0,3,0,0,0,1,1,0,0,2,2,0,2,7,9,0,0,1,1,4,3,1,8,24,0,26,50
Aleks GROZDANOV,Bulgaria,Middle Blocker,Men,Poland,2022-06-11,Pool,0,3,2,1,0,2,3,0,2,3,5,1,0,3,4,0,1,0,1,0,0,1,1,0,0,0,0
Asparuh ASPARUHOV,Bulgaria,Outside Hitter,Men,Poland,2022-06-11,Pool,0,3,4,2,2,6,10,1,0,1,2,1,1,3,5,1,2,4,7,1,0,1,2,1,0,0,1
Radoslav PARAPUNOV,Bulgaria,Opposite Spiker,Men,Poland,2022-06-11,Pool,0,3,6,6,2,2,10,0,2,5,7,0,2,2,4,0,0,0,0,2,1,0,3,0,0,2,2
Samuil VALCHINOV,Bulgaria,Outside Hitter,Men,Poland,2022-06-11,Pool,0,3,0,0,0,0,0,0,0,0,0,0,0,0,0,0,0,0,0,0,0,0,0,0,0,0,0
Svetoslav IVANOV,Bulgaria,Outside Hitter,Men,Poland,2022-06-11,Pool,0,3,5,4,4,2,10,1,1,1,3,0,2,2,4,7,1,9,17,1,0,0,1,0,0,2,2
Aleksandar NIKOLOV,Bulgaria,Outside Hitter,Men,Poland,2022-06-11,Pool,0,3,9,8,0,11,19,1,2,1,4,0,0,8,8,4,0,13,17,5,0,1,6,0,0,2,2
Martin IVANOV,Bulgaria,Libero,Men,Poland,2022-06-11,Pool,0,3,0,0,0,0,0,0,0,0,0,0,0,0,0,3,1,5,9,3,1,2,6,0,0,5,5
Denis KARYAGIN,Bulgaria,Opposite Spiker,Men,Germany,2022-06-10,Pool,2,5,5,5,4,8,17,0,2,1,3,0,1,2,3,0,0,0,0,1,0,0,1,0,0,2,2
Stefan CHAVDAROV,Bulgaria,Middle Blocker,Men,Germany,2022-06-10,Pool,2,5,0,0,0,0,0,0,0,0,0,0,0,0,0,0,0,0,0,0,0,0,0,0,0,0,0
Nikolay KOLEV,Bulgaria,Middle Blocker,Men,Germany,2022-06-10,Pool,2,5,5,5,1,2,8,0,6,4,10,0,0,13,13,0,0,0,0,0,0,0,0,0,0,0,0
Martin ATANASOV,Bulgaria,Outside Hitter,Men,Germany,2022-06-10,Pool,2,5,18,13,4,9,26,4,2,2,8,1,5,13,19,3,1,20,24,7,2,1,10,0,0,3,3
Svetoslav GOTSEV,Bulgaria,Middle Blocker,Men,Germany,2022-06-10,Pool,2,5,1,1,1,0,2,0,5,0,5,0,1,9,10,0,0,0,0,0,0,0,0,0,0,0,0
Dobromir DIMITROV,Bulgaria,Setter,Men,Germany,2022-06-10,Pool,2,5,0,0,0,0,0,0,0,0,0,0,0,1,1,0,0,0,0,0,0,0,0,0,0,0,0
Georgi SEGANOV,Bulgaria,Setter,Men,Germany,2022-06-10,Pool,2,5,4,3,0,1,4,1,3,1,5,0,1,15,16,0,0,0,0,6,4,3,13,37,2,59,98
Aleks GROZDANOV,Bulgaria,Middle Blocker,Men,Germany,2022-06-10,Pool,2,5,6,5,1,3,9,1,4,8,13,0,2,7,9,1,0,0,1,2,0,1,3,0,0,2,2
Asparuh ASPARUHOV,Bulgaria,Outside Hitter,Men,Germany,2022-06-10,Pool,2,5,0,0,0,0,0,0,0,0,0,0,0,0,0,0,0,0,0,0,0,0,0,0,0,0,0
Radoslav PARAPUNOV,Bulgaria,Opposite Spiker,Men,Germany,2022-06-10,Pool,2,5,6,5,5,3,13,1,3,3,7,0,2,6,8,0,0,2,2,1,2,0,3,0,0,0,0
Samuil VALCHINOV,Bulgaria,Outside Hitter,Men,Germany,2022-06-10,Pool,2,5,0,0,0,0,0,0,0,0,0,0,0,0,0,0,0,0,0,0,0,0,0,0,0,0,0
Svetoslav IVANOV,Bulgaria,Outside Hitter,Men,Germany,2022-06-10,Pool,2,5,0,0,0,0,0,0,0,0,0,0,0,0,0,1,0,1,2,1,1,0,2,0,0,0,0
Aleksandar NIKOLOV,Bulgaria,Outside Hitter,Men,Germany,2022-06-10,Pool,2,5,25,21,4,8,33,3,3,4,10,1,6,10,17,10,4,21,35,3,2,1,6,0,0,0,0
Martin IVANOV,Bulgaria,Libero,Men,Germany,2022-06-10,Pool,2,5,0,0,0,0,0,0,0,0,0,0,0,0,0,5,0,22,27,7,2,0,9,0,0,2,2
Denis KARYAGIN,Bulgaria,Opposite Spiker,Men,Serbia,2022-06-07,Pool,1,4,1,1,0,0,1,0,0,0,0,0,0,0,0,0,0,0,0,0,0,0,0,0,0,0,0
Stefan CHAVDAROV,Bulgaria,Middle Blocker,Men,Serbia,2022-06-07,Pool,1,4,0,0,0,0,0,0,0,0,0,0,0,0,0,0,0,0,0,0,0,0,0,0,0,0,0
Nikolay KOLEV,Bulgaria,Middle Blocker,Men,Serbia,2022-06-07,Pool,1,4,1,1,0,0,1,0,2,0,2,0,0,1,1,0,0,0,0,0,0,0,0,0,0,0,0
Martin ATANASOV,Bulgaria,Outside Hitter,Men,Serbia,2022-06-07,Pool,1,4,6,5,5,8,18,1,3,0,4,0,4,4,8,3,0,11,14,1,1,0,2,0,0,0,0
Svetoslav GOTSEV,Bulgaria,Middle Blocker,Men,Serbia,2022-06-07,Pool,1,4,13,6,1,2,9,5,4,3,12,2,1,18,21,0,0,3,3,2,2,2,6,0,0,2,2
Dobromir DIMITROV,Bulgaria,Setter,Men,Serbia,2022-06-07,Pool,1,4,0,0,0,1,1,0,0,0,0,0,0,1,1,0,0,0,0,0,0,1,1,7,0,3,10
Georgi SEGANOV,Bulgaria,Setter,Men,Serbia,2022-06-07,Pool,1,4,2,1,0,0,1,1,0,1,2,0,1,11,12,0,0,1,1,2,5,4,11,46,1,31,78
Aleks GROZDANOV,Bulgaria,Middle Blocker,Men,Serbia,2022-06-07,Pool,1,4,11,5,1,5,11,5,8,11,24,1,2,7,10,0,0,0,0,1,1,1,3,0,0,1,1
Asparuh ASPARUHOV,Bulgaria,Outside Hitter,Men,Serbia,2022-06-07,Pool,1,4,8,8,0,2,10,0,0,0,0,0,1,5,6,0,2,13,15,0,0,1,1,0,0,0,0
Radoslav PARAPUNOV,Bulgaria,Opposite Spiker,Men,Serbia,2022-06-07,Pool,1,4,15,13,2,7,22,2,6,2,10,0,3,8,11,0,0,1,1,2,9,1,12,0,0,2,2
Samuil VALCHINOV,Bulgaria,Outside Hitter,Men,Serbia,2022-06-07,Pool,1,4,0,0,0,0,0,0,0,0,0,0,0,0,0,0,0,0,0,0,0,0,0,0,0,0,0
Svetoslav IVANOV,Bulgaria,Outside Hitter,Men,Serbia,2022-06-07,Pool,1,4,0,0,0,0,0,0,0,0,0,0,0,0,0,0,0,1,1,0,0,0,0,0,0,0,0
Aleksandar NIKOLOV,Bulgaria,Outside Hitter,Men,Serbia,2022-06-07,Pool,1,4,13,12,6,7,25,1,4,0,5,0,1,16,17,5,3,27,35,1,2,5,8,0,0,1,1
Martin IVANOV,Bulgaria,Libero,Men,Serbia,2022-06-07,Pool,1,4,0,0,0,0,0,0,0,0,0,0,0,0,0,2,3,10,15,1,7,4,12,0,1,3,4
Jesse ELSER,Canada,Outside Hitter,Men,Bulgaria,2022-06-12,Pool,3,5,0,0,0,0,0,0,0,0,0,0,0,0,0,0,0,0,0,0,0,0,0,0,0,0,0
Nicholas HOAG,Canada,Outside Hitter,Men,Bulgaria,2022-06-12,Pool,3,5,15,14,6,2,22,1,1,3,5,0,5,13,18,1,2,25,28,4,0,4,8,1,0,8,9
Stephen Timothy MAAR,Canada,Outside Hitter,Men,Bulgaria,2022-06-12,Pool,3,5,25,21,4,16,41,2,5,1,8,2,1,20,23,4,1,32,37,7,0,6,13,0,0,2,2
Brett James WALSH,Canada,Setter,Men,Bulgaria,2022-06-12,Pool,3,5,6,3,0,3,6,3,2,8,13,0,3,11,14,0,0,0,0,6,1,0,7,53,2,44,99
Jay BLANKENAU,Canada,Setter,Men,Bulgaria,2022-06-12,Pool,3,5,0,0,0,0,0,0,0,0,0,0,0,0,0,0,0,0,0,0,0,0,0,0,0,0,0
Ryan Joseph SCLATER,Canada,Opposite Spiker,Men,Bulgaria,2022-06-12,Pool,3,5,17,11,4,9,24,2,3,2,7,4,4,11,19,0,1,0,1,6,2,0,8,0,0,1,1
Pearson ESHENKO,Canada,Middle Blocker,Men,Bulgaria,2022-06-12,Pool,3,5,0,0,0,0,0,0,0,0,0,0,0,0,0,0,0,0,0,0,0,0,0,0,0,0,0
Lucas VAN BERKEL,Canada,Middle Blocker,Men,Bulgaria,2022-06-12,Pool,3,5,11,9,2,1,12,2,8,7,17,0,0,15,15,0,1,2,3,5,0,1,6,1,0,1,2
Marc Major WILSON,Canada,Middle Blocker,Men,Bulgaria,2022-06-12,Pool,3,5,0,0,0,0,0,0,0,0,0,0,0,0,0,0,0,0,0,0,0,0,0,0,0,0,0
Ryley Brendan BARNES,Canada,Outside Hitter,Men,Bulgaria,2022-06-12,Pool,3,5,0,0,0,0,0,0,0,0,0,0,0,0,0,0,0,0,0,0,0,0,0,0,0,0,0
Justin LUI,Canada,Libero,Men,Bulgaria,2022-06-12,Pool,3,5,0,0,0,0,0,0,0,0,0,0,0,0,0,1,2,12,15,7,2,6,15,0,1,1,2
Brodie HOFER,Canada,Outside Hitter,Men,Bulgaria,2022-06-12,Pool,3,5,0,0,0,0,0,0,0,0,0,0,2,2,4,0,0,0,0,1,0,0,1,0,0,0,0
Jackson HOWE,Canada,Middle Blocker,Men,Bulgaria,2022-06-12,Pool,3,5,12,8,0,3,11,4,9,3,16,0,3,6,9,0,0,1,1,0,1,1,2,0,0,1,1
Mathias ELSER,Canada,Setter,Men,Bulgaria,2022-06-12,Pool,3,5,1,0,0,0,0,0,0,0,0,1,2,4,7,0,0,0,0,0,0,0,0,0,0,0,0
Jesse ELSER,Canada,Outside Hitter,Men,Italy,2022-06-11,Pool,0,3,0,0,0,0,0,0,0,0,0,0,0,0,0,0,0,0,0,0,0,0,0,0,0,0,0
Nicholas HOAG,Canada,Outside Hitter,Men,Italy,2022-06-11,Pool,0,3,6,5,4,9,18,1,0,0,1,0,1,10,11,2,0,10,12,4,0,0,4,0,0,5,5
Stephen Timothy MAAR,Canada,Outside Hitter,Men,Italy,2022-06-11,Pool,0,3,6,6,3,16,25,0,4,0,4,0,2,7,9,5,1,12,18,4,0,1,5,0,0,4,4
Brett James WALSH,Canada,Setter,Men,Italy,2022-06-11,Pool,0,3,0,0,0,0,0,0,1,0,1,0,0,2,2,0,0,0,0,0,0,0,0,0,0,25,25
Jay BLANKENAU,Canada,Setter,Men,Italy,2022-06-11,Pool,0,3,0,0,0,0,0,0,0,1,1,0,0,3,3,0,0,2,2,4,2,0,6,0,0,40,40
Ryan Joseph SCLATER,Canada,Opposite Spiker,Men,Italy,2022-06-11,Pool,0,3,3,3,5,8,16,0,2,0,2,0,3,3,6,2,0,4,6,4,0,0,4,0,0,2,2
Pearson ESHENKO,Canada,Middle Blocker,Men,Italy,2022-06-11,Pool,0,3,7,2,0,1,3,5,0,1,6,0,0,7,7,0,1,1,2,1,1,0,2,0,0,0,0
Lucas VAN BERKEL,Canada,Middle Blocker,Men,Italy,2022-06-11,Pool,0,3,0,0,0,0,0,0,0,0,0,0,0,1,1,0,0,0,0,0,0,0,0,0,0,0,0
Marc Major WILSON,Canada,Middle Blocker,Men,Italy,2022-06-11,Pool,0,3,2,2,1,1,4,0,1,0,1,0,1,3,4,0,0,1,1,0,0,0,0,0,0,0,0
Ryley Brendan BARNES,Canada,Outside Hitter,Men,Italy,2022-06-11,Pool,0,3,0,0,0,0,0,0,0,0,0,0,0,0,0,0,0,0,0,0,0,0,0,0,0,0,0
Justin LUI,Canada,Libero,Men,Italy,2022-06-11,Pool,0,3,0,0,0,0,0,0,0,0,0,0,0,0,0,2,0,14,16,4,2,0,6,0,0,4,4
Brodie HOFER,Canada,Outside Hitter,Men,Italy,2022-06-11,Pool,0,3,2,1,0,1,2,1,1,0,2,0,0,4,4,0,0,0,0,2,0,0,2,0,0,0,0
Jackson HOWE,Canada,Middle Blocker,Men,Italy,2022-06-11,Pool,0,3,8,6,0,1,7,2,4,0,6,0,1,5,6,0,1,2,3,0,0,0,0,0,0,0,0
Mathias ELSER,Canada,Setter,Men,Italy,2022-06-11,Pool,0,3,2,2,1,3,6,0,2,0,2,0,0,7,7,0,0,1,1,0,1,0,1,0,0,2,2
Jesse ELSER,Canada,Outside Hitter,Men,France,2022-06-10,Pool,0,3,0,0,0,0,0,0,0,0,0,0,0,0,0,2,4,12,18,6,2,2,10,0,2,2,4
Nicholas HOAG,Canada,Outside Hitter,Men,France,2022-06-10,Pool,0,3,0,0,0,0,0,0,0,0,0,0,0,4,4,0,0,0,0,0,0,0,0,0,0,0,0
Stephen Timothy MAAR,Canada,Outside Hitter,Men,France,2022-06-10,Pool,0,3,12,10,7,7,24,0,3,2,5,2,2,8,12,2,1,10,13,6,2,3,11,0,0,0,0
Brett James WALSH,Canada,Setter,Men,France,2022-06-10,Pool,0,3,4,1,0,2,3,2,2,2,6,1,1,7,9,0,0,0,0,5,1,1,7,28,0,31,59
Jay BLANKENAU,Canada,Setter,Men,France,2022-06-10,Pool,0,3,0,0,0,0,0,0,0,0,0,0,0,0,0,0,0,0,0,0,0,0,0,0,0,0,0
Ryan Joseph SCLATER,Canada,Opposite Spiker,Men,France,2022-06-10,Pool,0,3,7,5,1,4,10,1,0,5,6,1,2,9,12,0,0,8,8,4,1,2,7,0,1,3,4
Pearson ESHENKO,Canada,Middle Blocker,Men,France,2022-06-10,Pool,0,3,8,4,1,4,9,3,4,2,9,1,3,3,7,0,0,2,2,0,0,1,1,0,0,0,0
Lucas VAN BERKEL,Canada,Middle Blocker,Men,France,2022-06-10,Pool,0,3,2,2,3,2,7,0,3,6,9,0,1,5,6,0,0,0,0,0,0,0,0,0,0,0,0
Marc Major WILSON,Canada,Middle Blocker,Men,France,2022-06-10,Pool,0,3,3,2,0,1,3,1,1,2,4,0,1,1,2,0,0,0,0,0,0,0,0,0,0,1,1
Ryley Brendan BARNES,Canada,Outside Hitter,Men,France,2022-06-10,Pool,0,3,3,3,3,5,11,0,2,0,2,0,2,2,4,0,0,7,7,1,1,2,4,0,0,0,0
Justin LUI,Canada,Libero,Men,France,2022-06-10,Pool,0,3,0,0,0,0,0,0,0,0,0,0,0,0,0,0,0,0,0,0,0,0,0,0,0,0,0
Brodie HOFER,Canada,Outside Hitter,Men,France,2022-06-10,Pool,0,3,0,0,0,0,0,0,0,0,0,0,1,0,1,0,0,0,0,0,0,0,0,0,0,0,0
Jackson HOWE,Canada,Middle Blocker,Men,France,2022-06-10,Pool,0,3,0,0,0,0,0,0,0,0,0,0,0,0,0,0,0,0,0,0,0,0,0,0,0,0,0
Mathias ELSER,Canada,Setter,Men,France,2022-06-10,Pool,0,3,1,1,0,2,3,0,1,0,1,0,1,4,5,2,1,6,9,0,1,0,1,0,0,1,1
Jesse ELSER,Canada,Outside Hitter,Men,Germany,2022-06-07,Pool,0,3,0,0,0,0,0,0,0,0,0,0,0,0,0,0,0,0,0,0,0,0,0,0,0,0,0
Nicholas HOAG,Canada,Outside Hitter,Men,Germany,2022-06-07,Pool,0,3,12,10,2,3,15,0,2,1,3,2,4,10,16,4,2,11,17,3,1,0,4,0,0,6,6
Stephen Timothy MAAR,Canada,Outside Hitter,Men,Germany,2022-06-07,Pool,0,3,18,17,8,9,34,0,3,2,5,1,1,9,11,1,1,10,12,3,0,3,6,0,0,3,3
Brett James WALSH,Canada,Setter,Men,Germany,2022-06-07,Pool,0,3,1,0,0,0,0,0,0,0,0,1,0,2,3,0,0,0,0,0,1,0,1,2,0,8,10
Jay BLANKENAU,Canada,Setter,Men,Germany,2022-06-07,Pool,0,3,0,0,0,0,0,0,3,1,4,0,1,3,4,0,0,0,0,5,2,1,8,18,1,34,53
Ryan Joseph SCLATER,Canada,Opposite Spiker,Men,Germany,2022-06-07,Pool,0,3,6,6,3,5,14,0,2,4,6,0,0,13,13,0,1,3,4,6,2,2,10,0,0,0,0
Pearson ESHENKO,Canada,Middle Blocker,Men,Germany,2022-06-07,Pool,0,3,1,0,1,0,1,1,2,3,6,0,3,2,5,1,0,1,2,0,0,1,1,0,0,0,0
Lucas VAN BERKEL,Canada,Middle Blocker,Men,Germany,2022-06-07,Pool,0,3,2,1,0,1,2,1,2,5,8,0,0,5,5,0,0,0,0,0,0,0,0,0,0,0,0
Marc Major WILSON,Canada,Middle Blocker,Men,Germany,2022-06-07,Pool,0,3,0,0,0,0,0,0,0,0,0,0,0,0,0,0,0,0,0,0,0,0,0,0,0,0,0
Ryley Brendan BARNES,Canada,Outside Hitter,Men,Germany,2022-06-07,Pool,0,3,0,0,0,0,0,0,0,0,0,0,0,0,0,0,0,0,0,0,0,0,0,0,0,0,0
Justin LUI,Canada,Libero,Men,Germany,2022-06-07,Pool,0,3,0,0,0,0,0,0,0,0,0,0,0,0,0,3,4,17,24,5,3,1,9,0,1,3,4
Brodie HOFER,Canada,Outside Hitter,Men,Germany,2022-06-07,Pool,0,3,1,1,0,3,4,0,1,0,1,0,1,2,3,0,0,0,0,0,1,0,1,0,0,0,0
Jackson HOWE,Canada,Middle Blocker,Men,Germany,2022-06-07,Pool,0,3,4,2,2,0,4,2,4,3,9,0,1,5,6,1,0,2,3,1,0,0,1,0,0,1,1
Mathias ELSER,Canada,Setter,Men,Germany,2022-06-07,Pool,0,3,0,0,0,0,0,0,0,0,0,0,0,3,3,0,0,0,0,1,0,0,1,0,0,0,0
Nicholas HOAG,Canada,Outside Hitter,Men,United States,2022-07-09,Pool,0,3,0,0,0,0,0,0,0,0,0,0,0,0,0,0,0,0,0,0,0,0,0,0,0,0,0
Eric LOEPPKY,Canada,Outside Hitter,Men,United States,2022-07-09,Pool,0,3,1,1,0,0,1,0,0,0,0,0,0,0,0,0,1,2,3,0,0,1,1,0,0,0,0
Stephen Timothy MAAR,Canada,Outside Hitter,Men,United States,2022-07-09,Pool,0,3,7,7,4,15,26,0,3,1,4,0,2,7,9,5,1,8,14,2,1,1,4,1,0,4,5
Jay BLANKENAU,Canada,Setter,Men,United States,2022-07-09,Pool,0,3,0,0,0,0,0,0,0,0,0,0,0,1,1,0,0,0,0,0,2,1,3,0,0,5,5
Ryan Joseph SCLATER,Canada,Opposite Spiker,Men,United States,2022-07-09,Pool,0,3,7,7,2,6,15,0,0,2,2,0,0,3,3,0,0,2,2,5,1,1,7,0,0,0,0
Pearson ESHENKO,Canada,Middle Blocker,Men,United States,2022-07-09,Pool,0,3,2,2,1,1,4,0,6,3,9,0,0,6,6,0,0,0,0,1,2,2,5,0,0,1,1
Lucas VAN BERKEL,Canada,Middle Blocker,Men,United States,2022-07-09,Pool,0,3,2,2,0,2,4,0,8,1,9,0,0,9,9,0,0,4,4,3,0,2,5,1,0,0,1
Ryley Brendan BARNES,Canada,Outside Hitter,Men,United States,2022-07-09,Pool,0,3,0,0,0,0,0,0,0,0,0,0,0,0,0,0,0,0,0,0,0,0,0,0,0,0,0
Justin LUI,Canada,Libero,Men,United States,2022-07-09,Pool,0,3,0,0,0,0,0,0,0,0,0,0,0,0,0,7,1,12,20,5,3,0,8,0,0,5,5
Brodie HOFER,Canada,Outside Hitter,Men,United States,2022-07-09,Pool,0,3,8,7,3,4,14,0,0,1,1,1,0,5,6,0,0,1,1,0,1,0,1,0,0,0,0
Derek EPP,Canada,Setter,Men,United States,2022-07-09,Pool,0,3,2,1,0,2,3,1,2,0,3,0,4,8,12,0,0,1,1,4,2,2,8,18,0,42,60
Jackson HOWE,Canada,Middle Blocker,Men,United States,2022-07-09,Pool,0,3,0,0,0,0,0,0,0,0,0,0,0,0,0,0,0,0,0,0,0,0,0,0,0,0,0
Mathias ELSER,Canada,Setter,Men,United States,2022-07-09,Pool,0,3,0,0,0,0,0,0,0,0,0,0,0,0,0,0,0,0,0,0,0,0,0,0,0,0,0
Samuel COOPER,Canada,Outside Hitter,Men,United States,2022-07-09,Pool,0,3,8,7,3,6,16,0,2,0,2,1,3,4,8,5,2,9,16,2,1,4,7,1,0,4,5
Nicholas HOAG,Canada,Outside Hitter,Men,Japan,2022-07-08,Pool,1,4,0,0,0,0,0,0,0,0,0,0,0,0,0,0,0,0,0,0,0,0,0,0,0,0,0
Eric LOEPPKY,Canada,Outside Hitter,Men,Japan,2022-07-08,Pool,1,4,4,4,3,5,12,0,0,0,0,0,3,3,6,3,1,5,9,2,0,2,4,2,0,4,6
Stephen Timothy MAAR,Canada,Outside Hitter,Men,Japan,2022-07-08,Pool,1,4,20,17,6,14,37,1,3,4,8,2,2,9,13,10,2,22,34,11,4,1,16,1,0,4,5
Jay BLANKENAU,Canada,Setter,Men,Japan,2022-07-08,Pool,1,4,2,2,0,1,3,0,2,1,3,0,1,8,9,0,0,0,0,7,1,1,9,26,1,26,53
Ryan Joseph SCLATER,Canada,Opposite Spiker,Men,Japan,2022-07-08,Pool,1,4,5,4,0,6,10,1,1,4,6,0,3,3,6,0,0,3,3,4,1,0,5,0,0,1,1
Pearson ESHENKO,Canada,Middle Blocker,Men,Japan,2022-07-08,Pool,1,4,7,7,3,2,12,0,5,2,7,0,3,5,8,4,2,4,10,0,0,0,0,0,0,0,0
Lucas VAN BERKEL,Canada,Middle Blocker,Men,Japan,2022-07-08,Pool,1,4,0,0,0,0,0,0,0,0,0,0,0,0,0,0,0,0,0,0,0,0,0,0,0,0,0
Ryley Brendan BARNES,Canada,Outside Hitter,Men,Japan,2022-07-08,Pool,1,4,0,0,0,0,0,0,0,0,0,0,0,0,0,1,2,7,10,2,2,0,4,0,0,0,0
Justin LUI,Canada,Libero,Men,Japan,2022-07-08,Pool,1,4,0,0,0,0,0,0,0,0,0,0,0,0,0,1,0,3,4,3,1,1,5,0,0,2,2
Brodie HOFER,Canada,Outside Hitter,Men,Japan,2022-07-08,Pool,1,4,10,5,3,4,12,0,1,2,3,5,2,6,13,0,0,1,1,2,2,1,5,0,0,1,1
Derek EPP,Canada,Setter,Men,Japan,2022-07-08,Pool,1,4,0,0,0,0,0,0,2,2,4,0,0,3,3,0,0,0,0,3,3,2,8,18,0,17,35
Jackson HOWE,Canada,Middle Blocker,Men,Japan,2022-07-08,Pool,1,4,4,2,1,6,9,1,5,5,11,1,1,9,11,2,0,0,2,1,0,1,2,0,0,0,0
Mathias ELSER,Canada,Setter,Men,Japan,2022-07-08,Pool,1,4,10,9,2,5,16,1,0,1,2,0,2,11,13,0,0,8,8,1,1,1,3,0,0,2,2
Samuel COOPER,Canada,Outside Hitter,Men,Japan,2022-07-08,Pool,1,4,0,0,0,0,0,0,0,1,1,0,0,0,0,0,0,0,0,0,0,0,0,0,0,0,0
Nicholas HOAG,Canada,Outside Hitter,Men,Brazil,2022-07-07,Pool,0,3,0,0,0,0,0,0,0,0,0,0,0,0,0,0,0,0,0,0,0,0,0,0,0,0,0
Eric LOEPPKY,Canada,Outside Hitter,Men,Brazil,2022-07-07,Pool,0,3,11,8,9,8,25,1,3,2,6,2,3,6,11,3,2,14,19,6,1,4,11,0,0,3,3
Stephen Timothy MAAR,Canada,Outside Hitter,Men,Brazil,2022-07-07,Pool,0,3,0,0,0,0,0,0,0,0,0,0,0,0,0,0,0,0,0,0,0,0,0,0,0,0,0
Jay BLANKENAU,Canada,Setter,Men,Brazil,2022-07-07,Pool,0,3,2,0,0,1,1,0,0,5,5,2,1,7,10,0,0,0,0,3,1,1,5,24,2,40,66
Ryan Joseph SCLATER,Canada,Opposite Spiker,Men,Brazil,2022-07-07,Pool,0,3,0,0,0,0,0,0,0,0,0,0,0,2,2,0,0,0,0,0,1,0,1,0,0,0,0
Pearson ESHENKO,Canada,Middle Blocker,Men,Brazil,2022-07-07,Pool,0,3,0,0,0,0,0,0,0,0,0,0,0,0,0,0,0,0,0,0,0,0,0,0,0,0,0
Lucas VAN BERKEL,Canada,Middle Blocker,Men,Brazil,2022-07-07,Pool,0,3,1,1,2,3,6,0,5,1,6,0,0,9,9,1,0,3,4,1,1,0,2,0,0,3,3
Ryley Brendan BARNES,Canada,Outside Hitter,Men,Brazil,2022-07-07,Pool,0,3,0,0,0,0,0,0,0,0,0,0,0,0,0,0,0,0,0,0,0,0,0,0,0,0,0
Justin LUI,Canada,Libero,Men,Brazil,2022-07-07,Pool,0,3,0,0,0,0,0,0,0,0,0,0,0,0,0,4,0,11,15,7,3,4,14,0,0,5,5
Brodie HOFER,Canada,Outside Hitter,Men,Brazil,2022-07-07,Pool,0,3,13,12,2,3,17,0,2,1,3,1,2,7,10,1,1,3,5,2,0,2,4,0,0,2,2
Derek EPP,Canada,Setter,Men,Brazil,2022-07-07,Pool,0,3,0,0,0,0,0,0,0,0,0,0,0,0,0,0,0,0,0,0,0,1,1,1,0,6,7
Jackson HOWE,Canada,Middle Blocker,Men,Brazil,2022-07-07,Pool,0,3,7,7,2,3,12,0,5,4,9,0,1,5,6,0,0,0,0,1,0,1,2,0,0,0,0
Mathias ELSER,Canada,Setter,Men,Brazil,2022-07-07,Pool,0,3,8,8,0,8,16,0,2,3,5,0,2,4,6,6,1,16,23,3,3,0,6,0,0,3,3
Samuel COOPER,Canada,Outside Hitter,Men,Brazil,2022-07-07,Pool,0,3,0,0,1,2,3,0,1,3,4,0,1,0,1,0,0,1,1,0,0,0,0,1,0,1,2
Nicholas HOAG,Canada,Outside Hitter,Men,Argentina,2022-07-05,Pool,1,4,0,0,0,0,0,0,0,0,0,0,0,5,5,0,0,0,0,0,1,0,1,0,0,0,0
Eric LOEPPKY,Canada,Outside Hitter,Men,Argentina,2022-07-05,Pool,1,4,20,19,5,13,37,1,3,2,6,0,3,14,17,4,0,18,22,3,1,3,7,0,1,1,2
Stephen Timothy MAAR,Canada,Outside Hitter,Men,Argentina,2022-07-05,Pool,1,4,12,10,9,12,31,0,5,3,8,2,6,5,13,6,1,25,32,11,2,1,14,0,0,1,1
Jay BLANKENAU,Canada,Setter,Men,Argentina,2022-07-05,Pool,1,4,0,0,0,0,0,0,0,0,0,0,0,0,0,0,0,0,0,0,0,0,0,0,0,0,0
Ryan Joseph SCLATER,Canada,Opposite Spiker,Men,Argentina,2022-07-05,Pool,1,4,16,13,0,7,20,2,5,8,15,1,8,7,16,0,1,2,3,4,0,1,5,0,0,2,2
Pearson ESHENKO,Canada,Middle Blocker,Men,Argentina,2022-07-05,Pool,1,4,3,3,2,1,6,0,6,5,11,0,1,10,11,0,0,0,0,1,2,0,3,0,0,0,0
Lucas VAN BERKEL,Canada,Middle Blocker,Men,Argentina,2022-07-05,Pool,1,4,2,2,0,0,2,0,1,1,2,0,0,2,2,0,0,1,1,1,0,0,1,0,0,0,0
Ryley Brendan BARNES,Canada,Outside Hitter,Men,Argentina,2022-07-05,Pool,1,4,0,0,0,0,0,0,0,0,0,0,0,0,0,2,2,14,18,4,4,3,11,1,0,3,4
Justin LUI,Canada,Libero,Men,Argentina,2022-07-05,Pool,1,4,0,0,0,0,0,0,0,0,0,0,0,0,0,0,0,1,1,5,3,0,8,1,0,0,1
Brodie HOFER,Canada,Outside Hitter,Men,Argentina,2022-07-05,Pool,1,4,0,0,0,0,0,0,0,0,0,0,0,0,0,0,0,0,0,0,0,0,0,0,0,0,0
Derek EPP,Canada,Setter,Men,Argentina,2022-07-05,Pool,1,4,1,1,1,0,2,0,1,5,6,0,3,13,16,0,0,0,0,5,3,0,8,32,1,64,97
Jackson HOWE,Canada,Middle Blocker,Men,Argentina,2022-07-05,Pool,1,4,6,5,3,2,10,1,3,5,9,0,0,10,10,0,0,0,0,1,1,0,2,0,0,0,0
Mathias ELSER,Canada,Setter,Men,Argentina,2022-07-05,Pool,1,4,0,0,0,0,0,0,0,0,0,0,0,2,2,0,0,0,0,0,0,0,0,0,0,0,0
Samuel COOPER,Canada,Outside Hitter,Men,Argentina,2022-07-05,Pool,1,4,0,0,0,0,0,0,0,0,0,0,0,0,0,0,0,0,0,0,0,0,0,0,0,0,0
Nicholas HOAG,Canada,Outside Hitter,Men,Australia,2022-06-21,Pool,3,4,4,4,1,8,13,0,1,0,1,0,2,3,5,7,2,8,17,0,0,1,1,0,0,0,0
Eric LOEPPKY,Canada,Outside Hitter,Men,Australia,2022-06-21,Pool,3,4,5,3,2,10,15,0,1,0,1,2,3,6,11,4,1,16,21,1,1,1,3,0,0,0,0
Stephen Timothy MAAR,Canada,Outside Hitter,Men,Australia,2022-06-21,Pool,3,4,23,19,0,16,35,3,1,3,7,1,1,14,16,3,2,12,17,2,1,2,5,0,0,0,0
Brett James WALSH,Canada,Setter,Men,Australia,2022-06-21,Pool,3,4,1,1,0,0,1,0,1,3,4,0,0,12,12,0,0,0,0,1,0,0,1,29,0,59,88
Ryan Joseph SCLATER,Canada,Opposite Spiker,Men,Australia,2022-06-21,Pool,3,4,16,13,4,7,24,1,2,3,6,2,2,14,18,0,0,2,2,2,0,0,2,0,0,0,0
Pearson ESHENKO,Canada,Middle Blocker,Men,Australia,2022-06-21,Pool,3,4,5,2,1,3,6,2,2,0,4,1,2,5,8,0,0,1,1,0,0,1,1,0,0,0,0
Lucas VAN BERKEL,Canada,Middle Blocker,Men,Australia,2022-06-21,Pool,3,4,4,4,1,0,5,0,3,0,3,0,1,5,6,0,0,0,0,0,1,0,1,0,0,0,0
Marc Major WILSON,Canada,Middle Blocker,Men,Australia,2022-06-21,Pool,3,4,0,0,0,0,0,0,0,0,0,0,0,0,0,0,0,0,0,0,0,0,0,0,0,0,0
Ryley Brendan BARNES,Canada,Outside Hitter,Men,Australia,2022-06-21,Pool,3,4,0,0,0,0,0,0,0,0,0,0,0,0,0,2,1,4,7,5,1,0,6,2,0,0,2
Justin LUI,Canada,Libero,Men,Australia,2022-06-21,Pool,3,4,0,0,0,0,0,0,0,0,0,0,0,0,0,3,1,3,7,0,0,1,1,0,0,0,0
Brodie HOFER,Canada,Outside Hitter,Men,Australia,2022-06-21,Pool,3,4,2,2,2,0,4,0,1,0,1,0,1,2,3,0,0,1,1,0,0,0,0,0,0,0,0
Derek EPP,Canada,Setter,Men,Australia,2022-06-21,Pool,3,4,0,0,0,0,0,0,0,0,0,0,0,0,0,0,0,0,0,0,0,0,0,7,0,7,14
Jackson HOWE,Canada,Middle Blocker,Men,Australia,2022-06-21,Pool,3,4,7,5,2,2,9,1,4,1,6,1,3,8,12,3,1,0,4,0,1,0,1,0,0,0,0
Mathias ELSER,Canada,Setter,Men,Australia,2022-06-21,Pool,3,4,0,0,0,0,0,0,0,0,0,0,2,2,4,0,0,0,0,0,0,0,0,0,0,0,0
Eric LOEPPKY,Canada,Outside Hitter,Men,Iran,2022-06-25,Pool,0,3,13,11,3,11,25,1,0,0,1,1,5,6,12,1,2,13,16,3,1,0,4,0,0,3,3
Stephen Timothy MAAR,Canada,Outside Hitter,Men,Iran,2022-06-25,Pool,0,3,18,14,2,11,27,2,3,0,5,2,4,8,14,4,1,16,21,4,3,0,7,0,0,2,2
Brett James WALSH,Canada,Setter,Men,Iran,2022-06-25,Pool,0,3,1,0,0,1,1,0,2,0,2,1,2,4,7,0,0,0,0,1,0,0,1,16,0,24,40
Ryan Joseph SCLATER,Canada,Opposite Spiker,Men,Iran,2022-06-25,Pool,0,3,8,8,2,3,13,0,0,0,0,0,3,6,9,0,0,2,2,3,1,0,4,0,0,0,0
Pearson ESHENKO,Canada,Middle Blocker,Men,Iran,2022-06-25,Pool,0,3,3,3,2,5,10,0,6,2,8,0,1,8,9,0,0,0,0,1,0,0,1,0,0,1,1
Lucas VAN BERKEL,Canada,Middle Blocker,Men,Iran,2022-06-25,Pool,0,3,0,0,0,0,0,0,0,0,0,0,0,0,0,0,0,0,0,0,0,0,0,0,0,0,0
Marc Major WILSON,Canada,Middle Blocker,Men,Iran,2022-06-25,Pool,0,3,0,0,0,0,0,0,0,0,0,0,0,0,0,0,0,0,0,0,0,0,0,0,0,0,0
Ryley Brendan BARNES,Canada,Outside Hitter,Men,Iran,2022-06-25,Pool,0,3,0,0,0,0,0,0,0,0,0,0,0,0,0,5,1,17,23,1,5,2,8,0,0,2,2
Justin LUI,Canada,Libero,Men,Iran,2022-06-25,Pool,0,3,0,0,0,0,0,0,0,0,0,0,0,0,0,0,0,0,0,0,0,0,0,0,0,0,0
Brodie HOFER,Canada,Outside Hitter,Men,Iran,2022-06-25,Pool,0,3,0,0,0,0,0,0,0,0,0,0,2,1,3,0,0,0,0,0,0,0,0,0,0,0,0
Derek EPP,Canada,Setter,Men,Iran,2022-06-25,Pool,0,3,0,0,0,0,0,0,1,0,1,0,2,1,3,0,0,0,0,1,0,1,2,6,0,26,32
Jackson HOWE,Canada,Middle Blocker,Men,Iran,2022-06-25,Pool,0,3,3,3,1,1,5,0,2,0,2,0,0,6,6,0,0,0,0,0,0,0,0,0,0,0,0
Mathias ELSER,Canada,Setter,Men,Iran,2022-06-25,Pool,0,3,0,0,0,0,0,0,0,0,0,0,1,0,1,0,0,0,0,0,0,0,0,0,0,0,0
Samuel COOPER,Canada,Outside Hitter,Men,Iran,2022-06-25,Pool,0,3,1,1,0,1,2,0,1,0,1,0,2,0,2,0,0,0,0,0,0,1,1,0,0,0,0
Eric LOEPPKY,Canada,Outside Hitter,Men,Serbia,2022-06-24,Pool,2,5,19,14,5,7,26,1,2,0,3,4,6,9,19,2,1,26,29,0,2,0,2,0,0,3,3
Stephen Timothy MAAR,Canada,Outside Hitter,Men,Serbia,2022-06-24,Pool,2,5,22,18,5,13,36,1,7,2,10,3,1,14,18,5,1,16,22,0,1,0,1,0,0,2,2
Brett James WALSH,Canada,Setter,Men,Serbia,2022-06-24,Pool,2,5,0,0,1,1,2,0,1,0,1,0,1,14,15,0,0,0,0,2,1,0,3,24,2,64,90
Ryan Joseph SCLATER,Canada,Opposite Spiker,Men,Serbia,2022-06-24,Pool,2,5,17,13,2,6,21,3,3,0,6,1,5,13,19,0,1,6,7,4,1,2,7,1,0,0,1
Pearson ESHENKO,Canada,Middle Blocker,Men,Serbia,2022-06-24,Pool,2,5,0,0,0,0,0,0,0,0,0,0,0,0,0,0,0,0,0,0,0,0,0,0,0,0,0
Lucas VAN BERKEL,Canada,Middle Blocker,Men,Serbia,2022-06-24,Pool,2,5,4,2,0,1,3,2,2,6,10,0,1,5,6,0,0,2,2,0,0,0,0,0,0,0,0
Marc Major WILSON,Canada,Middle Blocker,Men,Serbia,2022-06-24,Pool,2,5,0,0,0,0,0,0,0,0,0,0,0,0,0,0,0,0,0,0,0,0,0,0,0,0,0
Ryley Brendan BARNES,Canada,Outside Hitter,Men,Serbia,2022-06-24,Pool,2,5,0,0,0,0,0,0,0,0,0,0,0,0,0,7,0,13,20,3,1,0,4,1,0,3,4
Justin LUI,Canada,Libero,Men,Serbia,2022-06-24,Pool,2,5,0,0,0,0,0,0,0,0,0,0,0,0,0,0,0,0,0,0,0,0,0,0,0,0,0
Brodie HOFER,Canada,Outside Hitter,Men,Serbia,2022-06-24,Pool,2,5,0,0,0,0,0,0,0,0,0,0,2,7,9,0,0,0,0,1,0,0,1,0,0,0,0
Jackson HOWE,Canada,Middle Blocker,Men,Serbia,2022-06-24,Pool,2,5,9,7,2,3,12,2,7,2,11,0,6,8,14,0,0,3,3,0,1,0,1,0,0,0,0
Mathias ELSER,Canada,Setter,Men,Serbia,2022-06-24,Pool,2,5,0,0,0,0,0,0,0,0,0,0,3,2,5,0,0,0,0,0,0,0,0,0,0,0,0
Samuel COOPER,Canada,Outside Hitter,Men,Serbia,2022-06-24,Pool,2,5,0,0,0,0,0,0,0,0,0,0,1,0,1,0,0,0,0,0,0,0,0,0,0,0,0
Eric LOEPPKY,Canada,Outside Hitter,Men,Poland,2022-06-23,Pool,0,3,0,0,0,0,0,0,0,0,0,0,1,2,3,0,0,0,0,0,0,0,0,0,0,0,0
Stephen Timothy MAAR,Canada,Outside Hitter,Men,Poland,2022-06-23,Pool,0,3,0,0,0,0,0,0,0,0,0,0,0,0,0,0,0,1,1,0,0,0,0,0,0,0,0
Brett James WALSH,Canada,Setter,Men,Poland,2022-06-23,Pool,0,3,1,0,0,0,0,0,2,1,3,1,1,7,9,0,0,0,0,1,1,0,2,9,1,58,68
Ryan Joseph SCLATER,Canada,Opposite Spiker,Men,Poland,2022-06-23,Pool,0,3,0,0,0,0,0,0,0,0,0,0,0,0,0,0,0,0,0,0,0,0,0,0,0,0,0
Pearson ESHENKO,Canada,Middle Blocker,Men,Poland,2022-06-23,Pool,0,3,4,3,0,2,5,1,3,2,6,0,2,4,6,2,0,0,2,0,0,0,0,0,0,0,0
Lucas VAN BERKEL,Canada,Middle Blocker,Men,Poland,2022-06-23,Pool,0,3,2,2,0,2,4,0,5,0,5,0,0,2,2,1,0,1,2,0,1,0,1,0,0,0,0
Marc Major WILSON,Canada,Middle Blocker,Men,Poland,2022-06-23,Pool,0,3,0,0,0,0,0,0,1,0,1,0,0,4,4,0,0,0,0,0,1,0,1,0,0,0,0
Ryley Brendan BARNES,Canada,Outside Hitter,Men,Poland,2022-06-23,Pool,0,3,9,9,5,9,23,0,3,1,4,0,5,4,9,1,0,11,12,0,2,0,2,0,0,1,1
Justin LUI,Canada,Libero,Men,Poland,2022-06-23,Pool,0,3,0,0,0,0,0,0,0,0,0,0,0,0,0,1,1,11,13,3,1,0,4,0,0,1,1
Brodie HOFER,Canada,Outside Hitter,Men,Poland,2022-06-23,Pool,0,3,4,2,1,10,13,0,1,0,1,2,3,5,10,0,0,4,4,2,1,0,3,0,0,0,0
Jackson HOWE,Canada,Middle Blocker,Men,Poland,2022-06-23,Pool,0,3,0,0,0,0,0,0,0,0,0,0,0,0,0,0,0,0,0,0,0,0,0,0,0,0,0
Mathias ELSER,Canada,Setter,Men,Poland,2022-06-23,Pool,0,3,7,6,5,3,14,1,0,0,1,0,1,3,4,2,2,11,15,0,0,0,0,0,0,0,0
Samuel COOPER,Canada,Outside Hitter,Men,Poland,2022-06-23,Pool,0,3,6,6,1,3,10,0,0,0,0,0,2,3,5,1,1,9,11,1,0,0,1,0,0,0,0
Yiming YANG,China,Libero,Men,Serbia,2022-07-10,Pool,1,4,0,0,0,0,0,0,0,0,0,0,0,0,0,8,4,23,35,2,0,1,3,0,0,0,0
Binglong ZHANG,China,Outside Hitter,Men,Serbia,2022-07-10,Pool,1,4,11,11,5,5,21,0,0,0,0,0,5,3,8,1,1,18,20,1,1,2,4,0,0,0,0
Yuantai YU,China,Outside Hitter,Men,Serbia,2022-07-10,Pool,1,4,8,8,2,5,15,0,2,0,2,0,4,9,13,1,1,20,22,4,0,2,6,0,0,0,0
Yaochen YU,China,Setter,Men,Serbia,2022-07-10,Pool,1,4,0,0,0,0,0,0,2,0,2,0,0,14,14,0,0,0,0,0,1,2,3,14,1,63,78
Tianyuan YANG,China,Libero,Men,Serbia,2022-07-10,Pool,1,4,0,0,0,0,0,0,0,0,0,0,0,0,0,0,0,0,0,1,0,0,1,0,0,0,0
Yongzhen LI,China,Middle Blocker,Men,Serbia,2022-07-10,Pool,1,4,11,5,4,2,11,5,5,1,11,1,1,11,13,0,0,0,0,0,0,0,0,0,0,0,0
Zhengyang JIANG,China,Middle Blocker,Men,Serbia,2022-07-10,Pool,1,4,0,0,0,0,0,0,0,0,0,0,0,0,0,0,0,0,0,0,0,0,0,0,0,0,0
Shikun PENG,China,Middle Blocker,Men,Serbia,2022-07-10,Pool,1,4,9,7,0,2,9,2,1,0,3,0,4,9,13,0,0,0,0,0,1,0,1,0,0,1,1
Hebin WANG,China,Setter,Men,Serbia,2022-07-10,Pool,1,4,0,0,0,0,0,0,0,0,0,0,1,3,4,0,0,0,0,0,0,0,0,4,0,15,19
Jingyi WANG,China,Opposite Spiker,Men,Serbia,2022-07-10,Pool,1,4,4,4,3,4,11,0,0,0,0,0,2,2,4,0,0,0,0,1,0,0,1,0,0,0,0
Dangyi YUAN,China,Outside Hitter,Men,Serbia,2022-07-10,Pool,1,4,0,0,0,0,0,0,0,0,0,0,0,0,0,0,0,0,0,0,0,0,0,0,0,0,0
Guanhua ZHANG,China,Opposite Spiker,Men,Serbia,2022-07-10,Pool,1,4,5,5,4,5,14,0,0,1,1,0,3,3,6,0,0,0,0,0,1,1,2,0,0,1,1
Ruantong MIAO,China,Middle Blocker,Men,Serbia,2022-07-10,Pool,1,4,0,0,0,0,0,0,0,0,0,0,0,0,0,0,0,0,0,0,0,0,0,0,0,0,0
Jingyin ZHANG,China,Outside Hitter,Men,Serbia,2022-07-10,Pool,1,4,9,8,4,3,15,0,0,0,0,1,1,5,7,1,0,8,9,1,0,0,1,0,0,0,0
Yiming YANG,China,Libero,Men,Bulgaria,2022-07-09,Pool,3,4,0,0,0,0,0,0,0,0,0,0,0,0,0,1,1,10,12,1,2,0,3,0,0,1,1
Binglong ZHANG,China,Outside Hitter,Men,Bulgaria,2022-07-09,Pool,3,4,0,0,0,0,0,0,0,0,0,0,1,1,2,0,0,0,0,0,0,0,0,0,0,0,0
Yuantai YU,China,Outside Hitter,Men,Bulgaria,2022-07-09,Pool,3,4,10,9,1,3,13,1,1,0,2,0,2,10,12,1,1,22,24,3,1,1,5,0,0,1,1
Yaochen YU,China,Setter,Men,Bulgaria,2022-07-09,Pool,3,4,4,2,0,1,3,1,2,0,3,1,0,13,14,1,0,0,1,2,1,0,3,23,0,61,84
Tianyuan YANG,China,Libero,Men,Bulgaria,2022-07-09,Pool,3,4,0,0,0,0,0,0,0,0,0,0,0,0,0,4,0,3,7,2,2,1,5,0,0,0,0
Yongzhen LI,China,Middle Blocker,Men,Bulgaria,2022-07-09,Pool,3,4,13,9,0,1,10,2,7,0,9,2,3,15,20,0,0,2,2,0,0,0,0,0,0,1,1
Zhengyang JIANG,China,Middle Blocker,Men,Bulgaria,2022-07-09,Pool,3,4,0,0,0,0,0,0,1,0,1,0,0,0,0,0,0,0,0,0,0,0,0,0,0,0,0
Shikun PENG,China,Middle Blocker,Men,Bulgaria,2022-07-09,Pool,3,4,14,10,1,2,13,1,6,0,7,3,3,12,18,0,1,1,2,0,0,0,0,0,0,1,1
Hebin WANG,China,Setter,Men,Bulgaria,2022-07-09,Pool,3,4,0,0,0,0,0,0,0,0,0,0,0,0,0,0,0,0,0,0,0,0,0,0,0,0,0
Jingyi WANG,China,Opposite Spiker,Men,Bulgaria,2022-07-09,Pool,3,4,15,14,3,2,19,1,1,0,2,0,5,4,9,0,0,0,0,2,0,0,2,0,0,0,0
Dangyi YUAN,China,Outside Hitter,Men,Bulgaria,2022-07-09,Pool,3,4,0,0,0,0,0,0,0,0,0,0,0,0,0,0,0,0,0,0,0,0,0,0,0,0,0
Guanhua ZHANG,China,Opposite Spiker,Men,Bulgaria,2022-07-09,Pool,3,4,3,2,3,5,10,1,1,0,2,0,1,3,4,0,0,0,0,0,0,0,0,0,0,0,0
Ruantong MIAO,China,Middle Blocker,Men,Bulgaria,2022-07-09,Pool,3,4,0,0,0,0,0,0,0,0,0,0,0,0,0,0,0,0,0,0,0,0,0,0,0,0,0
Jingyin ZHANG,China,Outside Hitter,Men,Bulgaria,2022-07-09,Pool,3,4,18,16,6,4,26,1,5,0,6,1,1,19,21,5,0,26,31,2,1,1,4,0,0,3,3
Yiming YANG,China,Libero,Men,Poland,2022-07-07,Pool,0,3,0,0,0,0,0,0,0,0,0,0,0,0,0,4,5,8,17,1,1,0,2,0,0,0,0
Binglong ZHANG,China,Outside Hitter,Men,Poland,2022-07-07,Pool,0,3,1,0,0,0,0,0,0,0,0,1,2,3,6,0,0,0,0,0,0,0,0,0,0,0,0
Yuantai YU,China,Outside Hitter,Men,Poland,2022-07-07,Pool,0,3,5,5,1,5,11,0,0,0,0,0,4,5,9,1,6,7,14,0,1,0,1,0,0,1,1
Yaochen YU,China,Setter,Men,Poland,2022-07-07,Pool,0,3,3,1,0,0,1,1,1,0,2,1,3,3,7,0,0,0,0,0,2,0,2,15,0,41,56
Tianyuan YANG,China,Libero,Men,Poland,2022-07-07,Pool,0,3,0,0,0,0,0,0,0,0,0,0,0,0,0,2,0,7,9,2,0,0,2,0,0,1,1
Yongzhen LI,China,Middle Blocker,Men,Poland,2022-07-07,Pool,0,3,0,0,0,0,0,0,0,0,0,0,0,0,0,0,0,0,0,0,0,0,0,0,0,0,0
Zhengyang JIANG,China,Middle Blocker,Men,Poland,2022-07-07,Pool,0,3,8,4,0,0,4,4,1,0,5,0,1,7,8,0,0,1,1,0,0,0,0,0,0,1,1
Shikun PENG,China,Middle Blocker,Men,Poland,2022-07-07,Pool,0,3,8,5,0,1,6,3,3,0,6,0,1,9,10,0,0,0,0,1,0,0,1,0,0,0,0
Hebin WANG,China,Setter,Men,Poland,2022-07-07,Pool,0,3,0,0,0,0,0,0,0,0,0,0,0,0,0,0,0,0,0,0,0,0,0,0,0,0,0
Jingyi WANG,China,Opposite Spiker,Men,Poland,2022-07-07,Pool,0,3,0,0,0,0,0,0,0,0,0,0,0,0,0,0,0,0,0,0,0,0,0,0,0,0,0
Dangyi YUAN,China,Outside Hitter,Men,Poland,2022-07-07,Pool,0,3,0,0,0,0,0,0,0,0,0,0,0,0,0,0,0,0,0,0,0,0,0,0,0,0,0
Guanhua ZHANG,China,Opposite Spiker,Men,Poland,2022-07-07,Pool,0,3,9,9,1,9,19,0,0,0,0,0,2,7,9,0,0,0,0,1,1,0,2,0,0,0,0
Ruantong MIAO,China,Middle Blocker,Men,Poland,2022-07-07,Pool,0,3,0,0,0,0,0,0,0,0,0,0,0,0,0,0,0,0,0,0,0,0,0,0,0,0,0
Jingyin ZHANG,China,Outside Hitter,Men,Poland,2022-07-07,Pool,0,3,10,10,6,3,19,0,0,0,0,0,3,7,10,5,1,18,24,1,1,1,3,0,0,0,0
Yiming YANG,China,Libero,Men,Netherlands,2022-07-06,Pool,0,3,0,0,0,0,0,0,0,0,0,0,0,0,0,2,5,9,16,3,2,1,6,0,0,3,3
Binglong ZHANG,China,Outside Hitter,Men,Netherlands,2022-07-06,Pool,0,3,0,0,2,0,2,0,1,0,1,0,0,2,2,4,2,6,12,0,0,0,0,0,0,1,1
Yuantai YU,China,Outside Hitter,Men,Netherlands,2022-07-06,Pool,0,3,1,1,1,2,4,0,1,0,1,0,1,5,6,1,0,5,6,1,0,0,1,0,0,0,0
Yaochen YU,China,Setter,Men,Netherlands,2022-07-06,Pool,0,3,5,3,0,1,4,2,4,0,6,0,1,8,9,0,0,1,1,2,3,1,6,12,1,46,59
Tianyuan YANG,China,Libero,Men,Netherlands,2022-07-06,Pool,0,3,0,0,0,0,0,0,0,0,0,0,0,0,0,0,0,0,0,0,0,0,0,0,0,0,0
Yongzhen LI,China,Middle Blocker,Men,Netherlands,2022-07-06,Pool,0,3,0,0,0,0,0,0,0,0,0,0,0,0,0,0,0,0,0,0,0,0,0,0,0,0,0
Zhengyang JIANG,China,Middle Blocker,Men,Netherlands,2022-07-06,Pool,0,3,4,3,0,1,4,1,4,0,5,0,0,8,8,0,0,0,0,0,1,0,1,0,0,0,0
Shikun PENG,China,Middle Blocker,Men,Netherlands,2022-07-06,Pool,0,3,4,3,2,4,9,1,3,0,4,0,1,8,9,0,0,3,3,2,1,0,3,0,0,0,0
Hebin WANG,China,Setter,Men,Netherlands,2022-07-06,Pool,0,3,0,0,0,0,0,0,0,0,0,0,0,0,0,0,0,0,0,0,0,0,0,0,0,3,3
Jingyi WANG,China,Opposite Spiker,Men,Netherlands,2022-07-06,Pool,0,3,0,0,0,0,0,0,0,0,0,0,0,0,0,0,0,0,0,0,0,0,0,0,0,0,0
Dangyi YUAN,China,Outside Hitter,Men,Netherlands,2022-07-06,Pool,0,3,1,1,0,3,4,0,1,0,1,0,0,4,4,1,1,6,8,1,0,0,1,0,0,0,0
Guanhua ZHANG,China,Opposite Spiker,Men,Netherlands,2022-07-06,Pool,0,3,12,11,5,4,20,1,0,0,1,0,2,5,7,0,0,0,0,3,0,0,3,0,0,0,0
Ruantong MIAO,China,Middle Blocker,Men,Netherlands,2022-07-06,Pool,0,3,0,0,0,0,0,0,0,0,0,0,0,0,0,0,0,0,0,0,0,0,0,0,0,0,0
Jingyin ZHANG,China,Outside Hitter,Men,Netherlands,2022-07-06,Pool,0,3,12,11,9,8,28,1,2,0,3,0,0,9,9,6,2,12,20,3,0,0,3,0,0,1,1
Yiming YANG,China,Libero,Men,Italy,2022-06-26,Pool,0,3,0,0,0,0,0,0,0,0,0,0,0,0,0,1,1,4,6,6,2,1,9,1,0,5,6
Binglong ZHANG,China,Outside Hitter,Men,Italy,2022-06-26,Pool,0,3,0,0,0,0,0,0,0,0,0,0,0,0,0,0,0,0,0,0,0,0,0,0,0,0,0
Yuantai YU,China,Outside Hitter,Men,Italy,2022-06-26,Pool,0,3,1,1,1,6,8,0,1,1,2,0,1,8,9,3,3,15,21,9,3,0,12,0,0,2,2
Yaochen YU,China,Setter,Men,Italy,2022-06-26,Pool,0,3,2,1,0,0,1,0,0,3,3,1,1,9,11,0,0,0,0,4,2,2,8,5,0,47,52
Tianyuan YANG,China,Libero,Men,Italy,2022-06-26,Pool,0,3,0,0,0,0,0,0,0,0,0,0,0,0,0,0,0,0,0,0,0,0,0,0,0,0,0
Yongzhen LI,China,Middle Blocker,Men,Italy,2022-06-26,Pool,0,3,6,4,2,2,8,2,5,1,8,0,1,7,8,0,0,1,1,1,0,0,1,0,0,2,2
Zhengyang JIANG,China,Middle Blocker,Men,Italy,2022-06-26,Pool,0,3,0,0,0,0,0,0,0,1,1,0,0,2,2,0,0,0,0,1,0,0,1,0,0,0,0
Shikun PENG,China,Middle Blocker,Men,Italy,2022-06-26,Pool,0,3,4,2,3,4,9,0,2,3,5,2,1,8,11,0,0,0,0,1,0,0,1,0,0,0,0
Hebin WANG,China,Setter,Men,Italy,2022-06-26,Pool,0,3,1,0,0,0,0,1,0,0,1,0,0,3,3,0,0,0,0,1,0,0,1,4,0,12,16
Jingyi WANG,China,Opposite Spiker,Men,Italy,2022-06-26,Pool,0,3,2,2,4,4,10,0,0,0,0,0,1,2,3,0,0,0,0,0,0,1,1,0,0,1,1
Dangyi YUAN,China,Outside Hitter,Men,Italy,2022-06-26,Pool,0,3,0,0,0,0,0,0,0,0,0,0,0,0,0,0,0,0,0,0,0,0,0,0,0,0,0
Guanhua ZHANG,China,Opposite Spiker,Men,Italy,2022-06-26,Pool,0,3,11,10,3,5,18,1,1,2,4,0,0,5,5,0,0,0,0,2,1,0,3,0,0,1,1
Ruantong MIAO,China,Middle Blocker,Men,Italy,2022-06-26,Pool,0,3,0,0,0,0,0,0,0,0,0,0,0,0,0,0,0,0,0,0,0,0,0,0,0,0,0
Jingyin ZHANG,China,Outside Hitter,Men,Italy,2022-06-26,Pool,0,3,11,11,3,10,24,0,6,3,9,0,2,5,7,6,3,22,31,1,1,0,2,0,0,0,0
Yiming YANG,China,Libero,Men,Argentina,2022-06-24,Pool,1,4,0,0,0,0,0,0,0,0,0,0,0,0,0,7,1,23,31,13,2,2,17,0,0,7,7
Binglong ZHANG,China,Outside Hitter,Men,Argentina,2022-06-24,Pool,1,4,0,0,0,1,1,0,0,0,0,0,1,6,7,0,0,0,0,0,0,0,0,0,0,0,0
Yuantai YU,China,Outside Hitter,Men,Argentina,2022-06-24,Pool,1,4,9,9,2,6,17,0,2,0,2,0,1,11,12,5,0,5,10,7,2,0,9,0,0,1,1
Yaochen YU,China,Setter,Men,Argentina,2022-06-24,Pool,1,4,2,0,0,0,0,2,2,0,4,0,3,7,10,0,0,1,1,2,2,2,6,12,0,59,71
Tianyuan YANG,China,Libero,Men,Argentina,2022-06-24,Pool,1,4,0,0,0,0,0,0,0,0,0,0,0,0,0,0,0,0,0,0,0,0,0,0,0,0,0
Yongzhen LI,China,Middle Blocker,Men,Argentina,2022-06-24,Pool,1,4,6,4,1,3,8,1,4,4,9,1,3,9,13,0,0,0,0,0,0,0,0,0,0,3,3
Zhengyang JIANG,China,Middle Blocker,Men,Argentina,2022-06-24,Pool,1,4,8,5,1,4,10,3,2,4,9,0,2,8,10,0,0,0,0,2,1,0,3,0,0,1,1
Hebin WANG,China,Setter,Men,Argentina,2022-06-24,Pool,1,4,1,1,0,1,2,0,0,1,1,0,1,1,2,0,0,0,0,3,0,0,3,2,0,12,14
Jingyi WANG,China,Opposite Spiker,Men,Argentina,2022-06-24,Pool,1,4,14,14,7,8,29,0,1,1,2,0,3,8,11,0,0,0,0,2,0,1,3,0,0,2,2
Dangyi YUAN,China,Outside Hitter,Men,Argentina,2022-06-24,Pool,1,4,0,0,0,1,1,0,1,0,1,0,2,3,5,1,1,3,5,0,1,0,1,0,0,1,1
Guanhua ZHANG,China,Opposite Spiker,Men,Argentina,2022-06-24,Pool,1,4,4,4,1,4,9,0,2,0,2,0,1,3,4,0,0,0,0,0,0,0,0,0,0,0,0
Ruantong MIAO,China,Middle Blocker,Men,Argentina,2022-06-24,Pool,1,4,0,0,0,1,1,0,3,1,4,0,0,2,2,0,0,0,0,0,1,0,1,0,0,0,0
Jingyin ZHANG,China,Outside Hitter,Men,Argentina,2022-06-24,Pool,1,4,18,17,3,9,29,0,4,2,6,1,1,14,16,8,1,19,28,5,2,2,9,0,0,2,2
Yiming YANG,China,Libero,Men,Germany,2022-06-23,Pool,3,0,0,0,0,0,0,0,0,0,0,0,0,0,0,0,0,0,0,0,0,0,0,0,0,0,0
Binglong ZHANG,China,Outside Hitter,Men,Germany,2022-06-23,Pool,3,0,0,0,0,0,0,0,0,0,0,0,0,0,0,0,0,0,0,0,0,0,0,0,0,0,0
Yuantai YU,China,Outside Hitter,Men,Germany,2022-06-23,Pool,3,0,0,0,0,0,0,0,0,0,0,0,0,0,0,0,0,0,0,0,0,0,0,0,0,0,0
Yaochen YU,China,Setter,Men,Germany,2022-06-23,Pool,3,0,0,0,0,0,0,0,0,0,0,0,0,0,0,0,0,0,0,0,0,0,0,0,0,0,0
Tianyuan YANG,China,Libero,Men,Germany,2022-06-23,Pool,3,0,0,0,0,0,0,0,0,0,0,0,0,0,0,0,0,0,0,0,0,0,0,0,0,0,0
Yongzhen LI,China,Middle Blocker,Men,Germany,2022-06-23,Pool,3,0,0,0,0,0,0,0,0,0,0,0,0,0,0,0,0,0,0,0,0,0,0,0,0,0,0
Zhengyang JIANG,China,Middle Blocker,Men,Germany,2022-06-23,Pool,3,0,0,0,0,0,0,0,0,0,0,0,0,0,0,0,0,0,0,0,0,0,0,0,0,0,0
Shikun PENG,China,Middle Blocker,Men,Germany,2022-06-23,Pool,3,0,0,0,0,0,0,0,0,0,0,0,0,0,0,0,0,0,0,0,0,0,0,0,0,0,0
Hebin WANG,China,Setter,Men,Germany,2022-06-23,Pool,3,0,0,0,0,0,0,0,0,0,0,0,0,0,0,0,0,0,0,0,0,0,0,0,0,0,0
Jingyi WANG,China,Opposite Spiker,Men,Germany,2022-06-23,Pool,3,0,0,0,0,0,0,0,0,0,0,0,0,0,0,0,0,0,0,0,0,0,0,0,0,0,0
Dangyi YUAN,China,Outside Hitter,Men,Germany,2022-06-23,Pool,3,0,0,0,0,0,0,0,0,0,0,0,0,0,0,0,0,0,0,0,0,0,0,0,0,0,0
Guanhua ZHANG,China,Opposite Spiker,Men,Germany,2022-06-23,Pool,3,0,0,0,0,0,0,0,0,0,0,0,0,0,0,0,0,0,0,0,0,0,0,0,0,0,0
Ruantong MIAO,China,Middle Blocker,Men,Germany,2022-06-23,Pool,3,0,0,0,0,0,0,0,0,0,0,0,0,0,0,0,0,0,0,0,0,0,0,0,0,0,0
Jingyin ZHANG,China,Outside Hitter,Men,Germany,2022-06-23,Pool,3,0,0,0,0,0,0,0,0,0,0,0,0,0,0,0,0,0,0,0,0,0,0,0,0,0,0
Yiming YANG,China,Libero,Men,Brazil,2022-06-12,Pool,3,3,0,0,0,0,0,0,0,0,0,0,0,0,0,6,1,14,21,6,1,1,8,1,0,0,1
Binglong ZHANG,China,Outside Hitter,Men,Brazil,2022-06-12,Pool,3,3,0,0,0,0,0,0,0,0,0,0,0,0,0,0,0,0,0,0,0,0,0,0,0,0,0
Yuantai YU,China,Outside Hitter,Men,Brazil,2022-06-12,Pool,3,3,6,4,2,2,8,1,1,0,2,1,2,11,14,4,1,11,16,4,0,0,4,2,0,0,2
Yaochen YU,China,Setter,Men,Brazil,2022-06-12,Pool,3,3,4,1,0,0,1,3,2,3,8,0,1,13,14,0,0,0,0,2,1,1,4,26,0,46,72
Tianyuan YANG,China,Libero,Men,Brazil,2022-06-12,Pool,3,3,0,0,0,0,0,0,0,0,0,0,0,0,0,0,0,0,0,0,0,0,0,1,0,0,1
Yongzhen LI,China,Middle Blocker,Men,Brazil,2022-06-12,Pool,3,3,7,4,1,0,5,3,4,3,10,0,2,7,9,0,0,0,0,1,1,0,2,0,0,0,0
Meng LIU,China,Setter,Men,Brazil,2022-06-12,Pool,3,3,0,0,0,0,0,0,0,0,0,0,0,0,0,0,0,0,0,0,0,0,0,0,0,0,0
Zhengyang JIANG,China,Middle Blocker,Men,Brazil,2022-06-12,Pool,3,3,0,0,0,0,0,0,0,0,0,0,0,0,0,0,0,0,0,0,0,0,0,0,0,0,0
Shikun PENG,China,Middle Blocker,Men,Brazil,2022-06-12,Pool,3,3,5,3,2,2,7,1,3,1,5,1,1,16,18,0,0,0,0,0,0,1,1,0,0,0,0
Hebin WANG,China,Setter,Men,Brazil,2022-06-12,Pool,3,3,0,0,0,0,0,0,0,0,0,0,0,0,0,0,0,0,0,0,0,0,0,0,0,0,0
Dangyi YUAN,China,Outside Hitter,Men,Brazil,2022-06-12,Pool,3,3,0,0,0,0,0,0,0,0,0,0,0,0,0,0,0,0,0,0,0,0,0,0,0,0,0
Guanhua ZHANG,China,Opposite Spiker,Men,Brazil,2022-06-12,Pool,3,3,9,9,3,6,18,0,1,0,1,0,3,8,11,0,0,0,0,4,0,0,4,0,0,1,1
Ruantong MIAO,China,Middle Blocker,Men,Brazil,2022-06-12,Pool,3,3,0,0,0,0,0,0,0,0,0,0,1,0,1,0,0,0,0,0,0,0,0,0,0,0,0
Jingyin ZHANG,China,Outside Hitter,Men,Brazil,2022-06-12,Pool,3,3,25,22,5,13,40,1,7,3,11,2,1,9,12,5,2,20,27,5,0,0,5,0,0,0,0
Yiming YANG,China,Libero,Men,Slovenia,2022-06-11,Pool,1,4,0,0,0,0,0,0,0,0,0,0,0,0,0,3,0,12,15,3,3,1,7,3,0,2,5
Binglong ZHANG,China,Outside Hitter,Men,Slovenia,2022-06-11,Pool,1,4,0,0,0,0,0,0,0,0,0,0,0,1,1,0,0,0,0,0,0,0,0,0,0,0,0
Yuantai YU,China,Outside Hitter,Men,Slovenia,2022-06-11,Pool,1,4,6,4,1,4,9,2,1,1,4,0,2,10,12,5,1,19,25,5,0,1,6,0,0,2,2
Yaochen YU,China,Setter,Men,Slovenia,2022-06-11,Pool,1,4,0,0,0,2,2,0,2,2,4,0,3,8,11,0,0,0,0,2,0,2,4,17,1,30,48
Tianyuan YANG,China,Libero,Men,Slovenia,2022-06-11,Pool,1,4,0,0,0,0,0,0,0,0,0,0,0,0,0,0,0,0,0,0,0,0,0,0,0,0,0
Yongzhen LI,China,Middle Blocker,Men,Slovenia,2022-06-11,Pool,1,4,8,6,3,1,10,2,7,4,13,0,3,9,12,0,0,0,0,1,0,0,1,0,1,0,1
Meng LIU,China,Setter,Men,Slovenia,2022-06-11,Pool,1,4,0,0,0,0,0,0,0,0,0,0,0,0,0,0,0,0,0,0,0,0,0,0,0,0,0
Zhengyang JIANG,China,Middle Blocker,Men,Slovenia,2022-06-11,Pool,1,4,0,0,0,0,0,0,0,0,0,0,0,0,0,0,0,0,0,0,0,0,0,0,0,0,0
Shikun PENG,China,Middle Blocker,Men,Slovenia,2022-06-11,Pool,1,4,10,6,3,3,12,4,6,1,11,0,1,12,13,0,0,0,0,1,0,0,1,0,0,0,0
Hebin WANG,China,Setter,Men,Slovenia,2022-06-11,Pool,1,4,0,0,0,0,0,0,2,3,5,0,0,4,4,0,0,0,0,3,0,0,3,17,2,16,35
Dangyi YUAN,China,Outside Hitter,Men,Slovenia,2022-06-11,Pool,1,4,0,0,0,0,0,0,0,0,0,0,0,0,0,0,0,0,0,0,0,0,0,0,0,0,0
Guanhua ZHANG,China,Opposite Spiker,Men,Slovenia,2022-06-11,Pool,1,4,15,13,2,11,26,1,3,0,4,1,2,14,17,0,0,1,1,5,0,1,6,3,0,2,5
Ruantong MIAO,China,Middle Blocker,Men,Slovenia,2022-06-11,Pool,1,4,0,0,0,0,0,0,0,0,0,0,0,0,0,0,0,0,0,0,0,0,0,0,0,0,0
Jingyin ZHANG,China,Outside Hitter,Men,Slovenia,2022-06-11,Pool,1,4,20,18,7,11,36,0,6,1,7,2,0,14,16,11,1,26,38,4,4,0,8,0,0,1,1
Yiming YANG,China,Libero,Men,Japan,2022-06-09,Pool,1,4,0,0,0,0,0,0,0,0,0,0,0,0,0,5,1,12,18,3,2,0,5,3,0,1,4
Binglong ZHANG,China,Outside Hitter,Men,Japan,2022-06-09,Pool,1,4,0,0,0,0,0,0,0,0,0,0,0,1,1,0,0,0,0,0,0,0,0,0,0,0,0
Yuantai YU,China,Outside Hitter,Men,Japan,2022-06-09,Pool,1,4,4,3,5,8,16,1,3,1,5,0,3,11,14,6,3,9,18,1,0,0,1,1,0,0,1
Yaochen YU,China,Setter,Men,Japan,2022-06-09,Pool,1,4,0,0,0,0,0,0,2,2,4,0,2,7,9,0,0,0,0,2,1,0,3,8,1,24,33
Tianyuan YANG,China,Libero,Men,Japan,2022-06-09,Pool,1,4,0,0,0,0,0,0,0,0,0,0,0,0,0,0,0,0,0,2,2,0,4,3,0,0,3
Yongzhen LI,China,Middle Blocker,Men,Japan,2022-06-09,Pool,1,4,9,6,2,3,11,3,10,2,15,0,4,9,13,0,1,0,1,1,0,0,1,0,0,0,0
Meng LIU,China,Setter,Men,Japan,2022-06-09,Pool,1,4,1,1,0,2,3,0,0,0,0,0,2,2,4,0,0,0,0,2,0,0,2,13,0,15,28
Zhengyang JIANG,China,Middle Blocker,Men,Japan,2022-06-09,Pool,1,4,0,0,0,0,0,0,0,0,0,0,0,0,0,0,0,0,0,0,0,0,0,0,0,0,0
Shikun PENG,China,Middle Blocker,Men,Japan,2022-06-09,Pool,1,4,10,7,1,0,8,3,5,7,15,0,1,13,14,0,0,1,1,1,0,0,1,0,0,0,0
Hebin WANG,China,Setter,Men,Japan,2022-06-09,Pool,1,4,0,0,0,0,0,0,0,0,0,0,1,1,2,0,0,0,0,0,0,0,0,4,0,5,9
Dangyi YUAN,China,Outside Hitter,Men,Japan,2022-06-09,Pool,1,4,0,0,0,0,0,0,0,0,0,0,0,0,0,0,1,1,2,0,0,0,0,0,0,0,0
Guanhua ZHANG,China,Opposite Spiker,Men,Japan,2022-06-09,Pool,1,4,8,7,1,7,15,1,1,2,4,0,2,10,12,0,0,0,0,2,1,0,3,0,0,0,0
Ruantong MIAO,China,Middle Blocker,Men,Japan,2022-06-09,Pool,1,4,0,0,0,0,0,0,0,0,0,0,0,0,0,0,0,0,0,0,0,0,0,0,0,0,0
Jingyin ZHANG,China,Outside Hitter,Men,Japan,2022-06-09,Pool,1,4,15,13,3,10,26,2,2,1,5,0,3,10,13,7,2,20,29,5,1,2,8,0,0,0,0
Yiming YANG,China,Libero,Men,Iran,2022-06-07,Pool,1,4,0,0,0,0,0,0,0,0,0,0,0,0,0,0,0,0,0,0,0,0,0,0,0,0,0
Binglong ZHANG,China,Outside Hitter,Men,Iran,2022-06-07,Pool,1,4,0,0,0,0,0,0,0,0,0,0,0,0,0,0,0,0,0,0,0,0,0,0,0,0,0
Yuantai YU,China,Outside Hitter,Men,Iran,2022-06-07,Pool,1,4,16,13,5,8,26,1,1,0,2,2,1,12,15,3,3,4,10,2,2,2,6,0,0,3,3
Yaochen YU,China,Setter,Men,Iran,2022-06-07,Pool,1,4,0,0,0,0,0,0,2,1,3,0,2,6,8,0,0,0,0,4,1,0,5,18,1,20,39
Tianyuan YANG,China,Libero,Men,Iran,2022-06-07,Pool,1,4,0,0,0,0,0,0,0,0,0,0,0,0,0,6,5,16,27,3,1,2,6,0,1,2,3
Yongzhen LI,China,Middle Blocker,Men,Iran,2022-06-07,Pool,1,4,8,5,1,1,7,3,5,2,10,0,4,10,14,0,0,1,1,0,0,1,1,0,2,0,2
Meng LIU,China,Setter,Men,Iran,2022-06-07,Pool,1,4,1,0,0,0,0,0,0,0,0,1,1,1,3,0,0,0,0,0,0,0,0,3,0,4,7
Zhengyang JIANG,China,Middle Blocker,Men,Iran,2022-06-07,Pool,1,4,0,0,0,0,0,0,0,0,0,0,0,0,0,0,0,0,0,0,0,0,0,0,0,0,0
Shikun PENG,China,Middle Blocker,Men,Iran,2022-06-07,Pool,1,4,3,2,0,3,5,1,2,3,6,0,1,10,11,0,0,1,1,2,0,0,2,0,0,3,3
Hebin WANG,China,Setter,Men,Iran,2022-06-07,Pool,1,4,0,0,0,0,0,0,0,0,0,0,0,0,0,0,0,0,0,0,0,0,0,0,0,0,0
Dangyi YUAN,China,Outside Hitter,Men,Iran,2022-06-07,Pool,1,4,0,0,0,0,0,0,0,0,0,0,0,0,0,0,0,0,0,0,0,0,0,0,0,0,0
Guanhua ZHANG,China,Opposite Spiker,Men,Iran,2022-06-07,Pool,1,4,10,9,5,8,22,1,0,1,2,0,3,9,12,0,0,0,0,3,0,0,3,0,0,0,0
Ruantong MIAO,China,Middle Blocker,Men,Iran,2022-06-07,Pool,1,4,1,1,0,1,2,0,1,1,2,0,0,1,1,0,0,0,0,0,0,0,0,0,0,0,0
Jingyin ZHANG,China,Outside Hitter,Men,Iran,2022-06-07,Pool,1,4,16,14,3,2,19,0,1,0,1,2,0,11,13,5,6,28,39,4,2,1,7,0,0,2,2
Barthélémy CHINENYEZE,France,Middle Blocker,Men,United States,2022-07-24,Finals (Gold),3,5,6,5,1,2,8,1,2,4,7,0,3,9,12,0,0,1,1,0,0,1,1,0,0,0,0
Jenia GREBENNIKOV,France,Libero,Men,United States,2022-07-24,Finals (Gold),3,5,0,0,0,0,0,0,0,0,0,0,0,0,0,5,0,15,20,12,3,0,15,1,0,10,11
Jean PATRY,France,Opposite Spiker,Men,United States,2022-07-24,Finals (Gold),3,5,17,17,2,9,28,0,5,1,6,0,0,16,16,0,0,1,1,2,1,2,5,1,0,1,2
Benjamin TONIUTTI,France,Setter,Men,United States,2022-07-24,Finals (Gold),3,5,0,0,0,0,0,0,0,0,0,0,0,0,0,0,0,0,0,0,0,0,0,1,1,7,9
Earvin NGAPETH,France,Outside Hitter,Men,United States,2022-07-24,Finals (Gold),3,5,22,21,5,13,39,1,2,0,3,0,6,12,18,10,1,20,31,5,1,1,7,0,0,5,5
Antoine BRIZARD,France,Setter,Men,United States,2022-07-24,Finals (Gold),3,5,5,2,0,0,2,0,5,3,8,3,2,16,21,0,0,0,0,5,2,0,7,14,0,64,78
Stephen BOYER,France,Opposite Spiker,Men,United States,2022-07-24,Finals (Gold),3,5,0,0,1,1,2,0,0,0,0,0,0,0,0,0,0,0,0,0,0,0,0,0,0,0,0
Nicolas LE GOFF,France,Middle Blocker,Men,United States,2022-07-24,Finals (Gold),3,5,8,4,2,6,12,3,5,1,9,1,3,5,9,0,0,0,0,2,0,0,2,0,0,0,0
Médéric HENRY,France,Middle Blocker,Men,United States,2022-07-24,Finals (Gold),3,5,0,0,0,0,0,0,0,0,0,0,0,0,0,0,0,0,0,0,0,0,0,0,0,0,0
Trevor CLEVENOT,France,Outside Hitter,Men,United States,2022-07-24,Finals (Gold),3,5,11,10,2,5,17,1,6,0,7,0,3,13,16,11,0,18,29,5,3,1,9,0,0,3,3
Yacine LOUATI,France,Outside Hitter,Men,United States,2022-07-24,Finals (Gold),3,5,0,0,0,0,0,0,0,0,0,0,0,0,0,0,0,0,0,0,0,0,0,0,0,0,0
Benjamin DIEZ,France,Libero,Men,United States,2022-07-24,Finals (Gold),3,5,0,0,0,0,0,0,0,0,0,0,0,0,0,0,0,0,0,0,0,0,0,0,0,0,0
Pierre DEROUILLON,France,Outside Hitter,Men,United States,2022-07-24,Finals (Gold),3,5,0,0,0,0,0,0,0,0,0,0,0,0,0,0,0,0,0,0,0,0,0,0,0,0,0
Quentin JOUFFROY,France,Middle Blocker,Men,United States,2022-07-24,Finals (Gold),3,5,2,0,0,0,0,0,0,0,0,2,3,3,8,0,0,0,0,2,0,0,2,0,0,0,0
Barthélémy CHINENYEZE,France,Middle Blocker,Men,Italy,2022-07-23,Semifinals,3,3,8,5,0,0,5,3,1,2,6,0,3,5,8,1,0,0,1,1,0,0,1,0,0,0,0
Jenia GREBENNIKOV,France,Libero,Men,Italy,2022-07-23,Semifinals,3,3,0,0,0,0,0,0,0,0,0,0,0,0,0,6,0,7,13,6,0,2,8,0,0,5,5
Jean PATRY,France,Opposite Spiker,Men,Italy,2022-07-23,Semifinals,3,3,16,12,3,8,23,1,1,0,2,3,4,6,13,0,0,0,0,5,4,1,10,0,1,0,1
Benjamin TONIUTTI,France,Setter,Men,Italy,2022-07-23,Semifinals,3,3,0,0,0,0,0,0,0,0,0,0,0,0,0,0,0,0,0,0,0,0,0,0,0,0,0
Earvin NGAPETH,France,Outside Hitter,Men,Italy,2022-07-23,Semifinals,3,3,14,10,2,5,17,0,4,2,6,4,4,5,13,9,1,10,20,7,2,0,9,0,0,3,3
Antoine BRIZARD,France,Setter,Men,Italy,2022-07-23,Semifinals,3,3,3,1,0,0,1,0,1,2,3,2,1,9,12,0,0,0,0,5,3,0,8,15,0,46,61
Stephen BOYER,France,Opposite Spiker,Men,Italy,2022-07-23,Semifinals,3,3,0,0,0,0,0,0,0,0,0,0,0,0,0,0,0,0,0,0,0,0,0,0,0,0,0
Nicolas LE GOFF,France,Middle Blocker,Men,Italy,2022-07-23,Semifinals,3,3,5,5,0,3,8,0,3,2,5,0,1,6,7,0,0,0,0,2,1,0,3,0,0,0,0
Médéric HENRY,France,Middle Blocker,Men,Italy,2022-07-23,Semifinals,3,3,0,0,0,0,0,0,0,0,0,0,0,0,0,0,0,0,0,0,0,0,0,0,0,0,0
Trevor CLEVENOT,France,Outside Hitter,Men,Italy,2022-07-23,Semifinals,3,3,15,13,0,4,17,0,4,1,5,2,3,12,17,8,1,7,16,3,2,0,5,0,0,1,1
Yacine LOUATI,France,Outside Hitter,Men,Italy,2022-07-23,Semifinals,3,3,0,0,0,0,0,0,0,0,0,0,0,0,0,0,0,0,0,0,0,0,0,0,0,0,0
Benjamin DIEZ,France,Libero,Men,Italy,2022-07-23,Semifinals,3,3,0,0,0,0,0,0,0,0,0,0,0,0,0,0,0,0,0,0,0,0,0,0,0,0,0
Pierre DEROUILLON,France,Outside Hitter,Men,Italy,2022-07-23,Semifinals,3,3,0,0,0,0,0,0,0,0,0,0,0,0,0,0,0,0,0,0,0,0,0,0,0,0,0
Quentin JOUFFROY,France,Middle Blocker,Men,Italy,2022-07-23,Semifinals,3,3,0,0,0,0,0,0,0,0,0,0,0,3,3,0,0,0,0,0,0,0,0,0,0,0,0
Barthélémy CHINENYEZE,France,Middle Blocker,Men,Japan,2022-07-21,Quarterfinals,3,3,6,5,0,1,6,1,3,0,4,0,5,5,10,1,0,1,2,2,0,0,2,0,0,0,0
Jenia GREBENNIKOV,France,Libero,Men,Japan,2022-07-21,Quarterfinals,3,3,0,0,0,0,0,0,0,0,0,0,0,0,0,5,1,2,8,3,1,2,6,0,0,5,5
Jean PATRY,France,Opposite Spiker,Men,Japan,2022-07-21,Quarterfinals,3,3,19,18,2,6,26,1,1,3,5,0,2,9,11,0,0,0,0,4,0,1,5,0,0,0,0
Benjamin TONIUTTI,France,Setter,Men,Japan,2022-07-21,Quarterfinals,3,3,0,0,0,0,0,0,0,0,0,0,0,0,0,0,0,0,0,0,0,0,0,0,0,0,0
Earvin NGAPETH,France,Outside Hitter,Men,Japan,2022-07-21,Quarterfinals,3,3,0,0,0,0,0,0,0,0,0,0,0,0,0,0,0,0,0,0,0,0,0,0,0,0,0
Antoine BRIZARD,France,Setter,Men,Japan,2022-07-21,Quarterfinals,3,3,4,2,0,1,3,0,0,2,2,2,4,6,12,0,0,0,0,6,3,0,9,18,1,37,56
Stephen BOYER,France,Opposite Spiker,Men,Japan,2022-07-21,Quarterfinals,3,3,0,0,0,0,0,0,0,0,0,0,0,0,0,0,0,0,0,0,0,0,0,0,0,0,0
Nicolas LE GOFF,France,Middle Blocker,Men,Japan,2022-07-21,Quarterfinals,3,3,6,3,0,2,5,3,4,3,10,0,3,10,13,0,0,0,0,1,0,0,1,0,0,0,0
Médéric HENRY,France,Middle Blocker,Men,Japan,2022-07-21,Quarterfinals,3,3,0,0,0,0,0,0,0,0,0,0,0,0,0,0,0,0,0,0,0,0,0,0,0,0,0
Trevor CLEVENOT,France,Outside Hitter,Men,Japan,2022-07-21,Quarterfinals,3,3,7,6,1,7,14,1,1,2,4,0,2,8,10,13,0,8,21,3,1,0,4,0,0,1,1
Yacine LOUATI,France,Outside Hitter,Men,Japan,2022-07-21,Quarterfinals,3,3,10,7,2,3,12,2,2,1,5,1,3,13,17,6,3,7,16,4,2,0,6,0,0,3,3
Benjamin DIEZ,France,Libero,Men,Japan,2022-07-21,Quarterfinals,3,3,0,0,0,0,0,0,0,0,0,0,0,0,0,0,0,0,0,0,0,0,0,0,0,0,0
Pierre DEROUILLON,France,Outside Hitter,Men,Japan,2022-07-21,Quarterfinals,3,3,0,0,0,0,0,0,0,0,0,0,0,0,0,0,0,0,0,0,0,0,0,0,0,0,0
Quentin JOUFFROY,France,Middle Blocker,Men,Japan,2022-07-21,Quarterfinals,3,3,0,0,0,0,0,0,0,0,0,0,1,0,1,0,0,0,0,0,0,0,0,0,0,0,0
Barthélémy CHINENYEZE,France,Middle Blocker,Men,Australia,2022-07-10,Pool,3,3,0,0,0,0,0,0,0,0,0,0,0,0,0,0,0,0,0,0,0,0,0,0,0,0,0
Jean PATRY,France,Opposite Spiker,Men,Australia,2022-07-10,Pool,3,3,0,0,0,0,0,0,0,0,0,0,0,0,0,0,0,0,0,0,0,0,0,0,0,0,0
Jérémie MOUIEL,France,Libero,Men,Australia,2022-07-10,Pool,3,3,0,0,0,0,0,0,0,0,0,0,0,0,0,0,0,0,0,0,0,0,0,0,0,0,0
Benjamin TONIUTTI,France,Setter,Men,Australia,2022-07-10,Pool,3,3,0,0,0,0,0,0,0,0,0,0,0,0,0,0,0,0,0,0,0,0,0,0,0,0,0
Earvin NGAPETH,France,Outside Hitter,Men,Australia,2022-07-10,Pool,3,3,4,4,0,1,5,0,1,0,1,0,2,7,9,3,0,9,12,4,0,0,4,0,1,1,2
Antoine BRIZARD,France,Setter,Men,Australia,2022-07-10,Pool,3,3,5,2,0,3,5,3,1,3,7,0,3,8,11,0,0,0,0,0,3,2,5,18,0,42,60
Stephen BOYER,France,Opposite Spiker,Men,Australia,2022-07-10,Pool,3,3,19,16,3,6,25,1,0,0,1,2,3,13,18,0,0,0,0,4,2,0,6,0,0,0,0
Nicolas LE GOFF,France,Middle Blocker,Men,Australia,2022-07-10,Pool,3,3,7,6,1,5,12,1,5,2,8,0,4,7,11,0,0,1,1,1,0,1,2,0,0,0,0
Médéric HENRY,France,Middle Blocker,Men,Australia,2022-07-10,Pool,3,3,0,0,0,0,0,0,0,0,0,0,0,0,0,0,0,0,0,0,0,0,0,0,0,0,0
Trevor CLEVENOT,France,Outside Hitter,Men,Australia,2022-07-10,Pool,3,3,12,7,1,3,11,2,0,3,5,3,5,7,15,5,2,13,20,4,1,1,6,0,0,2,2
Yacine LOUATI,France,Outside Hitter,Men,Australia,2022-07-10,Pool,3,3,0,0,0,0,0,0,0,0,0,0,0,0,0,0,0,0,0,0,0,0,0,0,0,0,0
Benjamin DIEZ,France,Libero,Men,Australia,2022-07-10,Pool,3,3,0,0,0,0,0,0,0,0,0,0,0,0,0,1,0,5,6,10,0,0,10,0,0,0,0
Pierre DEROUILLON,France,Outside Hitter,Men,Australia,2022-07-10,Pool,3,3,5,5,1,2,8,0,2,0,2,0,2,1,3,1,0,3,4,1,0,0,1,0,0,1,1
Quentin JOUFFROY,France,Middle Blocker,Men,Australia,2022-07-10,Pool,3,3,5,3,0,1,4,1,1,3,5,1,3,6,10,0,0,0,0,1,1,0,2,0,0,1,1
Barthélémy CHINENYEZE,France,Middle Blocker,Men,Argentina,2022-07-09,Pool,1,4,0,0,0,0,0,0,0,0,0,0,0,0,0,0,0,0,0,0,0,0,0,0,0,0,0
Jean PATRY,France,Opposite Spiker,Men,Argentina,2022-07-09,Pool,1,4,11,8,2,10,20,1,1,3,5,2,2,7,11,0,0,0,0,1,1,1,3,0,0,2,2
Jérémie MOUIEL,France,Libero,Men,Argentina,2022-07-09,Pool,1,4,0,0,0,0,0,0,0,0,0,0,0,0,0,8,0,21,29,6,7,3,16,0,0,0,0
Benjamin TONIUTTI,France,Setter,Men,Argentina,2022-07-09,Pool,1,4,0,0,0,0,0,0,2,4,6,0,1,6,7,0,0,0,0,4,3,2,9,14,0,58,72
Earvin NGAPETH,France,Outside Hitter,Men,Argentina,2022-07-09,Pool,1,4,0,0,0,0,0,0,0,0,0,0,2,4,6,0,0,0,0,3,0,0,3,0,0,1,1
Antoine BRIZARD,France,Setter,Men,Argentina,2022-07-09,Pool,1,4,1,0,0,1,1,1,0,0,1,0,1,1,2,0,0,0,0,1,1,0,2,5,0,12,17
Stephen BOYER,France,Opposite Spiker,Men,Argentina,2022-07-09,Pool,1,4,13,13,1,7,21,0,4,1,5,0,3,5,8,0,0,0,0,5,2,2,9,0,0,2,2
Nicolas LE GOFF,France,Middle Blocker,Men,Argentina,2022-07-09,Pool,1,4,0,0,0,0,0,0,0,0,0,0,0,0,0,0,0,0,0,0,0,0,0,0,0,0,0
Médéric HENRY,France,Middle Blocker,Men,Argentina,2022-07-09,Pool,1,4,3,3,1,4,8,0,5,7,12,0,2,8,10,0,0,0,0,3,0,0,3,0,0,2,2
Trevor CLEVENOT,France,Outside Hitter,Men,Argentina,2022-07-09,Pool,1,4,10,10,1,9,20,0,1,4,5,0,1,15,16,5,1,12,18,4,2,3,9,0,0,8,8
Yacine LOUATI,France,Outside Hitter,Men,Argentina,2022-07-09,Pool,1,4,8,7,3,12,22,1,5,7,13,0,4,8,12,5,4,16,25,12,5,1,18,0,0,2,2
Benjamin DIEZ,France,Libero,Men,Argentina,2022-07-09,Pool,1,4,0,0,0,0,0,0,0,0,0,0,0,0,0,0,0,0,0,0,0,0,0,0,0,0,0
Pierre DEROUILLON,France,Outside Hitter,Men,Argentina,2022-07-09,Pool,1,4,0,0,0,0,0,0,0,0,0,0,0,0,0,0,0,0,0,0,0,0,0,0,0,0,0
Quentin JOUFFROY,France,Middle Blocker,Men,Argentina,2022-07-09,Pool,1,4,8,6,1,2,9,1,3,6,10,1,6,11,18,0,0,0,0,2,0,1,3,0,0,2,2
Barthélémy CHINENYEZE,France,Middle Blocker,Men,Brazil,2022-07-08,Pool,3,3,11,7,0,6,13,3,4,6,13,1,1,8,10,0,0,2,2,2,0,1,3,0,0,0,0
Jean PATRY,France,Opposite Spiker,Men,Brazil,2022-07-08,Pool,3,3,19,16,1,11,28,0,2,2,4,3,6,4,13,0,0,0,0,2,1,2,5,0,0,1,1
Jérémie MOUIEL,France,Libero,Men,Brazil,2022-07-08,Pool,3,3,0,0,0,0,0,0,0,0,0,0,0,0,0,0,0,0,0,0,0,0,0,0,0,0,0
Benjamin TONIUTTI,France,Setter,Men,Brazil,2022-07-08,Pool,3,3,0,0,0,0,0,0,0,0,0,0,0,0,0,0,0,0,0,0,0,0,0,0,0,0,0
Earvin NGAPETH,France,Outside Hitter,Men,Brazil,2022-07-08,Pool,3,3,14,12,0,8,20,0,3,1,4,2,5,4,11,5,0,12,17,3,0,1,4,0,0,4,4
Antoine BRIZARD,France,Setter,Men,Brazil,2022-07-08,Pool,3,3,3,1,1,0,2,1,1,2,4,1,3,7,11,0,0,1,1,1,1,2,4,24,1,50,75
Stephen BOYER,France,Opposite Spiker,Men,Brazil,2022-07-08,Pool,3,3,0,0,0,0,0,0,0,0,0,0,0,0,0,0,0,0,0,0,0,0,0,0,0,0,0
Nicolas LE GOFF,France,Middle Blocker,Men,Brazil,2022-07-08,Pool,3,3,7,4,1,1,6,1,2,2,5,2,1,8,11,0,0,1,1,4,0,2,6,0,0,1,1
Médéric HENRY,France,Middle Blocker,Men,Brazil,2022-07-08,Pool,3,3,0,0,0,0,0,0,0,0,0,0,0,0,0,0,0,0,0,0,0,0,0,0,0,0,0
Trevor CLEVENOT,France,Outside Hitter,Men,Brazil,2022-07-08,Pool,3,3,0,0,0,0,0,0,0,0,0,0,0,1,1,0,0,0,0,0,0,0,0,0,0,0,0
Yacine LOUATI,France,Outside Hitter,Men,Brazil,2022-07-08,Pool,3,3,12,9,3,5,17,1,3,2,6,2,4,8,14,4,4,17,25,4,1,1,6,0,0,3,3
Benjamin DIEZ,France,Libero,Men,Brazil,2022-07-08,Pool,3,3,0,0,0,0,0,0,0,0,0,0,0,0,0,3,1,10,14,11,0,2,13,0,0,2,2
Pierre DEROUILLON,France,Outside Hitter,Men,Brazil,2022-07-08,Pool,3,3,0,0,0,0,0,0,0,0,0,0,0,0,0,0,0,0,0,0,0,0,0,0,0,0,0
Quentin JOUFFROY,France,Middle Blocker,Men,Brazil,2022-07-08,Pool,3,3,0,0,0,0,0,0,0,0,0,0,1,1,2,0,0,0,0,0,0,0,0,0,0,0,0
Barthélémy CHINENYEZE,France,Middle Blocker,Men,United States,2022-07-07,Pool,2,5,12,8,2,3,13,2,3,3,8,2,9,6,17,1,0,1,2,4,1,3,8,0,0,2,2
Jean PATRY,France,Opposite Spiker,Men,United States,2022-07-07,Pool,2,5,5,4,4,2,10,0,2,1,3,1,2,4,7,0,0,0,0,0,1,0,1,0,0,0,0
Jérémie MOUIEL,France,Libero,Men,United States,2022-07-07,Pool,2,5,0,0,0,0,0,0,0,0,0,0,0,0,0,0,0,0,0,0,0,1,1,0,0,0,0
Benjamin TONIUTTI,France,Setter,Men,United States,2022-07-07,Pool,2,5,0,0,0,1,1,0,0,3,3,0,0,9,9,0,0,0,0,4,2,5,11,23,0,53,76
Earvin NGAPETH,France,Outside Hitter,Men,United States,2022-07-07,Pool,2,5,19,16,3,9,28,2,1,0,3,1,4,15,20,3,2,16,21,11,4,2,17,0,1,17,18
Antoine BRIZARD,France,Setter,Men,United States,2022-07-07,Pool,2,5,0,0,0,1,1,0,0,1,1,0,0,0,0,0,0,0,0,0,1,0,1,4,0,17,21
Stephen BOYER,France,Opposite Spiker,Men,United States,2022-07-07,Pool,2,5,14,13,6,12,31,0,0,5,5,1,6,7,14,0,0,1,1,7,1,4,12,0,0,1,1
Nicolas LE GOFF,France,Middle Blocker,Men,United States,2022-07-07,Pool,2,5,5,4,1,7,12,1,0,4,5,0,2,3,5,0,0,0,0,0,1,1,2,0,0,1,1
Médéric HENRY,France,Middle Blocker,Men,United States,2022-07-07,Pool,2,5,0,0,0,0,0,0,0,0,0,0,0,0,0,0,0,0,0,0,0,0,0,0,0,0,0
Trevor CLEVENOT,France,Outside Hitter,Men,United States,2022-07-07,Pool,2,5,10,8,5,15,28,0,0,5,5,2,1,12,15,5,3,20,28,4,4,1,9,0,0,7,7
Yacine LOUATI,France,Outside Hitter,Men,United States,2022-07-07,Pool,2,5,0,0,1,2,3,0,0,0,0,0,0,1,1,1,0,2,3,1,0,1,2,0,0,0,0
Benjamin DIEZ,France,Libero,Men,United States,2022-07-07,Pool,2,5,0,0,0,0,0,0,0,0,0,0,0,0,0,13,1,13,27,14,3,4,21,0,0,6,6
Pierre DEROUILLON,France,Outside Hitter,Men,United States,2022-07-07,Pool,2,5,0,0,0,0,0,0,0,0,0,0,0,0,0,0,0,0,0,0,0,0,0,0,0,0,0
Quentin JOUFFROY,France,Middle Blocker,Men,United States,2022-07-07,Pool,2,5,0,0,0,0,0,0,0,0,0,0,2,4,6,0,0,0,0,1,0,0,1,0,0,0,0
Barthélémy CHINENYEZE,France,Middle Blocker,Men,Germany,2022-06-26,Pool,3,4,0,0,0,0,0,0,0,0,0,0,0,0,0,0,0,0,0,0,0,0,0,0,0,0,0
Raphaël CORRE,France,Setter,Men,Germany,2022-06-26,Pool,3,4,3,0,0,0,0,0,1,4,5,3,7,12,22,0,0,0,0,4,2,0,6,18,0,56,74
Jean PATRY,France,Opposite Spiker,Men,Germany,2022-06-26,Pool,3,4,0,0,0,0,0,0,0,0,0,0,0,0,0,0,0,0,0,0,0,0,0,0,0,0,0
Jérémie MOUIEL,France,Libero,Men,Germany,2022-06-26,Pool,3,4,0,0,0,0,0,0,0,0,0,0,0,0,0,2,1,13,16,4,1,0,5,0,0,2,2
Benjamin TONIUTTI,France,Setter,Men,Germany,2022-06-26,Pool,3,4,0,0,0,0,0,0,0,0,0,0,0,0,0,0,0,0,0,0,0,0,0,0,0,0,0
Earvin NGAPETH,France,Outside Hitter,Men,Germany,2022-06-26,Pool,3,4,18,16,4,7,27,2,1,0,3,0,4,11,15,4,0,4,8,9,1,2,12,1,0,2,3
Stephen BOYER,France,Opposite Spiker,Men,Germany,2022-06-26,Pool,3,4,16,14,6,7,27,1,5,1,7,1,7,5,13,0,0,0,0,6,2,1,9,0,0,0,0
Nicolas LE GOFF,France,Middle Blocker,Men,Germany,2022-06-26,Pool,3,4,0,0,0,0,0,0,0,0,0,0,0,0,0,0,0,0,0,0,0,0,0,0,0,0,0
Médéric HENRY,France,Middle Blocker,Men,Germany,2022-06-26,Pool,3,4,4,1,2,2,5,3,2,3,8,0,1,10,11,0,1,1,2,5,0,0,5,0,0,1,1
Trevor CLEVENOT,France,Outside Hitter,Men,Germany,2022-06-26,Pool,3,4,0,0,0,0,0,0,0,0,0,0,0,0,0,0,0,0,0,0,0,0,0,0,0,0,0
Yacine LOUATI,France,Outside Hitter,Men,Germany,2022-06-26,Pool,3,4,13,11,3,5,19,1,5,0,6,1,5,8,14,7,2,22,31,5,1,0,6,0,1,4,5
Benjamin DIEZ,France,Libero,Men,Germany,2022-06-26,Pool,3,4,0,0,0,0,0,0,0,0,0,0,0,0,0,0,0,0,0,0,0,0,0,0,0,0,0
Pierre DEROUILLON,France,Outside Hitter,Men,Germany,2022-06-26,Pool,3,4,0,0,0,0,0,0,0,0,0,0,0,0,0,0,0,0,0,0,0,0,0,0,0,0,0
Quentin JOUFFROY,France,Middle Blocker,Men,Germany,2022-06-26,Pool,3,4,12,6,0,3,9,3,1,5,9,3,5,10,18,0,0,0,0,2,0,0,2,0,0,1,1
Barthélémy CHINENYEZE,France,Middle Blocker,Men,Japan,2022-06-25,Pool,3,3,7,6,0,6,12,0,2,6,8,1,3,7,11,0,0,3,3,4,0,0,4,0,1,2,3
Raphaël CORRE,France,Setter,Men,Japan,2022-06-25,Pool,3,3,1,1,0,0,1,0,0,0,0,0,0,0,0,0,0,0,0,0,0,1,1,3,0,5,8
Jean PATRY,France,Opposite Spiker,Men,Japan,2022-06-25,Pool,3,3,14,10,1,14,25,3,1,1,5,1,2,9,12,0,0,0,0,6,2,0,8,0,0,2,2
Jérémie MOUIEL,France,Libero,Men,Japan,2022-06-25,Pool,3,3,0,0,0,0,0,0,0,0,0,0,0,0,0,0,0,0,0,0,0,0,0,0,0,0,0
Benjamin TONIUTTI,France,Setter,Men,Japan,2022-06-25,Pool,3,3,0,0,0,0,0,0,1,0,1,0,0,7,7,0,0,0,0,5,1,1,7,16,0,43,59
Earvin NGAPETH,France,Outside Hitter,Men,Japan,2022-06-25,Pool,3,3,0,0,0,0,0,0,0,0,0,0,0,0,0,0,0,0,0,0,0,0,0,0,0,0,0
Stephen BOYER,France,Opposite Spiker,Men,Japan,2022-06-25,Pool,3,3,3,3,0,3,6,0,1,0,1,0,1,4,5,0,0,0,0,3,0,0,3,0,0,1,1
Nicolas LE GOFF,France,Middle Blocker,Men,Japan,2022-06-25,Pool,3,3,7,4,0,2,6,3,5,6,14,0,2,5,7,0,0,0,0,2,0,0,2,0,0,1,1
Médéric HENRY,France,Middle Blocker,Men,Japan,2022-06-25,Pool,3,3,1,0,0,0,0,1,0,1,2,0,0,0,0,0,0,0,0,0,0,0,0,0,0,0,0
Trevor CLEVENOT,France,Outside Hitter,Men,Japan,2022-06-25,Pool,3,3,10,9,2,9,20,0,2,1,3,1,0,10,11,7,1,9,17,4,2,0,6,0,1,5,6
Yacine LOUATI,France,Outside Hitter,Men,Japan,2022-06-25,Pool,3,3,8,6,3,9,18,1,4,2,7,1,4,14,19,7,0,12,19,4,0,3,7,0,0,5,5
Benjamin DIEZ,France,Libero,Men,Japan,2022-06-25,Pool,3,3,0,0,0,0,0,0,0,0,0,0,0,0,0,6,0,3,9,11,3,2,16,0,0,1,1
Pierre DEROUILLON,France,Outside Hitter,Men,Japan,2022-06-25,Pool,3,3,0,0,0,0,0,0,0,0,0,0,0,0,0,0,0,0,0,0,0,0,0,0,0,0,0
Quentin JOUFFROY,France,Middle Blocker,Men,Japan,2022-06-25,Pool,3,3,1,0,0,0,0,0,0,0,0,1,2,1,4,0,0,0,0,0,0,0,0,0,0,0,0
Barthélémy CHINENYEZE,France,Middle Blocker,Men,Netherlands,2022-06-23,Pool,3,3,12,10,0,2,12,1,4,1,6,1,2,4,7,0,0,1,1,2,0,0,2,0,0,1,1
Raphaël CORRE,France,Setter,Men,Netherlands,2022-06-23,Pool,3,3,0,0,0,0,0,0,0,0,0,0,0,0,0,0,0,0,0,0,0,0,0,1,0,0,1
Jean PATRY,France,Opposite Spiker,Men,Netherlands,2022-06-23,Pool,3,3,0,0,0,0,0,0,0,0,0,0,1,1,2,0,0,0,0,0,0,0,0,0,0,0,0
Jérémie MOUIEL,France,Libero,Men,Netherlands,2022-06-23,Pool,3,3,0,0,0,0,0,0,0,0,0,0,0,0,0,0,0,0,0,0,0,0,0,0,0,0,0
Benjamin TONIUTTI,France,Setter,Men,Netherlands,2022-06-23,Pool,3,3,1,0,0,0,0,1,2,5,8,0,1,13,14,0,0,0,0,3,1,0,4,14,0,38,52
Earvin NGAPETH,France,Outside Hitter,Men,Netherlands,2022-06-23,Pool,3,3,8,7,1,5,13,0,1,1,2,1,1,9,11,5,0,4,9,4,0,0,4,0,0,4,4
Stephen BOYER,France,Opposite Spiker,Men,Netherlands,2022-06-23,Pool,3,3,15,11,1,5,17,4,2,4,10,0,3,11,14,0,0,0,0,3,1,0,4,0,0,0,0
Nicolas LE GOFF,France,Middle Blocker,Men,Netherlands,2022-06-23,Pool,3,3,10,4,0,1,5,6,4,1,11,0,2,7,9,0,0,0,0,1,1,1,3,0,0,0,0
Médéric HENRY,France,Middle Blocker,Men,Netherlands,2022-06-23,Pool,3,3,0,0,0,0,0,0,0,0,0,0,0,0,0,0,0,0,0,0,0,0,0,0,0,0,0
Trevor CLEVENOT,France,Outside Hitter,Men,Netherlands,2022-06-23,Pool,3,3,11,9,0,5,14,0,0,3,3,2,3,11,16,1,0,6,7,4,1,0,5,0,0,1,1
Yacine LOUATI,France,Outside Hitter,Men,Netherlands,2022-06-23,Pool,3,3,0,0,0,0,0,0,0,0,0,0,0,1,1,0,0,0,0,0,0,0,0,0,0,0,0
Benjamin DIEZ,France,Libero,Men,Netherlands,2022-06-23,Pool,3,3,0,0,0,0,0,0,0,0,0,0,0,0,0,7,5,11,23,6,1,0,7,0,0,0,0
Pierre DEROUILLON,France,Outside Hitter,Men,Netherlands,2022-06-23,Pool,3,3,0,0,0,0,0,0,0,0,0,0,0,0,0,0,0,0,0,0,0,0,0,0,0,0,0
Quentin JOUFFROY,France,Middle Blocker,Men,Netherlands,2022-06-23,Pool,3,3,0,0,0,0,0,0,0,0,0,0,0,0,0,0,0,0,0,0,0,0,0,0,0,0,0
Barthélémy CHINENYEZE,France,Middle Blocker,Men,Poland,2022-06-12,Pool,1,4,6,4,1,1,6,1,3,5,9,1,3,6,10,0,0,1,1,2,0,2,4,0,0,0,0
Raphaël CORRE,France,Setter,Men,Poland,2022-06-12,Pool,1,4,0,0,0,0,0,0,0,0,0,0,1,1,2,0,0,0,0,0,0,0,0,0,0,0,0
Jean PATRY,France,Opposite Spiker,Men,Poland,2022-06-12,Pool,1,4,18,16,5,16,37,2,2,1,5,0,2,10,12,0,0,0,0,1,3,0,4,0,0,3,3
Jérémie MOUIEL,France,Libero,Men,Poland,2022-06-12,Pool,1,4,0,0,0,0,0,0,0,0,0,0,0,0,0,0,0,0,0,0,0,0,0,0,0,0,0
Kevin TILLIE,France,Outside Hitter,Men,Poland,2022-06-12,Pool,1,4,0,0,0,0,0,0,0,0,0,0,0,0,0,0,0,0,0,0,0,0,0,0,0,0,0
Earvin NGAPETH,France,Outside Hitter,Men,Poland,2022-06-12,Pool,1,4,8,8,6,8,22,0,6,1,7,0,4,9,13,4,0,10,14,7,0,3,10,0,1,4,5
Antoine BRIZARD,France,Setter,Men,Poland,2022-06-12,Pool,1,4,11,3,0,1,4,2,1,5,8,6,3,9,18,0,0,1,1,7,2,3,12,42,2,43,87
Stephen BOYER,France,Opposite Spiker,Men,Poland,2022-06-12,Pool,1,4,0,0,0,0,0,0,0,0,0,0,0,0,0,0,0,0,0,0,0,0,0,0,0,0,0
Médéric HENRY,France,Middle Blocker,Men,Poland,2022-06-12,Pool,1,4,1,1,0,0,1,0,1,0,1,0,0,1,1,0,0,0,0,0,0,0,0,0,0,0,0
Yacine LOUATI,France,Outside Hitter,Men,Poland,2022-06-12,Pool,1,4,10,10,3,7,20,0,3,5,8,0,4,10,14,9,5,24,38,4,7,2,13,0,0,5,5
Benjamin DIEZ,France,Libero,Men,Poland,2022-06-12,Pool,1,4,0,0,0,0,0,0,0,0,0,0,0,0,0,5,2,16,23,9,5,1,15,0,0,2,2
Pierre DEROUILLON,France,Outside Hitter,Men,Poland,2022-06-12,Pool,1,4,4,4,0,1,5,0,0,0,0,0,1,1,2,0,0,3,3,1,0,0,1,0,0,1,1
Mousse GUEYE,France,Middle Blocker,Men,Poland,2022-06-12,Pool,1,4,0,0,0,0,0,0,0,0,0,0,0,0,0,0,0,0,0,0,0,0,0,0,0,0,0
Quentin JOUFFROY,France,Middle Blocker,Men,Poland,2022-06-12,Pool,1,4,7,4,1,3,8,1,3,4,8,2,3,14,19,0,0,1,1,0,1,1,2,0,0,0,0
Barthélémy CHINENYEZE,France,Middle Blocker,Men,Canada,2022-06-10,Pool,3,3,14,9,2,1,12,5,1,5,11,0,4,3,7,0,0,0,0,1,0,1,2,0,0,0,0
Raphaël CORRE,France,Setter,Men,Canada,2022-06-10,Pool,3,3,1,0,0,1,1,1,0,1,2,0,2,11,13,0,0,0,0,4,1,1,6,31,0,33,64
Jean PATRY,France,Opposite Spiker,Men,Canada,2022-06-10,Pool,3,3,8,7,2,12,21,0,2,0,2,1,3,13,17,0,0,0,0,2,0,6,8,0,0,0,0
Jérémie MOUIEL,France,Libero,Men,Canada,2022-06-10,Pool,3,3,0,0,0,0,0,0,0,0,0,0,0,0,0,2,0,9,11,8,4,1,13,0,0,5,5
Kevin TILLIE,France,Outside Hitter,Men,Canada,2022-06-10,Pool,3,3,0,0,0,0,0,0,0,0,0,0,0,0,0,0,0,0,0,0,0,0,0,0,0,0,0
Earvin NGAPETH,France,Outside Hitter,Men,Canada,2022-06-10,Pool,3,3,2,0,0,1,1,0,0,0,0,2,1,1,4,0,0,0,0,1,0,0,1,0,0,0,0
Antoine BRIZARD,France,Setter,Men,Canada,2022-06-10,Pool,3,3,0,0,0,0,0,0,0,0,0,0,0,0,0,0,0,0,0,0,0,0,0,0,0,0,0
Stephen BOYER,France,Opposite Spiker,Men,Canada,2022-06-10,Pool,3,3,0,0,0,0,0,0,0,0,0,0,0,0,0,0,0,0,0,0,0,0,0,0,0,0,0
Médéric HENRY,France,Middle Blocker,Men,Canada,2022-06-10,Pool,3,3,5,5,0,5,10,0,4,8,12,0,0,7,7,0,0,0,0,2,1,0,3,0,0,1,1
Yacine LOUATI,France,Outside Hitter,Men,Canada,2022-06-10,Pool,3,3,12,9,3,4,16,2,1,3,6,1,1,6,8,6,2,14,22,6,3,1,10,0,0,2,2
Benjamin DIEZ,France,Libero,Men,Canada,2022-06-10,Pool,3,3,0,0,0,0,0,0,0,0,0,0,0,0,0,0,0,0,0,0,0,0,0,0,0,0,0
Pierre DEROUILLON,France,Outside Hitter,Men,Canada,2022-06-10,Pool,3,3,8,6,3,9,18,0,0,0,0,2,5,7,14,2,3,10,15,1,0,1,2,0,1,0,1
Mousse GUEYE,France,Middle Blocker,Men,Canada,2022-06-10,Pool,3,3,0,0,0,0,0,0,0,0,0,0,0,0,0,0,0,0,0,0,0,0,0,0,0,0,0
Quentin JOUFFROY,France,Middle Blocker,Men,Canada,2022-06-10,Pool,3,3,0,0,0,0,0,0,0,0,0,0,0,3,3,0,0,0,0,0,1,0,1,0,0,0,0
Barthélémy CHINENYEZE,France,Middle Blocker,Men,Serbia,2022-06-09,Pool,3,4,9,9,1,2,12,0,9,8,17,0,1,9,10,0,0,0,0,1,2,0,3,0,0,1,1
Raphaël CORRE,France,Setter,Men,Serbia,2022-06-09,Pool,3,4,1,0,0,0,0,0,0,0,0,1,1,2,4,0,0,0,0,0,0,0,0,0,0,0,0
Jean PATRY,France,Opposite Spiker,Men,Serbia,2022-06-09,Pool,3,4,0,0,0,0,0,0,0,0,0,0,0,0,0,0,0,0,0,0,0,0,0,0,0,0,0
Jérémie MOUIEL,France,Libero,Men,Serbia,2022-06-09,Pool,3,4,0,0,0,0,0,0,0,0,0,0,0,0,0,0,0,0,0,0,0,0,0,0,0,0,0
Kevin TILLIE,France,Outside Hitter,Men,Serbia,2022-06-09,Pool,3,4,0,0,0,0,0,0,0,0,0,0,0,0,0,0,0,0,0,0,0,0,0,0,0,0,0
Earvin NGAPETH,France,Outside Hitter,Men,Serbia,2022-06-09,Pool,3,4,16,11,4,13,28,2,6,1,9,3,6,8,17,9,0,14,23,5,3,1,9,1,0,7,8
Antoine BRIZARD,France,Setter,Men,Serbia,2022-06-09,Pool,3,4,6,3,0,1,4,2,1,5,8,1,4,12,17,0,0,0,0,2,1,2,5,53,0,38,91
Stephen BOYER,France,Opposite Spiker,Men,Serbia,2022-06-09,Pool,3,4,24,19,4,22,45,3,3,2,8,2,2,14,18,0,0,0,0,6,5,0,11,0,0,1,1
Médéric HENRY,France,Middle Blocker,Men,Serbia,2022-06-09,Pool,3,4,0,0,0,0,0,0,0,0,0,0,0,0,0,0,0,0,0,0,0,0,0,0,0,0,0
Yacine LOUATI,France,Outside Hitter,Men,Serbia,2022-06-09,Pool,3,4,10,8,1,6,15,0,5,2,7,2,2,11,15,8,3,24,35,3,2,2,7,2,0,3,5
Benjamin DIEZ,France,Libero,Men,Serbia,2022-06-09,Pool,3,4,0,0,0,0,0,0,0,0,0,0,0,0,0,6,0,12,18,16,4,3,23,1,0,0,1
Pierre DEROUILLON,France,Outside Hitter,Men,Serbia,2022-06-09,Pool,3,4,0,0,0,0,0,0,0,0,0,0,0,0,0,0,0,0,0,0,0,0,0,0,0,0,0
Mousse GUEYE,France,Middle Blocker,Men,Serbia,2022-06-09,Pool,3,4,0,0,0,0,0,0,0,0,0,0,0,0,0,0,0,0,0,0,0,0,0,0,0,0,0
Quentin JOUFFROY,France,Middle Blocker,Men,Serbia,2022-06-09,Pool,3,4,5,1,2,3,6,3,6,10,19,1,3,10,14,0,0,1,1,3,0,3,6,0,1,0,1
Barthélémy CHINENYEZE,France,Middle Blocker,Men,Italy,2022-06-08,Pool,3,3,11,7,0,6,13,3,3,7,13,1,3,5,9,0,1,2,3,1,1,0,2,0,0,0,0
Raphaël CORRE,France,Setter,Men,Italy,2022-06-08,Pool,3,3,0,0,0,0,0,0,0,0,0,0,0,1,1,0,0,0,0,0,1,0,1,0,0,0,0
Jean PATRY,France,Opposite Spiker,Men,Italy,2022-06-08,Pool,3,3,9,7,4,10,21,2,1,6,9,0,0,12,12,0,0,0,0,2,1,2,5,0,1,0,1
Jérémie MOUIEL,France,Libero,Men,Italy,2022-06-08,Pool,3,3,0,0,0,0,0,0,0,0,0,0,0,0,0,0,0,0,0,0,0,0,0,0,0,0,0
Kevin TILLIE,France,Outside Hitter,Men,Italy,2022-06-08,Pool,3,3,2,2,2,3,7,0,2,0,2,0,2,1,3,0,0,4,4,2,2,0,4,0,0,0,0
Earvin NGAPETH,France,Outside Hitter,Men,Italy,2022-06-08,Pool,3,3,13,11,3,4,18,1,3,0,4,1,2,15,18,6,0,10,16,5,2,4,11,0,0,7,7
Antoine BRIZARD,France,Setter,Men,Italy,2022-06-08,Pool,3,3,3,3,0,2,5,0,2,1,3,0,3,12,15,0,0,0,0,4,2,3,9,48,0,25,73
Stephen BOYER,France,Opposite Spiker,Men,Italy,2022-06-08,Pool,3,3,0,0,0,0,0,0,0,0,0,0,0,0,0,0,0,0,0,0,0,0,0,0,0,0,0
Médéric HENRY,France,Middle Blocker,Men,Italy,2022-06-08,Pool,3,3,0,0,0,0,0,0,0,0,0,0,0,0,0,0,0,0,0,0,0,0,0,0,0,0,0
Yacine LOUATI,France,Outside Hitter,Men,Italy,2022-06-08,Pool,3,3,2,2,5,5,12,0,0,1,1,0,2,3,5,6,1,9,16,4,0,0,4,0,0,1,1
Benjamin DIEZ,France,Libero,Men,Italy,2022-06-08,Pool,3,3,0,0,0,0,0,0,0,0,0,0,0,0,0,2,0,8,10,13,1,4,18,0,0,0,0
Pierre DEROUILLON,France,Outside Hitter,Men,Italy,2022-06-08,Pool,3,3,0,0,0,0,0,0,0,0,0,0,0,0,0,0,0,0,0,0,0,0,0,0,0,0,0
Mousse GUEYE,France,Middle Blocker,Men,Italy,2022-06-08,Pool,3,3,0,0,0,0,0,0,0,0,0,0,0,0,0,0,0,0,0,0,0,0,0,0,0,0,0
Quentin JOUFFROY,France,Middle Blocker,Men,Italy,2022-06-08,Pool,3,3,7,5,0,4,9,0,4,7,11,2,2,7,11,0,0,0,0,3,0,2,5,0,0,1,1
Christian FROMM,Germany,Outside Hitter,Men,Japan,2022-07-09,Pool,1,4,10,9,4,11,24,1,1,2,4,0,5,8,13,7,1,11,19,1,1,3,5,0,0,5,5
Leonard GRAVEN,Germany,Libero,Men,Japan,2022-07-09,Pool,1,4,0,0,0,0,0,0,0,0,0,0,0,0,0,0,0,0,0,4,2,0,6,0,0,2,2
Moritz REICHERT,Germany,Outside Hitter,Men,Japan,2022-07-09,Pool,1,4,0,0,0,0,0,0,0,0,0,0,0,0,0,1,0,1,2,0,0,0,0,0,0,0,0
Julian ZENGER,Germany,Libero,Men,Japan,2022-07-09,Pool,1,4,0,0,0,0,0,0,0,0,0,0,0,0,0,4,1,11,16,2,1,1,4,0,0,5,5
Jan ZIMMERMANN,Germany,Setter,Men,Japan,2022-07-09,Pool,1,4,1,0,0,2,2,1,3,1,5,0,1,12,13,0,0,0,0,3,2,5,10,20,0,44,64
Florian KRAGE,Germany,Middle Blocker,Men,Japan,2022-07-09,Pool,1,4,5,3,1,3,7,2,3,1,6,0,3,13,16,1,0,0,1,1,0,1,2,0,0,0,0
Tobias KRICK,Germany,Middle Blocker,Men,Japan,2022-07-09,Pool,1,4,9,8,2,4,14,1,5,3,9,0,4,7,11,0,0,3,3,2,0,2,4,0,0,0,0
Tobias BRAND,Germany,Outside Hitter,Men,Japan,2022-07-09,Pool,1,4,12,12,2,13,27,0,2,0,2,0,4,8,12,5,2,18,25,3,2,1,6,0,0,3,3
Leon DERVISAJ,Germany,Setter,Men,Japan,2022-07-09,Pool,1,4,1,1,0,0,1,0,1,0,1,0,1,1,2,0,0,0,0,1,4,0,5,5,0,16,21
Iven FERCH,Germany,Middle Blocker,Men,Japan,2022-07-09,Pool,1,4,0,0,0,0,0,0,0,0,0,0,0,0,0,0,0,0,0,0,0,0,0,0,0,0,0
Tim PETER,Germany,Outside Hitter,Men,Japan,2022-07-09,Pool,1,4,7,5,2,1,8,0,0,0,0,2,1,6,9,0,0,10,10,0,1,3,4,0,0,0,0
Max SCHULZ,Germany,Outside Hitter,Men,Japan,2022-07-09,Pool,1,4,12,9,7,3,19,3,4,5,12,0,5,7,12,0,0,1,1,6,3,1,10,0,0,1,1
Christian FROMM,Germany,Outside Hitter,Men,Australia,2022-07-07,Pool,3,4,13,13,6,6,25,0,1,2,3,0,1,14,15,0,0,1,1,4,0,2,6,0,0,0,0
Leonard GRAVEN,Germany,Libero,Men,Australia,2022-07-07,Pool,3,4,0,0,0,0,0,0,0,0,0,0,0,0,0,0,0,0,0,0,0,0,0,0,0,0,0
Moritz REICHERT,Germany,Outside Hitter,Men,Australia,2022-07-07,Pool,3,4,22,21,1,10,32,0,5,1,6,1,4,14,19,9,2,8,19,5,4,2,11,0,0,5,5
Julian ZENGER,Germany,Libero,Men,Australia,2022-07-07,Pool,3,4,0,0,0,0,0,0,0,0,0,0,0,0,0,10,0,10,20,10,1,1,12,2,0,6,8
Jan ZIMMERMANN,Germany,Setter,Men,Australia,2022-07-07,Pool,3,4,2,1,0,1,2,0,2,2,4,1,2,10,13,0,0,0,0,4,0,2,6,33,0,50,83
Florian KRAGE,Germany,Middle Blocker,Men,Australia,2022-07-07,Pool,3,4,5,3,2,3,8,1,4,2,7,1,2,13,16,0,0,0,0,0,2,1,3,0,0,0,0
Tobias KRICK,Germany,Middle Blocker,Men,Australia,2022-07-07,Pool,3,4,17,9,3,3,15,6,7,5,18,2,4,7,13,0,0,0,0,0,0,0,0,0,0,0,0
Tobias BRAND,Germany,Outside Hitter,Men,Australia,2022-07-07,Pool,3,4,6,5,4,9,18,1,2,1,4,0,4,12,16,6,2,18,26,7,2,1,10,0,0,0,0
Leon DERVISAJ,Germany,Setter,Men,Australia,2022-07-07,Pool,3,4,0,0,0,0,0,0,0,0,0,0,0,0,0,0,0,0,0,0,0,0,0,0,0,0,0
Iven FERCH,Germany,Middle Blocker,Men,Australia,2022-07-07,Pool,3,4,0,0,0,0,0,0,0,0,0,0,0,0,0,0,0,0,0,0,0,0,0,0,0,0,0
Tim PETER,Germany,Outside Hitter,Men,Australia,2022-07-07,Pool,3,4,0,0,0,0,0,0,0,0,0,0,1,2,3,0,0,0,0,0,0,0,0,0,0,0,0
Max SCHULZ,Germany,Outside Hitter,Men,Australia,2022-07-07,Pool,3,4,0,0,0,0,0,0,0,0,0,0,0,0,0,0,0,0,0,0,0,0,0,0,0,0,0
Christian FROMM,Germany,Outside Hitter,Men,Brazil,2022-07-06,Pool,1,4,12,10,3,12,25,1,3,0,4,1,2,9,12,6,1,24,31,2,4,1,7,0,0,3,3
Leonard GRAVEN,Germany,Libero,Men,Brazil,2022-07-06,Pool,1,4,0,0,0,0,0,0,0,0,0,0,0,0,0,0,0,0,0,0,0,0,0,0,0,0,0
Moritz REICHERT,Germany,Outside Hitter,Men,Brazil,2022-07-06,Pool,1,4,0,0,0,0,0,0,0,0,0,0,0,0,0,0,0,4,4,1,0,1,2,0,1,0,1
Julian ZENGER,Germany,Libero,Men,Brazil,2022-07-06,Pool,1,4,0,0,0,0,0,0,0,0,0,0,0,0,0,8,3,10,21,10,4,5,19,0,0,12,12
Jan ZIMMERMANN,Germany,Setter,Men,Brazil,2022-07-06,Pool,1,4,0,0,0,0,0,0,1,1,2,0,1,16,17,0,0,0,0,2,2,3,7,28,0,58,86
Florian KRAGE,Germany,Middle Blocker,Men,Brazil,2022-07-06,Pool,1,4,9,8,2,3,13,0,9,4,13,1,2,11,14,0,0,0,0,1,0,0,1,0,0,4,4
Tobias KRICK,Germany,Middle Blocker,Men,Brazil,2022-07-06,Pool,1,4,6,5,1,2,8,1,9,2,12,0,4,3,7,0,0,2,2,1,1,0,2,0,0,0,0
Tobias BRAND,Germany,Outside Hitter,Men,Brazil,2022-07-06,Pool,1,4,17,14,2,11,27,3,4,2,9,0,2,11,13,7,2,17,26,4,0,3,7,0,0,4,4
Lukas MAASE,Germany,Middle Blocker,Men,Brazil,2022-07-06,Pool,1,4,15,13,5,14,32,1,3,1,5,1,3,12,16,0,0,1,1,5,2,5,12,0,2,2,4
Leon DERVISAJ,Germany,Setter,Men,Brazil,2022-07-06,Pool,1,4,0,0,0,0,0,0,0,0,0,0,0,0,0,0,0,0,0,0,0,0,0,0,0,4,4
Iven FERCH,Germany,Middle Blocker,Men,Brazil,2022-07-06,Pool,1,4,0,0,0,0,0,0,0,0,0,0,0,0,0,0,0,0,0,0,0,0,0,0,0,0,0
Tim PETER,Germany,Outside Hitter,Men,Brazil,2022-07-06,Pool,1,4,0,0,0,0,0,0,0,0,0,0,0,3,3,0,0,0,0,0,0,0,0,0,0,0,0
Max SCHULZ,Germany,Outside Hitter,Men,Brazil,2022-07-06,Pool,1,4,1,1,0,2,3,0,0,0,0,0,1,1,2,0,0,0,0,0,0,0,0,0,0,0,0
Christian FROMM,Germany,Outside Hitter,Men,United States,2022-07-05,Pool,1,4,9,7,3,14,24,2,2,2,6,0,3,7,10,7,5,11,23,3,0,0,3,0,0,3,3
Leonard GRAVEN,Germany,Libero,Men,United States,2022-07-05,Pool,1,4,0,0,0,0,0,0,0,0,0,0,0,0,0,0,0,0,0,0,0,0,0,0,0,0,0
Moritz REICHERT,Germany,Outside Hitter,Men,United States,2022-07-05,Pool,1,4,0,0,0,1,1,0,0,0,0,0,0,1,1,3,0,1,4,0,0,0,0,0,0,3,3
Julian ZENGER,Germany,Libero,Men,United States,2022-07-05,Pool,1,4,0,0,0,0,0,0,0,0,0,0,0,0,0,11,0,11,22,3,6,15,24,3,0,11,14
Jan ZIMMERMANN,Germany,Setter,Men,United States,2022-07-05,Pool,1,4,2,2,0,1,3,0,3,2,5,0,2,12,14,0,0,0,0,8,2,3,13,30,0,62,92
Florian KRAGE,Germany,Middle Blocker,Men,United States,2022-07-05,Pool,1,4,7,7,1,5,13,0,2,3,5,0,3,11,14,0,0,1,1,1,2,0,3,0,0,2,2
Linus WEBER,Germany,Opposite Spiker,Men,United States,2022-07-05,Pool,1,4,0,0,0,0,0,0,0,0,0,0,0,0,0,0,0,0,0,0,0,0,0,0,0,0,0
Tobias KRICK,Germany,Middle Blocker,Men,United States,2022-07-05,Pool,1,4,8,6,1,12,19,1,4,4,9,1,5,5,11,1,0,1,2,0,0,3,3,0,0,2,2
Tobias BRAND,Germany,Outside Hitter,Men,United States,2022-07-05,Pool,1,4,11,11,1,8,20,0,3,3,6,0,2,15,17,11,2,12,25,9,2,3,14,1,0,3,4
Lukas MAASE,Germany,Middle Blocker,Men,United States,2022-07-05,Pool,1,4,15,14,4,22,40,0,3,1,4,1,2,12,15,0,0,1,1,2,3,3,8,0,1,2,3
Leon DERVISAJ,Germany,Setter,Men,United States,2022-07-05,Pool,1,4,0,0,0,0,0,0,0,0,0,0,0,0,0,0,0,0,0,0,0,0,0,1,0,1,2
Iven FERCH,Germany,Middle Blocker,Men,United States,2022-07-05,Pool,1,4,0,0,0,0,0,0,0,0,0,0,0,0,0,0,0,0,0,0,0,0,0,0,0,0,0
Tim PETER,Germany,Outside Hitter,Men,United States,2022-07-05,Pool,1,4,0,0,0,0,0,0,0,0,0,0,0,2,2,0,0,0,0,0,0,0,0,0,0,0,0
Max SCHULZ,Germany,Outside Hitter,Men,United States,2022-07-05,Pool,1,4,0,0,1,1,2,0,0,0,0,0,0,0,0,0,0,0,0,0,0,0,0,0,0,0,0
Christian FROMM,Germany,Outside Hitter,Men,France,2022-06-26,Pool,1,4,6,5,3,10,18,1,1,2,4,0,4,5,9,1,2,14,17,2,0,0,2,0,0,1,1
Johannes TILLE,Germany,Setter,Men,France,2022-06-26,Pool,1,4,4,1,0,0,1,1,4,0,5,2,3,13,18,0,0,1,1,8,0,1,9,15,1,44,60
Leonard GRAVEN,Germany,Libero,Men,France,2022-06-26,Pool,1,4,0,0,0,0,0,0,0,0,0,0,0,0,0,1,1,5,7,0,0,0,0,0,0,2,2
Moritz REICHERT,Germany,Outside Hitter,Men,France,2022-06-26,Pool,1,4,0,0,0,0,0,0,0,0,0,0,0,0,0,0,0,0,0,0,0,0,0,0,0,0,0
Julian ZENGER,Germany,Libero,Men,France,2022-06-26,Pool,1,4,0,0,0,0,0,0,0,0,0,0,0,0,0,5,2,6,13,2,3,0,5,0,0,6,6
Jan ZIMMERMANN,Germany,Setter,Men,France,2022-06-26,Pool,1,4,0,0,0,0,0,0,0,0,0,0,0,0,0,0,0,0,0,0,0,0,0,0,0,0,0
Florian KRAGE,Germany,Middle Blocker,Men,France,2022-06-26,Pool,1,4,4,3,1,0,4,1,9,3,13,0,5,4,9,1,1,1,3,1,0,2,3,0,0,1,1
Linus WEBER,Germany,Opposite Spiker,Men,France,2022-06-26,Pool,1,4,16,14,6,8,28,1,4,4,9,1,7,5,13,0,0,0,0,3,3,0,6,0,0,2,2
Tobias KRICK,Germany,Middle Blocker,Men,France,2022-06-26,Pool,1,4,0,0,0,0,0,0,0,0,0,0,0,0,0,0,0,0,0,0,0,0,0,0,0,0,0
Tobias BRAND,Germany,Outside Hitter,Men,France,2022-06-26,Pool,1,4,5,4,1,10,15,0,1,1,2,1,2,13,16,8,2,11,21,3,1,0,4,0,0,6,6
Lukas MAASE,Germany,Middle Blocker,Men,France,2022-06-26,Pool,1,4,8,5,1,5,11,3,4,3,10,0,3,13,16,0,0,2,2,3,0,0,3,0,0,1,1
Iven FERCH,Germany,Middle Blocker,Men,France,2022-06-26,Pool,1,4,0,0,0,0,0,0,0,0,0,0,1,0,1,0,0,0,0,0,0,0,0,0,0,0,0
Tim PETER,Germany,Outside Hitter,Men,France,2022-06-26,Pool,1,4,0,0,0,0,0,0,0,0,0,0,0,0,0,0,0,0,0,0,0,0,0,0,0,0,0
Christian FROMM,Germany,Outside Hitter,Men,Netherlands,2022-06-24,Pool,1,4,9,8,5,18,31,1,3,3,7,0,5,9,14,3,1,13,17,9,3,1,13,1,0,3,4
Johannes TILLE,Germany,Setter,Men,Netherlands,2022-06-24,Pool,1,4,0,0,0,0,0,0,0,0,0,0,1,3,4,0,0,0,0,0,0,0,0,2,0,9,11
Leonard GRAVEN,Germany,Libero,Men,Netherlands,2022-06-24,Pool,1,4,0,0,0,0,0,0,0,0,0,0,0,0,0,0,0,1,1,0,0,0,0,0,0,0,0
Moritz REICHERT,Germany,Outside Hitter,Men,Netherlands,2022-06-24,Pool,1,4,0,0,0,0,0,0,0,0,0,0,0,0,0,0,0,0,0,0,0,0,0,0,0,0,0
Julian ZENGER,Germany,Libero,Men,Netherlands,2022-06-24,Pool,1,4,0,0,0,0,0,0,0,0,0,0,0,0,0,6,4,16,26,25,1,1,27,1,0,12,13
Jan ZIMMERMANN,Germany,Setter,Men,Netherlands,2022-06-24,Pool,1,4,0,0,0,2,2,0,4,4,8,0,0,21,21,0,0,0,0,8,2,3,13,11,1,90,102
Florian KRAGE,Germany,Middle Blocker,Men,Netherlands,2022-06-24,Pool,1,4,0,0,0,0,0,0,0,0,0,0,0,1,1,0,0,0,0,0,0,0,0,0,0,0,0
Erik RÖHRS,Germany,Outside Hitter,Men,Netherlands,2022-06-24,Pool,1,4,0,0,0,0,0,0,0,0,0,0,0,0,0,0,0,0,0,0,0,0,0,0,0,0,0
Linus WEBER,Germany,Opposite Spiker,Men,Netherlands,2022-06-24,Pool,1,4,25,22,8,20,50,2,3,5,10,1,8,5,14,0,0,0,0,7,3,1,11,0,0,0,0
Tobias KRICK,Germany,Middle Blocker,Men,Netherlands,2022-06-24,Pool,1,4,12,11,2,2,15,1,3,5,9,0,2,7,9,0,0,0,0,1,0,0,1,0,0,0,0
Tobias BRAND,Germany,Outside Hitter,Men,Netherlands,2022-06-24,Pool,1,4,7,7,1,13,21,0,4,5,9,0,1,13,14,8,1,25,34,10,3,0,13,0,0,2,2
Lukas MAASE,Germany,Middle Blocker,Men,Netherlands,2022-06-24,Pool,1,4,10,5,0,6,11,5,7,10,22,0,2,13,15,1,0,2,3,4,2,1,7,0,0,1,1
Iven FERCH,Germany,Middle Blocker,Men,Netherlands,2022-06-24,Pool,1,4,1,1,0,0,1,0,0,1,1,0,0,0,0,0,0,0,0,0,0,0,0,0,0,0,0
Tim PETER,Germany,Outside Hitter,Men,Netherlands,2022-06-24,Pool,1,4,1,1,2,0,3,0,0,1,1,0,1,1,2,0,0,0,0,0,1,0,1,0,0,0,0
Christian FROMM,Germany,Outside Hitter,Men,China,2022-06-23,Pool,0,0,0,0,0,0,0,0,0,0,0,0,0,0,0,0,0,0,0,0,0,0,0,0,0,0,0
Johannes TILLE,Germany,Setter,Men,China,2022-06-23,Pool,0,0,0,0,0,0,0,0,0,0,0,0,0,0,0,0,0,0,0,0,0,0,0,0,0,0,0
Leonard GRAVEN,Germany,Libero,Men,China,2022-06-23,Pool,0,0,0,0,0,0,0,0,0,0,0,0,0,0,0,0,0,0,0,0,0,0,0,0,0,0,0
Moritz REICHERT,Germany,Outside Hitter,Men,China,2022-06-23,Pool,0,0,0,0,0,0,0,0,0,0,0,0,0,0,0,0,0,0,0,0,0,0,0,0,0,0,0
Julian ZENGER,Germany,Libero,Men,China,2022-06-23,Pool,0,0,0,0,0,0,0,0,0,0,0,0,0,0,0,0,0,0,0,0,0,0,0,0,0,0,0
Jan ZIMMERMANN,Germany,Setter,Men,China,2022-06-23,Pool,0,0,0,0,0,0,0,0,0,0,0,0,0,0,0,0,0,0,0,0,0,0,0,0,0,0,0
Florian KRAGE,Germany,Middle Blocker,Men,China,2022-06-23,Pool,0,0,0,0,0,0,0,0,0,0,0,0,0,0,0,0,0,0,0,0,0,0,0,0,0,0,0
Erik RÖHRS,Germany,Outside Hitter,Men,China,2022-06-23,Pool,0,0,0,0,0,0,0,0,0,0,0,0,0,0,0,0,0,0,0,0,0,0,0,0,0,0,0
Linus WEBER,Germany,Opposite Spiker,Men,China,2022-06-23,Pool,0,0,0,0,0,0,0,0,0,0,0,0,0,0,0,0,0,0,0,0,0,0,0,0,0,0,0
Tobias KRICK,Germany,Middle Blocker,Men,China,2022-06-23,Pool,0,0,0,0,0,0,0,0,0,0,0,0,0,0,0,0,0,0,0,0,0,0,0,0,0,0,0
Tobias BRAND,Germany,Outside Hitter,Men,China,2022-06-23,Pool,0,0,0,0,0,0,0,0,0,0,0,0,0,0,0,0,0,0,0,0,0,0,0,0,0,0,0
Lukas MAASE,Germany,Middle Blocker,Men,China,2022-06-23,Pool,0,0,0,0,0,0,0,0,0,0,0,0,0,0,0,0,0,0,0,0,0,0,0,0,0,0,0
Iven FERCH,Germany,Middle Blocker,Men,China,2022-06-23,Pool,0,0,0,0,0,0,0,0,0,0,0,0,0,0,0,0,0,0,0,0,0,0,0,0,0,0,0
Tim PETER,Germany,Outside Hitter,Men,China,2022-06-23,Pool,0,0,0,0,0,0,0,0,0,0,0,0,0,0,0,0,0,0,0,0,0,0,0,0,0,0,0
Christian FROMM,Germany,Outside Hitter,Men,Italy,2022-06-22,Pool,0,3,4,4,1,2,7,0,0,1,1,0,4,2,6,1,3,10,14,0,0,1,1,0,0,2,2
Johannes TILLE,Germany,Setter,Men,Italy,2022-06-22,Pool,0,3,0,0,1,0,1,0,0,0,0,0,2,3,5,0,0,0,0,1,1,1,3,6,0,13,19
Leonard GRAVEN,Germany,Libero,Men,Italy,2022-06-22,Pool,0,3,0,0,0,0,0,0,0,0,0,0,0,0,0,0,0,0,0,0,0,0,0,0,0,0,0
Moritz REICHERT,Germany,Outside Hitter,Men,Italy,2022-06-22,Pool,0,3,3,3,3,7,13,0,1,1,2,0,2,7,9,2,1,13,16,6,2,0,8,0,0,3,3
Julian ZENGER,Germany,Libero,Men,Italy,2022-06-22,Pool,0,3,0,0,0,0,0,0,0,0,0,0,0,0,0,7,0,5,12,7,2,1,10,0,0,2,2
Jan ZIMMERMANN,Germany,Setter,Men,Italy,2022-06-22,Pool,0,3,1,0,0,0,0,0,4,0,4,1,1,4,6,0,0,0,0,1,0,0,1,9,0,38,47
Florian KRAGE,Germany,Middle Blocker,Men,Italy,2022-06-22,Pool,0,3,2,1,2,0,3,1,0,1,2,0,1,5,6,1,0,1,2,1,0,0,1,0,0,0,0
Erik RÖHRS,Germany,Outside Hitter,Men,Italy,2022-06-22,Pool,0,3,2,0,1,3,4,0,0,0,0,2,0,6,8,2,0,4,6,0,0,0,0,0,0,0,0
Linus WEBER,Germany,Opposite Spiker,Men,Italy,2022-06-22,Pool,0,3,14,14,7,5,26,0,2,0,2,0,4,3,7,0,0,1,1,1,1,0,2,0,0,0,0
Tobias KRICK,Germany,Middle Blocker,Men,Italy,2022-06-22,Pool,0,3,5,4,0,1,5,1,0,2,3,0,1,1,2,0,0,0,0,1,0,0,1,0,0,0,0
Tobias BRAND,Germany,Outside Hitter,Men,Italy,2022-06-22,Pool,0,3,1,1,2,2,5,0,1,1,2,0,0,1,1,0,0,6,6,2,0,0,2,0,0,0,0
Lukas MAASE,Germany,Middle Blocker,Men,Italy,2022-06-22,Pool,0,3,7,5,1,4,10,2,5,2,9,0,2,7,9,0,0,3,3,3,1,0,4,0,0,1,1
Iven FERCH,Germany,Middle Blocker,Men,Italy,2022-06-22,Pool,0,3,0,0,0,0,0,0,0,0,0,0,0,0,0,0,0,0,0,0,0,0,0,0,0,0,0
Tim PETER,Germany,Outside Hitter,Men,Italy,2022-06-22,Pool,0,3,1,1,1,0,2,0,0,0,0,0,0,1,1,0,0,1,1,0,0,0,0,0,0,1,1
Christian FROMM,Germany,Outside Hitter,Men,Serbia,2022-06-11,Pool,3,5,18,13,1,11,25,4,1,1,6,1,5,8,14,2,4,18,24,6,3,2,11,0,0,7,7
Johannes TILLE,Germany,Setter,Men,Serbia,2022-06-11,Pool,3,5,3,0,0,0,0,2,2,0,4,1,0,11,12,0,1,0,1,2,0,2,4,7,0,21,28
Moritz REICHERT,Germany,Outside Hitter,Men,Serbia,2022-06-11,Pool,3,5,18,14,4,19,37,1,2,1,4,3,3,18,24,16,0,25,41,4,0,7,11,0,0,4,4
Julian ZENGER,Germany,Libero,Men,Serbia,2022-06-11,Pool,3,5,0,0,0,0,0,0,0,0,0,0,0,0,0,7,3,17,27,12,5,3,20,0,0,4,4
Jan ZIMMERMANN,Germany,Setter,Men,Serbia,2022-06-11,Pool,3,5,0,0,0,2,2,0,2,2,4,0,0,11,11,0,1,1,2,4,5,1,10,26,2,66,94
Florian KRAGE,Germany,Middle Blocker,Men,Serbia,2022-06-11,Pool,3,5,10,6,1,2,9,4,3,4,11,0,3,8,11,0,0,1,1,5,1,1,7,0,0,0,0
Linus WEBER,Germany,Opposite Spiker,Men,Serbia,2022-06-11,Pool,3,5,19,15,8,20,43,2,2,5,9,2,5,10,17,0,0,0,0,3,2,0,5,0,0,3,3
Tobias KRICK,Germany,Middle Blocker,Men,Serbia,2022-06-11,Pool,3,5,0,0,0,0,0,0,0,0,0,0,0,0,0,0,0,0,0,0,0,0,0,0,0,0,0
Tobias BRAND,Germany,Outside Hitter,Men,Serbia,2022-06-11,Pool,3,5,0,0,0,3,3,0,0,0,0,0,0,5,5,2,1,2,5,1,2,3,6,0,0,1,1
Yannick GORALIK,Germany,Middle Blocker,Men,Serbia,2022-06-11,Pool,3,5,0,0,0,0,0,0,0,0,0,0,0,0,0,0,0,0,0,0,0,0,0,0,0,0,0
Lukas MAASE,Germany,Middle Blocker,Men,Serbia,2022-06-11,Pool,3,5,17,12,3,7,22,3,14,7,24,2,3,16,21,0,0,1,1,0,4,3,7,0,0,0,0
Iven FERCH,Germany,Middle Blocker,Men,Serbia,2022-06-11,Pool,3,5,0,0,0,0,0,0,0,0,0,0,0,0,0,0,0,0,0,0,0,0,0,0,0,0,0
Tim PETER,Germany,Outside Hitter,Men,Serbia,2022-06-11,Pool,3,5,0,0,0,0,0,0,0,0,0,0,0,0,0,0,0,0,0,0,0,0,0,0,0,0,0
Max SCHULZ,Germany,Outside Hitter,Men,Serbia,2022-06-11,Pool,3,5,0,0,0,0,0,0,0,0,0,0,0,0,0,0,0,0,0,0,0,0,0,0,0,0,0
Christian FROMM,Germany,Outside Hitter,Men,Bulgaria,2022-06-10,Pool,3,5,22,17,4,7,28,3,1,2,6,2,3,17,22,9,0,23,32,2,1,2,5,0,0,7,7
Johannes TILLE,Germany,Setter,Men,Bulgaria,2022-06-10,Pool,3,5,0,0,0,0,0,0,1,0,1,0,0,0,0,0,0,0,0,0,0,0,0,1,0,0,1
Moritz REICHERT,Germany,Outside Hitter,Men,Bulgaria,2022-06-10,Pool,3,5,14,13,4,11,28,1,3,2,6,0,4,19,23,8,1,21,30,3,3,4,10,0,0,2,2
Julian ZENGER,Germany,Libero,Men,Bulgaria,2022-06-10,Pool,3,5,0,0,0,0,0,0,0,0,0,0,0,0,0,4,1,6,11,14,6,5,25,0,0,6,6
Jan ZIMMERMANN,Germany,Setter,Men,Bulgaria,2022-06-10,Pool,3,5,1,1,1,0,2,0,2,1,3,0,2,6,8,0,0,2,2,4,0,2,6,32,1,59,92
Florian KRAGE,Germany,Middle Blocker,Men,Bulgaria,2022-06-10,Pool,3,5,0,0,0,0,0,0,0,0,0,0,0,0,0,0,0,0,0,0,0,0,0,0,0,0,0
Linus WEBER,Germany,Opposite Spiker,Men,Bulgaria,2022-06-10,Pool,3,5,15,13,7,7,27,1,5,0,6,1,3,14,18,0,0,0,0,4,2,3,9,0,0,1,1
Tobias KRICK,Germany,Middle Blocker,Men,Bulgaria,2022-06-10,Pool,3,5,17,11,1,4,16,5,4,5,14,1,1,10,12,1,0,0,1,0,0,1,1,0,0,0,0
Tobias BRAND,Germany,Outside Hitter,Men,Bulgaria,2022-06-10,Pool,3,5,0,0,0,0,0,0,0,0,0,0,0,2,2,0,0,0,0,0,0,0,0,0,0,0,0
Yannick GORALIK,Germany,Middle Blocker,Men,Bulgaria,2022-06-10,Pool,3,5,0,0,0,0,0,0,0,0,0,0,0,0,0,0,0,0,0,0,0,0,0,0,0,0,0
Lukas MAASE,Germany,Middle Blocker,Men,Bulgaria,2022-06-10,Pool,3,5,10,6,1,3,10,3,4,4,11,1,3,18,22,0,0,2,2,3,2,2,7,0,1,1,2
Iven FERCH,Germany,Middle Blocker,Men,Bulgaria,2022-06-10,Pool,3,5,0,0,0,0,0,0,0,0,0,0,0,0,0,0,0,0,0,0,0,0,0,0,0,0,0
Tim PETER,Germany,Outside Hitter,Men,Bulgaria,2022-06-10,Pool,3,5,0,0,0,0,0,0,0,0,0,0,0,0,0,0,0,0,0,0,0,0,0,0,0,0,0
Max SCHULZ,Germany,Outside Hitter,Men,Bulgaria,2022-06-10,Pool,3,5,0,0,0,0,0,0,0,0,0,0,0,0,0,0,0,0,0,0,0,0,0,0,0,0,0
Christian FROMM,Germany,Outside Hitter,Men,Argentina,2022-06-09,Pool,1,4,9,7,4,9,20,1,1,2,4,1,1,6,8,1,2,19,22,1,3,0,4,0,0,2,2
Johannes TILLE,Germany,Setter,Men,Argentina,2022-06-09,Pool,1,4,0,0,0,0,0,0,0,1,1,0,1,3,4,0,0,0,0,2,0,0,2,3,0,19,22
Moritz REICHERT,Germany,Outside Hitter,Men,Argentina,2022-06-09,Pool,1,4,18,14,5,6,25,2,3,5,10,2,1,15,18,8,2,19,29,1,2,1,4,0,1,2,3
Julian ZENGER,Germany,Libero,Men,Argentina,2022-06-09,Pool,1,4,0,0,0,0,0,0,0,0,0,0,0,0,0,3,1,20,24,10,4,2,16,0,0,3,3
Jan ZIMMERMANN,Germany,Setter,Men,Argentina,2022-06-09,Pool,1,4,1,0,0,1,1,0,0,2,2,1,0,10,11,0,0,0,0,4,2,1,7,13,0,51,64
Florian KRAGE,Germany,Middle Blocker,Men,Argentina,2022-06-09,Pool,1,4,8,5,1,1,7,1,3,4,8,2,4,9,15,0,0,0,0,2,2,3,7,0,1,0,1
Linus WEBER,Germany,Opposite Spiker,Men,Argentina,2022-06-09,Pool,1,4,20,16,8,10,34,1,1,5,7,3,6,5,14,0,0,0,0,4,1,2,7,0,0,3,3
Tobias KRICK,Germany,Middle Blocker,Men,Argentina,2022-06-09,Pool,1,4,0,0,0,0,0,0,0,0,0,0,0,0,0,0,0,0,0,0,0,0,0,0,0,0,0
Tobias BRAND,Germany,Outside Hitter,Men,Argentina,2022-06-09,Pool,1,4,0,0,1,0,1,0,0,1,1,0,0,1,1,0,0,2,2,0,0,0,0,0,0,1,1
Yannick GORALIK,Germany,Middle Blocker,Men,Argentina,2022-06-09,Pool,1,4,0,0,0,0,0,0,0,0,0,0,0,0,0,0,0,0,0,0,0,0,0,0,0,0,0
Lukas MAASE,Germany,Middle Blocker,Men,Argentina,2022-06-09,Pool,1,4,7,6,1,6,13,1,5,2,8,0,3,9,12,1,1,1,3,1,0,4,5,0,0,2,2
Iven FERCH,Germany,Middle Blocker,Men,Argentina,2022-06-09,Pool,1,4,0,0,0,0,0,0,0,0,0,0,0,0,0,0,0,0,0,0,0,0,0,0,0,0,0
Tim PETER,Germany,Outside Hitter,Men,Argentina,2022-06-09,Pool,1,4,0,0,0,0,0,0,0,0,0,0,1,0,1,0,0,0,0,0,0,0,0,0,0,0,0
Max SCHULZ,Germany,Outside Hitter,Men,Argentina,2022-06-09,Pool,1,4,0,0,0,2,2,0,0,0,0,0,1,0,1,0,0,0,0,0,0,0,0,0,0,0,0
Christian FROMM,Germany,Outside Hitter,Men,Canada,2022-06-07,Pool,3,3,18,14,1,11,26,1,4,1,6,3,0,11,14,2,3,14,19,6,1,1,8,0,0,2,2
Johannes TILLE,Germany,Setter,Men,Canada,2022-06-07,Pool,3,3,0,0,0,0,0,0,0,0,0,0,1,1,2,0,0,0,0,0,0,0,0,0,0,0,0
Moritz REICHERT,Germany,Outside Hitter,Men,Canada,2022-06-07,Pool,3,3,15,12,1,7,20,1,1,0,2,2,1,13,16,6,1,11,18,3,0,1,4,0,0,5,5
Julian ZENGER,Germany,Libero,Men,Canada,2022-06-07,Pool,3,3,0,0,0,0,0,0,0,0,0,0,0,0,0,9,0,11,20,5,1,5,11,0,0,3,3
Jan ZIMMERMANN,Germany,Setter,Men,Canada,2022-06-07,Pool,3,3,1,0,0,0,0,0,0,0,0,1,1,11,13,0,0,0,0,6,1,1,8,25,1,45,71
Florian KRAGE,Germany,Middle Blocker,Men,Canada,2022-06-07,Pool,3,3,0,0,0,0,0,0,0,0,0,0,0,0,0,0,0,0,0,0,0,0,0,0,0,0,0
Linus WEBER,Germany,Opposite Spiker,Men,Canada,2022-06-07,Pool,3,3,15,12,4,9,25,3,4,3,10,0,5,7,12,0,0,0,0,1,1,3,5,0,0,2,2
Tobias KRICK,Germany,Middle Blocker,Men,Canada,2022-06-07,Pool,3,3,3,1,3,4,8,1,3,4,8,1,3,1,5,0,0,0,0,1,0,0,1,0,0,2,2
Tobias BRAND,Germany,Outside Hitter,Men,Canada,2022-06-07,Pool,3,3,0,0,0,0,0,0,0,0,0,0,0,0,0,0,0,0,0,0,0,0,0,0,0,0,0
Yannick GORALIK,Germany,Middle Blocker,Men,Canada,2022-06-07,Pool,3,3,0,0,0,0,0,0,0,0,0,0,0,0,0,0,0,0,0,0,0,0,0,0,0,0,0
Lukas MAASE,Germany,Middle Blocker,Men,Canada,2022-06-07,Pool,3,3,5,4,0,3,7,0,6,1,7,1,3,10,14,0,0,1,1,1,0,4,5,0,0,0,0
Iven FERCH,Germany,Middle Blocker,Men,Canada,2022-06-07,Pool,3,3,0,0,0,0,0,0,0,0,0,0,0,0,0,0,0,0,0,0,0,0,0,0,0,0,0
Tim PETER,Germany,Outside Hitter,Men,Canada,2022-06-07,Pool,3,3,0,0,0,0,0,0,0,0,0,0,1,0,1,0,0,0,0,0,0,0,0,0,0,0,0
Max SCHULZ,Germany,Outside Hitter,Men,Canada,2022-06-07,Pool,3,3,0,0,0,0,0,0,0,0,0,0,0,0,0,0,0,0,0,0,0,0,0,0,0,0,0
Mahdi JELVEH GHAZIANI,Iran,Middle Blocker,Men,Poland,2022-07-21,Quarterfinals,2,5,6,5,2,2,9,1,2,9,12,0,2,12,14,2,0,0,2,1,1,1,3,0,0,4,4
Milad EBADIPOUR GHARA H.,Iran,Outside Hitter,Men,Poland,2022-07-21,Quarterfinals,2,5,17,12,4,11,27,2,3,2,7,3,5,11,19,7,1,10,18,11,4,0,15,0,2,2,4
Amir Hossein TOUKHTEH,Iran,Middle Blocker,Men,Poland,2022-07-21,Quarterfinals,2,5,6,4,3,1,8,0,3,2,5,2,4,8,14,1,1,2,4,2,0,0,2,0,0,2,2
Mohammadreza HAZRATPOURTALATAPPEH,Iran,Libero,Men,Poland,2022-07-21,Quarterfinals,2,5,0,0,0,0,0,0,0,0,0,0,0,0,0,10,0,10,20,9,2,2,13,0,0,8,8
Abolfazl GHOLIPOUR GHOLCHI,Iran,Libero,Men,Poland,2022-07-21,Quarterfinals,2,5,0,0,0,0,0,0,0,0,0,0,0,0,0,0,0,0,0,0,0,0,0,0,0,0,0
Amin ESMAEILNEZHAD,Iran,Opposite Spiker,Men,Poland,2022-07-21,Quarterfinals,2,5,22,21,9,9,39,1,6,4,11,0,3,12,15,1,0,0,1,2,2,2,6,1,0,1,2
Mohammad Taher VADI,Iran,Setter,Men,Poland,2022-07-21,Quarterfinals,2,5,0,0,0,0,0,0,4,2,6,0,1,16,17,0,1,1,2,8,2,0,10,15,0,80,95
Ehsan DANESHDOUST,Iran,Outside Hitter,Men,Poland,2022-07-21,Quarterfinals,2,5,1,1,0,0,1,0,0,0,0,0,0,0,0,2,0,2,4,0,1,0,1,0,0,0,0
Amir Reza SARLAK,Iran,Middle Blocker,Men,Poland,2022-07-21,Quarterfinals,2,5,1,1,1,0,2,0,0,0,0,0,0,1,1,0,0,0,0,0,0,0,0,0,0,0,0
Amirhossein ESFANDIAR,Iran,Outside Hitter,Men,Poland,2022-07-21,Quarterfinals,2,5,14,10,5,14,29,3,3,3,9,1,4,9,14,10,3,13,26,5,3,2,10,0,0,2,2
Bardia SAADAT,Iran,Opposite Spiker,Men,Poland,2022-07-21,Quarterfinals,2,5,0,0,0,0,0,0,0,0,0,0,0,0,0,0,0,0,0,0,0,0,0,0,0,1,1
Fazel PAZHOOMAN,Iran,Setter,Men,Poland,2022-07-21,Quarterfinals,2,5,0,0,0,0,0,0,0,0,0,0,0,1,1,0,0,0,0,0,0,0,0,3,0,1,4
Mehrab MALAKISORKHI,Iran,Middle Blocker,Men,Poland,2022-07-21,Quarterfinals,2,5,0,0,0,0,0,0,0,0,0,0,0,0,0,0,0,0,0,0,0,0,0,0,0,0,0
Morteza SHARIFI,Iran,Outside Hitter,Men,Poland,2022-07-21,Quarterfinals,2,5,1,1,0,0,1,0,1,0,1,0,1,2,3,0,0,4,4,0,1,0,1,0,0,0,0
Mahdi JELVEH GHAZIANI,Iran,Middle Blocker,Men,Serbia,2022-07-09,Pool,3,3,9,3,2,0,5,6,3,0,9,0,0,11,11,0,0,1,1,2,1,0,3,0,0,0,0
Milad EBADIPOUR GHARA H.,Iran,Outside Hitter,Men,Serbia,2022-07-09,Pool,3,3,10,9,3,7,19,0,3,0,3,1,3,12,16,2,1,8,11,3,1,0,4,0,0,2,2
Amir Hossein TOUKHTEH,Iran,Middle Blocker,Men,Serbia,2022-07-09,Pool,3,3,13,10,1,1,12,2,2,0,4,1,3,15,19,0,0,2,2,0,0,0,0,0,0,0,0
Mohammadreza HAZRATPOURTALATAPPEH,Iran,Libero,Men,Serbia,2022-07-09,Pool,3,3,0,0,0,0,0,0,0,0,0,0,0,0,0,1,0,15,16,4,4,1,9,0,0,2,2
Abolfazl GHOLIPOUR GHOLCHI,Iran,Libero,Men,Serbia,2022-07-09,Pool,3,3,0,0,0,0,0,0,0,0,0,0,0,0,0,0,0,0,0,0,0,0,0,0,0,0,0
Amin ESMAEILNEZHAD,Iran,Opposite Spiker,Men,Serbia,2022-07-09,Pool,3,3,16,13,2,9,24,1,4,0,5,2,2,11,15,0,0,0,0,4,2,0,6,0,0,2,2
Mohammad Taher VADI,Iran,Setter,Men,Serbia,2022-07-09,Pool,3,3,4,2,0,0,2,1,0,0,1,1,1,7,9,0,0,0,0,1,1,0,2,24,0,49,73
Ehsan DANESHDOUST,Iran,Outside Hitter,Men,Serbia,2022-07-09,Pool,3,3,0,0,0,0,0,0,0,0,0,0,0,0,0,0,0,0,0,0,0,0,0,0,0,0,0
Amir Reza SARLAK,Iran,Middle Blocker,Men,Serbia,2022-07-09,Pool,3,3,0,0,0,0,0,0,0,0,0,0,0,1,1,0,0,0,0,0,0,0,0,0,0,0,0
Amirhossein ESFANDIAR,Iran,Outside Hitter,Men,Serbia,2022-07-09,Pool,3,3,17,11,3,7,21,4,3,0,7,2,2,8,12,4,0,21,25,1,0,0,1,0,0,4,4
Bardia SAADAT,Iran,Opposite Spiker,Men,Serbia,2022-07-09,Pool,3,3,0,0,0,0,0,0,0,0,0,0,0,0,0,0,0,0,0,0,0,0,0,0,0,0,0
Fazel PAZHOOMAN,Iran,Setter,Men,Serbia,2022-07-09,Pool,3,3,0,0,0,0,0,0,0,0,0,0,0,0,0,0,0,0,0,0,0,0,0,0,0,0,0
Mehrab MALAKISORKHI,Iran,Middle Blocker,Men,Serbia,2022-07-09,Pool,3,3,0,0,0,0,0,0,0,0,0,0,0,0,0,0,0,0,0,0,0,0,0,0,0,0,0
Morteza SHARIFI,Iran,Outside Hitter,Men,Serbia,2022-07-09,Pool,3,3,0,0,0,0,0,0,0,0,0,0,1,0,1,0,0,3,3,0,0,0,0,0,0,0,0
Mahdi JELVEH GHAZIANI,Iran,Middle Blocker,Men,Slovenia,2022-07-08,Pool,3,3,4,4,0,1,5,0,2,0,2,0,2,7,9,0,0,0,0,0,0,0,0,0,0,0,0
Milad EBADIPOUR GHARA H.,Iran,Outside Hitter,Men,Slovenia,2022-07-08,Pool,3,3,12,10,2,5,17,1,0,0,1,1,2,8,11,3,2,10,15,0,1,0,1,0,0,2,2
Amir Hossein TOUKHTEH,Iran,Middle Blocker,Men,Slovenia,2022-07-08,Pool,3,3,5,3,0,1,4,1,0,1,2,1,4,5,10,0,0,1,1,0,0,0,0,0,0,0,0
Mohammadreza HAZRATPOURTALATAPPEH,Iran,Libero,Men,Slovenia,2022-07-08,Pool,3,3,0,0,0,0,0,0,0,0,0,0,0,0,0,4,1,3,8,7,2,2,11,0,0,4,4
Abolfazl GHOLIPOUR GHOLCHI,Iran,Libero,Men,Slovenia,2022-07-08,Pool,3,3,0,0,0,0,0,0,0,0,0,0,0,0,0,0,0,0,0,0,0,0,0,0,0,0,0
Amin ESMAEILNEZHAD,Iran,Opposite Spiker,Men,Slovenia,2022-07-08,Pool,3,3,14,11,5,10,26,0,2,0,2,3,5,14,22,0,0,0,0,4,0,0,4,0,0,0,0
Mohammad Taher VADI,Iran,Setter,Men,Slovenia,2022-07-08,Pool,3,3,3,0,0,0,0,3,1,0,4,0,1,10,11,0,0,0,0,0,1,0,1,18,0,44,62
Ehsan DANESHDOUST,Iran,Outside Hitter,Men,Slovenia,2022-07-08,Pool,3,3,0,0,0,0,0,0,0,0,0,0,0,0,0,0,0,0,0,0,0,0,0,0,0,0,0
Amir Reza SARLAK,Iran,Middle Blocker,Men,Slovenia,2022-07-08,Pool,3,3,0,0,0,0,0,0,0,0,0,0,0,0,0,0,0,0,0,0,0,0,0,0,0,0,0
Amirhossein ESFANDIAR,Iran,Outside Hitter,Men,Slovenia,2022-07-08,Pool,3,3,10,8,3,5,16,1,0,0,1,1,3,6,10,3,1,19,23,1,1,1,3,0,0,0,0
Bardia SAADAT,Iran,Opposite Spiker,Men,Slovenia,2022-07-08,Pool,3,3,1,1,0,0,1,0,0,0,0,0,0,0,0,0,0,0,0,0,0,0,0,0,0,0,0
Fazel PAZHOOMAN,Iran,Setter,Men,Slovenia,2022-07-08,Pool,3,3,0,0,0,0,0,0,0,0,0,0,0,0,0,0,0,0,0,0,0,0,0,0,0,0,0
Mehrab MALAKISORKHI,Iran,Middle Blocker,Men,Slovenia,2022-07-08,Pool,3,3,0,0,0,0,0,0,0,0,0,0,0,0,0,0,0,0,0,0,0,0,0,0,0,0,0
Morteza SHARIFI,Iran,Outside Hitter,Men,Slovenia,2022-07-08,Pool,3,3,0,0,0,0,0,0,0,0,0,0,0,1,1,0,0,0,0,0,0,0,0,0,0,0,0
Mahdi JELVEH GHAZIANI,Iran,Middle Blocker,Men,Italy,2022-07-07,Pool,1,4,0,0,0,1,1,0,3,1,4,0,2,2,4,0,0,0,0,0,0,0,0,0,0,0,0
Milad EBADIPOUR GHARA H.,Iran,Outside Hitter,Men,Italy,2022-07-07,Pool,1,4,26,20,1,9,30,2,2,0,4,4,2,14,20,3,7,14,24,9,0,0,9,0,0,3,3
Amir Hossein TOUKHTEH,Iran,Middle Blocker,Men,Italy,2022-07-07,Pool,1,4,4,2,2,4,8,1,6,1,8,1,2,11,14,0,0,4,4,1,0,0,1,0,0,0,0
Mohammadreza HAZRATPOURTALATAPPEH,Iran,Libero,Men,Italy,2022-07-07,Pool,1,4,0,0,0,0,0,0,0,0,0,0,0,0,0,2,0,19,21,7,2,1,10,0,0,7,7
Abolfazl GHOLIPOUR GHOLCHI,Iran,Libero,Men,Italy,2022-07-07,Pool,1,4,0,0,0,0,0,0,0,0,0,0,0,0,0,0,0,0,0,0,0,0,0,0,0,0,0
Amin ESMAEILNEZHAD,Iran,Opposite Spiker,Men,Italy,2022-07-07,Pool,1,4,23,18,6,18,42,3,2,0,5,2,2,11,15,0,0,2,2,0,2,0,2,0,0,5,5
Mohammad Taher VADI,Iran,Setter,Men,Italy,2022-07-07,Pool,1,4,1,1,0,0,1,0,0,0,0,0,0,14,14,0,0,0,0,0,1,1,2,12,0,62,74
Ehsan DANESHDOUST,Iran,Outside Hitter,Men,Italy,2022-07-07,Pool,1,4,0,0,0,0,0,0,0,0,0,0,0,0,0,0,0,2,2,0,0,0,0,0,0,0,0
Amir Reza SARLAK,Iran,Middle Blocker,Men,Italy,2022-07-07,Pool,1,4,1,1,0,0,1,0,2,0,2,0,0,8,8,0,0,0,0,1,0,1,2,0,0,0,0
Amirhossein ESFANDIAR,Iran,Outside Hitter,Men,Italy,2022-07-07,Pool,1,4,5,4,4,6,14,0,0,0,0,1,5,2,8,3,1,12,16,1,0,1,2,0,0,2,2
Bardia SAADAT,Iran,Opposite Spiker,Men,Italy,2022-07-07,Pool,1,4,0,0,0,0,0,0,0,0,0,0,0,0,0,0,0,0,0,0,0,0,0,0,0,0,0
Fazel PAZHOOMAN,Iran,Setter,Men,Italy,2022-07-07,Pool,1,4,0,0,0,1,1,0,0,0,0,0,1,1,2,0,0,0,0,0,0,0,0,1,0,22,23
Mehrab MALAKISORKHI,Iran,Middle Blocker,Men,Italy,2022-07-07,Pool,1,4,0,0,0,0,0,0,0,0,0,0,1,0,1,0,0,0,0,0,0,0,0,0,0,0,0
Morteza SHARIFI,Iran,Outside Hitter,Men,Italy,2022-07-07,Pool,1,4,4,3,4,3,10,1,1,0,2,0,2,2,4,1,0,13,14,4,0,0,4,0,0,0,0
Mahdi JELVEH GHAZIANI,Iran,Middle Blocker,Men,Poland,2022-07-05,Pool,3,5,6,3,1,2,6,3,4,1,8,0,1,9,10,0,0,0,0,1,2,1,4,0,0,1,1
Milad EBADIPOUR GHARA H.,Iran,Outside Hitter,Men,Poland,2022-07-05,Pool,3,5,18,14,4,6,24,1,1,0,2,3,2,14,19,2,3,10,15,8,2,2,12,0,0,4,4
Amir Hossein TOUKHTEH,Iran,Middle Blocker,Men,Poland,2022-07-05,Pool,3,5,7,6,3,5,14,0,5,1,6,1,3,21,25,0,0,3,3,1,1,1,3,0,0,0,0
Mohammadreza HAZRATPOURTALATAPPEH,Iran,Libero,Men,Poland,2022-07-05,Pool,3,5,0,0,0,0,0,0,0,0,0,0,0,0,0,6,3,11,20,5,2,0,7,0,0,3,3
Abolfazl GHOLIPOUR GHOLCHI,Iran,Libero,Men,Poland,2022-07-05,Pool,3,5,0,0,0,0,0,0,0,0,0,0,0,0,0,0,0,0,0,0,0,0,0,0,0,0,0
Amin ESMAEILNEZHAD,Iran,Opposite Spiker,Men,Poland,2022-07-05,Pool,3,5,18,14,5,8,27,1,4,0,5,3,4,17,24,0,0,0,0,2,1,1,4,0,0,2,2
Mohammad Taher VADI,Iran,Setter,Men,Poland,2022-07-05,Pool,3,5,0,0,0,1,1,0,3,0,3,0,3,8,11,0,0,0,0,1,0,1,2,19,0,75,94
Ehsan DANESHDOUST,Iran,Outside Hitter,Men,Poland,2022-07-05,Pool,3,5,0,0,0,0,0,0,0,0,0,0,0,0,0,0,0,0,0,0,0,0,0,0,0,0,0
Amir Reza SARLAK,Iran,Middle Blocker,Men,Poland,2022-07-05,Pool,3,5,0,0,0,0,0,0,0,0,0,0,0,1,1,0,0,0,0,0,0,0,0,0,0,0,0
Amirhossein ESFANDIAR,Iran,Outside Hitter,Men,Poland,2022-07-05,Pool,3,5,21,19,3,10,32,0,4,1,5,2,2,14,18,3,4,34,41,1,3,1,5,0,0,1,1
Bardia SAADAT,Iran,Opposite Spiker,Men,Poland,2022-07-05,Pool,3,5,0,0,0,0,0,0,1,0,1,0,0,0,0,0,0,0,0,0,0,0,0,0,0,0,0
Fazel PAZHOOMAN,Iran,Setter,Men,Poland,2022-07-05,Pool,3,5,0,0,0,0,0,0,0,0,0,0,0,1,1,0,0,0,0,0,0,0,0,0,0,1,1
Mehrab MALAKISORKHI,Iran,Middle Blocker,Men,Poland,2022-07-05,Pool,3,5,0,0,0,0,0,0,0,0,0,0,0,0,0,0,0,0,0,0,0,0,0,0,0,0,0
Morteza SHARIFI,Iran,Outside Hitter,Men,Poland,2022-07-05,Pool,3,5,0,0,0,0,0,0,0,0,0,0,0,1,1,0,0,0,0,0,0,0,0,0,0,0,0
Mahdi JELVEH GHAZIANI,Iran,Middle Blocker,Men,Canada,2022-06-25,Pool,3,3,5,3,0,0,3,2,3,2,7,0,0,10,10,0,0,1,1,0,1,0,1,0,0,0,0
Milad EBADIPOUR GHARA H.,Iran,Outside Hitter,Men,Canada,2022-06-25,Pool,3,3,10,7,2,4,13,1,2,0,3,2,4,10,16,4,1,8,13,4,0,0,4,0,1,1,2
Amir Hossein TOUKHTEH,Iran,Middle Blocker,Men,Canada,2022-06-25,Pool,3,3,0,0,0,0,0,0,0,0,0,0,0,0,0,0,0,0,0,0,0,0,0,0,0,0,0
Esmaeil MOSAFERDASHLIBOROUN,Iran,Outside Hitter,Men,Canada,2022-06-25,Pool,3,3,0,0,0,0,0,0,0,0,0,0,0,0,0,0,0,0,0,0,0,0,0,0,0,0,0
Mohammadreza HAZRATPOURTALATAPPEH,Iran,Libero,Men,Canada,2022-06-25,Pool,3,3,0,0,0,0,0,0,0,0,0,0,0,0,0,3,1,5,9,3,1,0,4,0,0,2,2
Mohammadreza MOAZZEN,Iran,Libero,Men,Canada,2022-06-25,Pool,3,3,0,0,0,0,0,0,0,0,0,0,0,0,0,0,0,0,0,0,0,0,0,0,0,0,0
Ali RAMEZANI,Iran,Setter,Men,Canada,2022-06-25,Pool,3,3,0,0,0,0,0,0,0,0,0,0,0,0,0,0,0,0,0,0,0,0,0,0,0,3,3
Amin ESMAEILNEZHAD,Iran,Opposite Spiker,Men,Canada,2022-06-25,Pool,3,3,15,15,3,6,24,0,1,2,3,0,5,11,16,0,0,0,0,2,0,3,5,0,0,0,0
Mohammad Taher VADI,Iran,Setter,Men,Canada,2022-06-25,Pool,3,3,0,0,0,1,1,0,1,0,1,0,1,10,11,0,0,0,0,4,0,0,4,10,0,44,54
Amir Reza SARLAK,Iran,Middle Blocker,Men,Canada,2022-06-25,Pool,3,3,4,3,0,1,4,1,2,4,7,0,0,10,10,0,0,0,0,0,1,0,1,0,0,1,1
Amirhossein ESFANDIAR,Iran,Outside Hitter,Men,Canada,2022-06-25,Pool,3,3,14,12,1,8,21,0,1,3,4,2,3,6,11,8,2,11,21,2,2,0,4,0,0,1,1
Bardia SAADAT,Iran,Opposite Spiker,Men,Canada,2022-06-25,Pool,3,3,0,0,0,0,0,0,0,0,0,0,0,0,0,0,0,0,0,0,0,0,0,0,0,0,0
Mehrab MALAKISORKHI,Iran,Middle Blocker,Men,Canada,2022-06-25,Pool,3,3,0,0,0,0,0,0,0,0,0,0,0,0,0,0,0,0,0,0,0,0,0,0,0,0,0
Morteza SHARIFI,Iran,Outside Hitter,Men,Canada,2022-06-25,Pool,3,3,0,0,0,0,0,0,0,0,0,0,0,1,1,0,0,0,0,0,0,0,0,0,0,0,0
Mahdi JELVEH GHAZIANI,Iran,Middle Blocker,Men,Brazil,2022-06-24,Pool,0,3,3,2,1,3,6,0,1,0,1,1,0,13,14,0,0,0,0,0,0,0,0,0,0,0,0
Milad EBADIPOUR GHARA H.,Iran,Outside Hitter,Men,Brazil,2022-06-24,Pool,0,3,5,3,5,7,15,2,1,0,3,0,1,9,10,8,0,7,15,1,3,1,5,0,0,2,2
Amir Hossein TOUKHTEH,Iran,Middle Blocker,Men,Brazil,2022-06-24,Pool,0,3,6,5,0,1,6,1,2,1,4,0,2,7,9,0,0,0,0,0,0,0,0,0,0,0,0
Esmaeil MOSAFERDASHLIBOROUN,Iran,Outside Hitter,Men,Brazil,2022-06-24,Pool,0,3,0,0,0,0,0,0,0,0,0,0,0,0,0,0,0,0,0,0,0,0,0,0,0,0,0
Mohammadreza HAZRATPOURTALATAPPEH,Iran,Libero,Men,Brazil,2022-06-24,Pool,0,3,0,0,0,0,0,0,0,0,0,0,0,0,0,8,3,11,22,0,1,1,2,0,0,1,1
Mohammadreza MOAZZEN,Iran,Libero,Men,Brazil,2022-06-24,Pool,0,3,0,0,0,0,0,0,0,0,0,0,0,0,0,0,0,0,0,0,0,0,0,0,0,0,0
Ali RAMEZANI,Iran,Setter,Men,Brazil,2022-06-24,Pool,0,3,0,0,0,0,0,0,0,0,0,0,0,2,2,0,0,0,0,0,0,0,0,0,0,10,10
Amin ESMAEILNEZHAD,Iran,Opposite Spiker,Men,Brazil,2022-06-24,Pool,0,3,15,15,3,3,21,0,2,2,4,0,2,7,9,0,0,0,0,0,0,0,0,0,0,0,0
Mohammad Taher VADI,Iran,Setter,Men,Brazil,2022-06-24,Pool,0,3,2,1,0,2,3,1,2,0,3,0,0,8,8,0,0,0,0,1,0,0,1,10,0,43,53
Amir Reza SARLAK,Iran,Middle Blocker,Men,Brazil,2022-06-24,Pool,0,3,0,0,1,0,1,0,2,0,2,0,0,2,2,0,0,0,0,0,1,0,1,0,0,0,0
Amirhossein ESFANDIAR,Iran,Outside Hitter,Men,Brazil,2022-06-24,Pool,0,3,6,4,3,5,12,1,3,1,5,1,4,3,8,5,1,10,16,0,0,0,0,0,0,0,0
Bardia SAADAT,Iran,Opposite Spiker,Men,Brazil,2022-06-24,Pool,0,3,2,1,0,4,5,0,1,0,1,1,1,1,3,0,0,0,0,1,1,0,2,0,0,0,0
Mehrab MALAKISORKHI,Iran,Middle Blocker,Men,Brazil,2022-06-24,Pool,0,3,0,0,0,1,1,0,1,0,1,0,1,1,2,0,0,0,0,0,0,0,0,0,0,0,0
Morteza SHARIFI,Iran,Outside Hitter,Men,Brazil,2022-06-24,Pool,0,3,5,4,0,0,4,0,1,0,1,1,1,2,4,1,1,5,7,0,2,0,2,0,0,0,0
Mahdi JELVEH GHAZIANI,Iran,Middle Blocker,Men,United States,2022-06-23,Pool,3,3,5,4,1,1,6,1,3,0,4,0,0,9,9,0,0,0,0,1,2,0,3,0,0,0,0
Milad EBADIPOUR GHARA H.,Iran,Outside Hitter,Men,United States,2022-06-23,Pool,3,3,15,12,2,7,21,1,0,0,1,2,3,8,13,3,2,15,20,0,1,0,1,0,1,0,1
Amir Hossein TOUKHTEH,Iran,Middle Blocker,Men,United States,2022-06-23,Pool,3,3,2,2,1,2,5,0,2,1,3,0,1,2,3,0,0,0,0,1,0,0,1,0,0,0,0
Esmaeil MOSAFERDASHLIBOROUN,Iran,Outside Hitter,Men,United States,2022-06-23,Pool,3,3,0,0,0,0,0,0,0,0,0,0,0,0,0,0,0,0,0,0,0,0,0,0,0,0,0
Mohammadreza HAZRATPOURTALATAPPEH,Iran,Libero,Men,United States,2022-06-23,Pool,3,3,0,0,0,0,0,0,0,0,0,0,0,0,0,2,0,9,11,0,1,1,2,0,0,6,6
Mohammadreza MOAZZEN,Iran,Libero,Men,United States,2022-06-23,Pool,3,3,0,0,0,0,0,0,0,0,0,0,0,0,0,0,0,0,0,0,0,0,0,0,0,0,0
Ali RAMEZANI,Iran,Setter,Men,United States,2022-06-23,Pool,3,3,0,0,0,0,0,0,0,0,0,0,0,0,0,0,0,0,0,0,0,0,0,0,0,1,1
Amin ESMAEILNEZHAD,Iran,Opposite Spiker,Men,United States,2022-06-23,Pool,3,3,20,19,4,6,29,1,1,3,5,0,2,12,14,0,0,1,1,1,1,1,3,0,1,0,1
Mohammad Taher VADI,Iran,Setter,Men,United States,2022-06-23,Pool,3,3,1,1,0,0,1,0,4,2,6,0,1,11,12,0,0,0,0,1,0,2,3,12,0,53,65
Amir Reza SARLAK,Iran,Middle Blocker,Men,United States,2022-06-23,Pool,3,3,1,0,0,1,1,1,0,0,1,0,1,7,8,0,0,2,2,0,0,0,0,0,0,0,0
Amirhossein ESFANDIAR,Iran,Outside Hitter,Men,United States,2022-06-23,Pool,3,3,13,8,1,4,13,2,2,2,6,3,5,9,17,5,1,20,26,1,1,0,2,0,0,0,0
Bardia SAADAT,Iran,Opposite Spiker,Men,United States,2022-06-23,Pool,3,3,0,0,0,0,0,0,0,0,0,0,0,0,0,0,0,0,0,0,0,0,0,0,0,0,0
Mehrab MALAKISORKHI,Iran,Middle Blocker,Men,United States,2022-06-23,Pool,3,3,0,0,0,0,0,0,0,0,0,0,0,0,0,0,0,0,0,0,0,0,0,0,0,0,0
Morteza SHARIFI,Iran,Outside Hitter,Men,United States,2022-06-23,Pool,3,3,0,0,0,0,0,0,0,0,0,0,0,3,3,0,0,0,0,1,0,0,1,0,0,0,0
Mahdi JELVEH GHAZIANI,Iran,Middle Blocker,Men,Bulgaria,2022-06-21,Pool,0,3,1,0,0,2,2,1,3,3,7,0,1,13,14,1,0,0,1,0,1,0,1,0,0,0,0
Milad EBADIPOUR GHARA H.,Iran,Outside Hitter,Men,Bulgaria,2022-06-21,Pool,0,3,1,1,0,1,2,0,1,1,2,0,0,2,2,1,0,4,5,0,0,0,0,0,0,0,0
Amir Hossein TOUKHTEH,Iran,Middle Blocker,Men,Bulgaria,2022-06-21,Pool,0,3,3,2,0,1,3,1,3,1,5,0,1,8,9,0,1,1,2,0,0,0,0,0,0,1,1
Esmaeil MOSAFERDASHLIBOROUN,Iran,Outside Hitter,Men,Bulgaria,2022-06-21,Pool,0,3,0,0,0,0,0,0,0,0,0,0,0,0,0,0,0,3,3,1,0,0,1,0,0,0,0
Mohammadreza HAZRATPOURTALATAPPEH,Iran,Libero,Men,Bulgaria,2022-06-21,Pool,0,3,0,0,0,0,0,0,0,0,0,0,0,0,0,0,1,9,10,3,2,3,8,0,0,4,4
Mohammadreza MOAZZEN,Iran,Libero,Men,Bulgaria,2022-06-21,Pool,0,3,0,0,0,0,0,0,0,0,0,0,0,0,0,2,0,3,5,0,1,0,1,0,0,0,0
Ali RAMEZANI,Iran,Setter,Men,Bulgaria,2022-06-21,Pool,0,3,0,0,0,0,0,0,0,0,0,0,1,0,1,0,0,0,0,0,0,0,0,2,0,1,3
Amin ESMAEILNEZHAD,Iran,Opposite Spiker,Men,Bulgaria,2022-06-21,Pool,0,3,17,15,6,8,29,2,2,0,4,0,1,6,7,0,0,0,0,2,0,1,3,0,0,0,0
Mohammad Taher VADI,Iran,Setter,Men,Bulgaria,2022-06-21,Pool,0,3,2,1,0,0,1,1,2,0,3,0,1,13,14,0,0,0,0,1,0,0,1,14,0,53,67
Amir Reza SARLAK,Iran,Middle Blocker,Men,Bulgaria,2022-06-21,Pool,0,3,0,0,0,0,0,0,0,0,0,0,1,1,2,0,0,0,0,1,0,0,1,0,0,0,0
Amirhossein ESFANDIAR,Iran,Outside Hitter,Men,Bulgaria,2022-06-21,Pool,0,3,8,8,5,4,17,0,1,1,2,0,0,7,7,5,2,9,16,0,1,0,1,0,0,1,1
Bardia SAADAT,Iran,Opposite Spiker,Men,Bulgaria,2022-06-21,Pool,0,3,2,2,0,0,2,0,0,0,0,0,0,1,1,0,0,0,0,0,0,0,0,0,0,0,0
Mehrab MALAKISORKHI,Iran,Middle Blocker,Men,Bulgaria,2022-06-21,Pool,0,3,0,0,0,0,0,0,0,0,0,0,0,0,0,0,0,0,0,0,0,0,0,0,0,0,0
Morteza SHARIFI,Iran,Outside Hitter,Men,Bulgaria,2022-06-21,Pool,0,3,11,10,4,6,20,0,2,0,2,1,4,5,10,2,2,18,22,0,0,0,0,0,0,0,0
Mahdi JELVEH GHAZIANI,Iran,Middle Blocker,Men,Japan,2022-06-12,Pool,0,3,2,2,0,0,2,0,1,1,2,0,0,5,5,1,0,0,1,1,0,0,1,0,0,0,0
Milad EBADIPOUR GHARA H.,Iran,Outside Hitter,Men,Japan,2022-06-12,Pool,0,3,3,2,2,8,12,1,1,1,3,0,1,5,6,3,3,12,18,1,1,0,2,2,0,0,2
Reza ABEDINI,Iran,Middle Blocker,Men,Japan,2022-06-12,Pool,0,3,0,0,0,0,0,0,0,0,0,0,0,0,0,0,0,0,0,0,0,0,0,0,0,0,0
Amir Hossein TOUKHTEH,Iran,Middle Blocker,Men,Japan,2022-06-12,Pool,0,3,2,2,1,3,6,0,6,1,7,0,3,3,6,2,0,1,3,2,1,1,4,0,0,0,0
Esmaeil MOSAFERDASHLIBOROUN,Iran,Outside Hitter,Men,Japan,2022-06-12,Pool,0,3,3,2,1,2,5,1,1,1,3,0,1,1,2,0,1,8,9,1,0,1,2,0,0,1,1
Mohammadreza HAZRATPOURTALATAPPEH,Iran,Libero,Men,Japan,2022-06-12,Pool,0,3,0,0,0,0,0,0,0,0,0,0,0,0,0,0,0,4,4,4,1,0,5,2,0,0,2
Mohammadreza MOAZZEN,Iran,Libero,Men,Japan,2022-06-12,Pool,0,3,0,0,0,0,0,0,0,0,0,0,0,0,0,4,0,1,5,2,0,0,2,2,0,1,3
Saber KAZEMI,Iran,Opposite Spiker,Men,Japan,2022-06-12,Pool,0,3,3,3,1,5,9,0,0,0,0,0,0,5,5,0,0,0,0,2,0,0,2,0,0,0,0
Ali RAMEZANI,Iran,Setter,Men,Japan,2022-06-12,Pool,0,3,1,0,0,2,2,0,0,1,1,1,0,5,6,0,0,0,0,2,1,0,3,12,2,21,35
Amin ESMAEILNEZHAD,Iran,Opposite Spiker,Men,Japan,2022-06-12,Pool,0,3,10,7,2,8,17,1,1,1,3,2,2,4,8,0,0,0,0,1,1,0,2,1,0,0,1
Mohammad Taher VADI,Iran,Setter,Men,Japan,2022-06-12,Pool,0,3,0,0,0,0,0,0,1,1,2,0,0,4,4,0,0,0,0,4,0,0,4,8,0,16,24
Amirhossein ESFANDIAR,Iran,Outside Hitter,Men,Japan,2022-06-12,Pool,0,3,4,4,1,1,6,0,2,4,6,0,2,2,4,3,5,5,13,1,0,1,2,1,0,1,2
Mehrab MALAKISORKHI,Iran,Middle Blocker,Men,Japan,2022-06-12,Pool,0,3,1,1,1,1,3,0,2,3,5,0,1,2,3,0,0,1,1,0,1,0,1,0,1,0,1
Morteza SHARIFI,Iran,Outside Hitter,Men,Japan,2022-06-12,Pool,0,3,5,4,1,3,8,0,0,0,0,1,3,1,5,1,1,6,8,2,0,0,2,0,0,1,1
Mahdi JELVEH GHAZIANI,Iran,Middle Blocker,Men,Australia,2022-06-12,Pool,3,4,11,4,1,4,9,5,4,3,12,2,2,9,13,0,0,0,0,1,0,0,1,3,0,0,3
Milad EBADIPOUR GHARA H.,Iran,Outside Hitter,Men,Australia,2022-06-12,Pool,3,4,8,6,2,7,15,2,2,0,4,0,2,11,13,7,0,7,14,8,2,2,12,2,0,0,2
Reza ABEDINI,Iran,Middle Blocker,Men,Australia,2022-06-12,Pool,3,4,0,0,0,0,0,0,0,0,0,0,0,0,0,0,0,0,0,0,0,0,0,0,0,0,0
Amir Hossein TOUKHTEH,Iran,Middle Blocker,Men,Australia,2022-06-12,Pool,3,4,8,6,0,0,6,1,4,6,11,1,4,15,20,0,0,1,1,1,0,1,2,1,2,0,3
Esmaeil MOSAFERDASHLIBOROUN,Iran,Outside Hitter,Men,Australia,2022-06-12,Pool,3,4,0,0,0,0,0,0,0,0,0,0,0,0,0,0,0,0,0,0,0,0,0,0,0,0,0
Mohammadreza HAZRATPOURTALATAPPEH,Iran,Libero,Men,Australia,2022-06-12,Pool,3,4,0,0,0,0,0,0,0,0,0,0,0,0,0,11,0,14,25,6,2,1,9,4,0,3,7
Mohammadreza MOAZZEN,Iran,Libero,Men,Australia,2022-06-12,Pool,3,4,0,0,0,0,0,0,0,0,0,0,0,0,0,0,0,0,0,0,0,0,0,0,0,0,0
Saber KAZEMI,Iran,Opposite Spiker,Men,Australia,2022-06-12,Pool,3,4,0,0,0,0,0,0,0,0,0,0,1,0,1,0,0,0,0,0,0,0,0,0,0,0,0
Ali RAMEZANI,Iran,Setter,Men,Australia,2022-06-12,Pool,3,4,0,0,0,0,0,0,0,1,1,0,0,0,0,0,0,0,0,3,0,0,3,6,0,3,9
Amin ESMAEILNEZHAD,Iran,Opposite Spiker,Men,Australia,2022-06-12,Pool,3,4,23,21,7,9,37,1,2,3,6,1,4,10,15,0,0,0,0,7,2,1,10,1,0,0,1
Mohammad Taher VADI,Iran,Setter,Men,Australia,2022-06-12,Pool,3,4,1,1,0,0,1,0,3,4,7,0,0,12,12,0,0,0,0,5,2,0,7,30,0,35,65
Amirhossein ESFANDIAR,Iran,Outside Hitter,Men,Australia,2022-06-12,Pool,3,4,14,10,2,8,20,3,1,4,8,1,3,14,18,6,2,14,22,3,2,2,7,1,0,1,2
Mehrab MALAKISORKHI,Iran,Middle Blocker,Men,Australia,2022-06-12,Pool,3,4,0,0,0,0,0,0,0,0,0,0,0,0,0,0,0,0,0,0,0,0,0,0,0,0,0
Morteza SHARIFI,Iran,Outside Hitter,Men,Australia,2022-06-12,Pool,3,4,0,0,0,0,0,0,0,0,0,0,0,0,0,0,0,0,0,0,0,0,0,0,0,0,0
Mahdi JELVEH GHAZIANI,Iran,Middle Blocker,Men,Netherlands,2022-06-10,Pool,0,3,5,2,0,3,5,1,5,1,7,2,0,7,9,0,0,2,2,1,0,1,2,0,0,0,0
Milad EBADIPOUR GHARA H.,Iran,Outside Hitter,Men,Netherlands,2022-06-10,Pool,0,3,6,5,4,7,16,0,2,0,2,1,3,5,9,3,1,14,18,4,0,0,4,1,0,0,1
Amir Hossein TOUKHTEH,Iran,Middle Blocker,Men,Netherlands,2022-06-10,Pool,0,3,2,1,0,0,1,0,4,0,4,1,1,5,7,0,0,2,2,0,0,0,0,0,0,0,0
Esmaeil MOSAFERDASHLIBOROUN,Iran,Outside Hitter,Men,Netherlands,2022-06-10,Pool,0,3,0,0,0,0,0,0,0,0,0,0,0,0,0,0,0,0,0,0,0,0,0,0,0,0,0
Mohammadreza HAZRATPOURTALATAPPEH,Iran,Libero,Men,Netherlands,2022-06-10,Pool,0,3,0,0,0,0,0,0,0,0,0,0,0,0,0,8,0,11,19,6,3,3,12,5,0,0,5
Mohammadreza MOAZZEN,Iran,Libero,Men,Netherlands,2022-06-10,Pool,0,3,0,0,0,0,0,0,0,0,0,0,0,0,0,0,0,0,0,0,0,0,0,0,0,0,0
Saber KAZEMI,Iran,Opposite Spiker,Men,Netherlands,2022-06-10,Pool,0,3,1,1,1,1,3,0,0,0,0,0,0,1,1,0,0,0,0,0,0,0,0,0,0,0,0
Ali RAMEZANI,Iran,Setter,Men,Netherlands,2022-06-10,Pool,0,3,1,1,0,0,1,0,3,0,3,0,0,6,6,0,0,1,1,1,1,1,3,9,1,17,27
Amin ESMAEILNEZHAD,Iran,Opposite Spiker,Men,Netherlands,2022-06-10,Pool,0,3,15,15,4,11,30,0,3,2,5,0,2,8,10,0,0,0,0,3,0,0,3,0,0,1,1
Mohammad Taher VADI,Iran,Setter,Men,Netherlands,2022-06-10,Pool,0,3,0,0,0,0,0,0,1,0,1,0,0,6,6,0,0,0,0,3,1,0,4,13,0,27,40
Amirhossein ESFANDIAR,Iran,Outside Hitter,Men,Netherlands,2022-06-10,Pool,0,3,5,3,0,1,4,0,3,2,5,2,1,3,6,4,0,5,9,3,1,1,5,0,0,0,0
Mehrab MALAKISORKHI,Iran,Middle Blocker,Men,Netherlands,2022-06-10,Pool,0,3,5,4,0,2,6,0,4,4,8,1,1,4,6,0,0,0,0,1,0,0,1,0,0,0,0
Morteza SHARIFI,Iran,Outside Hitter,Men,Netherlands,2022-06-10,Pool,0,3,4,4,4,2,10,0,3,2,5,0,2,5,7,1,1,5,7,0,0,1,1,1,0,0,1
Mahdi JELVEH GHAZIANI,Iran,Middle Blocker,Men,China,2022-06-07,Pool,3,4,0,0,0,0,0,0,0,0,0,0,0,0,0,0,0,0,0,0,0,0,0,0,0,0,0
Milad EBADIPOUR GHARA H.,Iran,Outside Hitter,Men,China,2022-06-07,Pool,3,4,15,13,5,8,26,1,2,0,3,1,3,11,15,5,2,17,24,3,0,0,3,0,0,3,3
Reza ABEDINI,Iran,Middle Blocker,Men,China,2022-06-07,Pool,3,4,5,2,2,0,4,2,7,4,13,1,2,8,11,0,1,3,4,5,1,2,8,0,0,0,0
Amir Hossein TOUKHTEH,Iran,Middle Blocker,Men,China,2022-06-07,Pool,3,4,12,9,0,3,12,1,4,0,5,2,2,12,16,0,0,3,3,3,0,0,3,0,0,1,1
Esmaeil MOSAFERDASHLIBOROUN,Iran,Outside Hitter,Men,China,2022-06-07,Pool,3,4,0,0,0,0,0,0,0,0,0,0,0,0,0,0,0,0,0,0,0,0,0,0,0,0,0
Mohammadreza HAZRATPOURTALATAPPEH,Iran,Libero,Men,China,2022-06-07,Pool,3,4,0,0,0,0,0,0,0,0,0,0,0,0,0,4,0,15,19,5,1,4,10,0,0,8,8
Mohammadreza MOAZZEN,Iran,Libero,Men,China,2022-06-07,Pool,3,4,0,0,0,0,0,0,0,0,0,0,0,0,0,0,0,0,0,0,0,0,0,0,0,0,0
Saber KAZEMI,Iran,Opposite Spiker,Men,China,2022-06-07,Pool,3,4,7,3,5,5,13,0,1,1,2,4,2,6,12,0,0,1,1,4,1,0,5,0,1,0,1
Ali RAMEZANI,Iran,Setter,Men,China,2022-06-07,Pool,3,4,0,0,0,0,0,0,0,0,0,0,0,0,0,0,0,0,0,0,0,0,0,0,0,2,2
Amin ESMAEILNEZHAD,Iran,Opposite Spiker,Men,China,2022-06-07,Pool,3,4,7,6,0,0,6,1,0,2,3,0,1,4,5,0,0,0,0,1,0,0,1,0,0,0,0
Mohammad Taher VADI,Iran,Setter,Men,China,2022-06-07,Pool,3,4,3,1,0,1,2,0,0,1,1,2,0,11,13,0,0,2,2,2,2,2,6,29,1,16,46
Amirhossein ESFANDIAR,Iran,Outside Hitter,Men,China,2022-06-07,Pool,3,4,0,0,0,0,0,0,0,0,0,0,0,0,0,0,0,0,0,0,0,0,0,0,0,0,0
Mehrab MALAKISORKHI,Iran,Middle Blocker,Men,China,2022-06-07,Pool,3,4,0,0,0,0,0,0,0,0,0,0,0,0,0,0,0,0,0,0,0,0,0,0,0,0,0
Morteza SHARIFI,Iran,Outside Hitter,Men,China,2022-06-07,Pool,3,4,20,14,1,5,20,2,1,2,5,4,3,12,19,2,2,8,12,3,0,0,3,0,0,2,2
Giulio PINALI,Italy,Opposite Spiker,Men,China,2022-06-26,Pool,3,3,15,12,4,4,20,1,4,1,6,2,3,7,12,0,0,0,0,6,0,2,8,0,0,0,0
Fabio RICCI,Italy,Middle Blocker,Men,China,2022-06-26,Pool,3,3,0,0,0,0,0,0,0,0,0,0,0,1,1,0,0,0,0,0,0,0,0,0,0,0,0
Oreste CAVUTO,Italy,Outside Hitter,Men,China,2022-06-26,Pool,3,3,0,0,0,0,0,0,0,0,0,0,0,0,0,0,0,0,0,0,0,0,0,0,0,0,0
Alessandro MICHIELETTO,Italy,Outside Hitter,Men,China,2022-06-26,Pool,3,3,9,8,2,5,15,0,1,1,2,1,2,8,11,8,2,14,24,3,0,0,3,0,0,1,1
Simone GIANNELLI,Italy,Setter,Men,China,2022-06-26,Pool,3,3,5,1,0,1,2,3,0,3,6,1,2,9,12,0,0,0,0,2,1,1,4,16,1,40,57
Fabio BALASO,Italy,Libero,Men,China,2022-06-26,Pool,3,3,0,0,0,0,0,0,0,0,0,0,0,0,0,4,0,5,9,9,2,1,12,0,0,1,1
Riccardo SBERTOLI,Italy,Setter,Men,China,2022-06-26,Pool,3,3,1,0,0,0,0,1,1,0,2,0,1,1,2,0,0,0,0,0,0,0,0,3,0,8,11
Mattia BOTTOLO,Italy,Outside Hitter,Men,China,2022-06-26,Pool,3,3,2,2,1,2,5,0,2,2,4,0,1,1,2,0,0,6,6,0,0,0,0,0,0,0,0
Gianluca GALASSI,Italy,Middle Blocker,Men,China,2022-06-26,Pool,3,3,4,3,0,4,7,1,5,4,10,0,3,5,8,0,0,1,1,2,1,0,3,0,0,0,0
Daniele LAVIA,Italy,Outside Hitter,Men,China,2022-06-26,Pool,3,3,22,16,1,6,23,3,3,0,6,3,2,12,17,4,0,2,6,5,0,0,5,0,0,2,2
Yuri ROMANÒ,Italy,Opposite Spiker,Men,China,2022-06-26,Pool,3,3,0,0,0,0,0,0,0,0,0,0,0,0,0,0,0,0,0,0,0,0,0,0,0,0,0
Simone ANZANI,Italy,Middle Blocker,Men,China,2022-06-26,Pool,3,3,5,3,0,0,3,2,2,3,7,0,1,8,9,1,1,0,2,1,0,0,1,0,0,2,2
Alessandro PICCINELLI,Italy,Libero,Men,China,2022-06-26,Pool,3,3,0,0,0,0,0,0,0,0,0,0,0,0,0,1,0,3,4,2,0,0,2,0,0,0,0
Giulio PINALI,Italy,Opposite Spiker,Men,Slovenia,2022-06-25,Pool,3,3,5,5,2,1,8,0,3,1,4,0,2,2,4,0,0,0,0,3,1,0,4,1,0,0,1
Fabio RICCI,Italy,Middle Blocker,Men,Slovenia,2022-06-25,Pool,3,3,0,0,0,0,0,0,0,0,0,0,0,0,0,0,0,0,0,0,0,0,0,0,0,0,0
Oreste CAVUTO,Italy,Outside Hitter,Men,Slovenia,2022-06-25,Pool,3,3,0,0,0,0,0,0,0,0,0,0,0,0,0,0,0,0,0,0,0,0,0,0,0,0,0
Alessandro MICHIELETTO,Italy,Outside Hitter,Men,Slovenia,2022-06-25,Pool,3,3,16,13,1,10,24,2,1,1,4,1,2,10,13,8,0,10,18,6,2,1,9,0,0,1,1
Simone GIANNELLI,Italy,Setter,Men,Slovenia,2022-06-25,Pool,3,3,5,4,0,0,4,0,4,0,4,1,2,10,13,0,0,0,0,6,1,0,7,20,0,43,63
Fabio BALASO,Italy,Libero,Men,Slovenia,2022-06-25,Pool,3,3,0,0,0,0,0,0,0,0,0,0,0,0,0,3,0,3,6,7,1,2,10,0,1,6,7
Riccardo SBERTOLI,Italy,Setter,Men,Slovenia,2022-06-25,Pool,3,3,0,0,0,0,0,0,2,1,3,0,0,3,3,0,0,0,0,0,0,0,0,1,0,9,10
Mattia BOTTOLO,Italy,Outside Hitter,Men,Slovenia,2022-06-25,Pool,3,3,0,0,0,0,0,0,0,0,0,0,0,0,0,0,0,0,0,0,0,0,0,0,0,0,0
Gianluca GALASSI,Italy,Middle Blocker,Men,Slovenia,2022-06-25,Pool,3,3,7,5,1,3,9,1,2,2,5,1,3,5,9,0,0,0,0,1,0,0,1,1,0,1,2
Daniele LAVIA,Italy,Outside Hitter,Men,Slovenia,2022-06-25,Pool,3,3,14,12,2,10,24,0,2,0,2,2,2,10,14,5,0,19,24,2,0,2,4,0,0,2,2
Yuri ROMANÒ,Italy,Opposite Spiker,Men,Slovenia,2022-06-25,Pool,3,3,6,4,2,4,10,1,1,0,2,1,1,3,5,0,0,0,0,7,1,0,8,0,0,0,0
Simone ANZANI,Italy,Middle Blocker,Men,Slovenia,2022-06-25,Pool,3,3,7,6,1,2,9,1,1,7,9,0,1,11,12,0,0,0,0,3,0,0,3,0,0,2,2
Alessandro PICCINELLI,Italy,Libero,Men,Slovenia,2022-06-25,Pool,3,3,0,0,0,0,0,0,0,0,0,0,0,0,0,0,0,0,0,0,0,0,0,0,0,0,0
Giulio PINALI,Italy,Opposite Spiker,Men,Japan,2022-06-24,Pool,2,5,0,0,0,0,0,0,0,0,0,0,0,0,0,0,0,0,0,0,0,0,0,0,0,0,0
Fabio RICCI,Italy,Middle Blocker,Men,Japan,2022-06-24,Pool,2,5,0,0,0,0,0,0,0,0,0,0,0,0,0,0,0,0,0,0,0,0,0,0,0,0,0
Oreste CAVUTO,Italy,Outside Hitter,Men,Japan,2022-06-24,Pool,2,5,0,0,0,0,0,0,0,0,0,0,0,0,0,0,1,1,2,0,0,0,0,0,0,0,0
Alessandro MICHIELETTO,Italy,Outside Hitter,Men,Japan,2022-06-24,Pool,2,5,16,14,2,5,21,2,2,0,4,0,6,8,14,11,5,26,42,4,1,0,5,0,0,2,2
Simone GIANNELLI,Italy,Setter,Men,Japan,2022-06-24,Pool,2,5,8,4,0,1,5,3,0,4,7,1,2,20,23,0,0,0,0,6,1,2,9,31,0,60,91
Fabio BALASO,Italy,Libero,Men,Japan,2022-06-24,Pool,2,5,0,0,0,0,0,0,0,0,0,0,0,0,0,6,3,13,22,8,2,1,11,1,0,7,8
Riccardo SBERTOLI,Italy,Setter,Men,Japan,2022-06-24,Pool,2,5,0,0,0,0,0,0,0,0,0,0,0,5,5,0,0,0,0,0,0,0,0,0,0,0,0
Mattia BOTTOLO,Italy,Outside Hitter,Men,Japan,2022-06-24,Pool,2,5,0,0,0,0,0,0,1,0,1,0,1,2,3,1,1,1,3,0,2,0,2,0,0,0,0
Gianluca GALASSI,Italy,Middle Blocker,Men,Japan,2022-06-24,Pool,2,5,8,6,0,5,11,1,8,5,14,1,4,8,13,1,0,0,1,2,1,1,4,0,0,0,0
Daniele LAVIA,Italy,Outside Hitter,Men,Japan,2022-06-24,Pool,2,5,22,18,2,11,31,3,5,6,14,1,3,14,18,7,4,15,26,1,1,1,3,0,0,1,1
Yuri ROMANÒ,Italy,Opposite Spiker,Men,Japan,2022-06-24,Pool,2,5,16,14,3,11,28,2,3,3,8,0,6,8,14,0,0,0,0,7,1,0,8,0,0,0,0
Simone ANZANI,Italy,Middle Blocker,Men,Japan,2022-06-24,Pool,2,5,10,7,0,3,10,3,7,9,19,0,1,13,14,0,0,0,0,1,2,2,5,0,0,2,2
Alessandro PICCINELLI,Italy,Libero,Men,Japan,2022-06-24,Pool,2,5,0,0,0,0,0,0,0,0,0,0,0,0,0,0,0,0,0,0,0,0,0,0,0,0,0
Leandro Ausibio MOSCA,Italy,Middle Blocker,Men,Japan,2022-06-24,Pool,2,5,0,0,0,0,0,0,0,0,0,0,0,0,0,0,0,0,0,0,0,0,0,0,0,0,0
Giulio PINALI,Italy,Opposite Spiker,Men,Germany,2022-06-22,Pool,3,3,0,0,0,0,0,0,0,0,0,0,1,3,4,0,0,0,0,0,0,0,0,0,0,0,0
Fabio RICCI,Italy,Middle Blocker,Men,Germany,2022-06-22,Pool,3,3,0,0,0,0,0,0,0,0,0,0,0,0,0,0,0,0,0,0,0,0,0,0,0,0,0
Oreste CAVUTO,Italy,Outside Hitter,Men,Germany,2022-06-22,Pool,3,3,0,0,0,0,0,0,0,0,0,0,0,0,0,0,0,0,0,0,0,0,0,0,0,0,0
Alessandro MICHIELETTO,Italy,Outside Hitter,Men,Germany,2022-06-22,Pool,3,3,8,6,5,4,15,1,1,0,2,1,1,8,10,1,1,11,13,6,2,1,9,0,0,0,0
Simone GIANNELLI,Italy,Setter,Men,Germany,2022-06-22,Pool,3,3,1,0,0,0,0,1,2,2,5,0,2,8,10,0,0,0,0,5,1,2,8,16,0,38,54
Fabio BALASO,Italy,Libero,Men,Germany,2022-06-22,Pool,3,3,0,0,0,0,0,0,0,0,0,0,0,0,0,4,2,11,17,6,2,0,8,0,0,4,4
Riccardo SBERTOLI,Italy,Setter,Men,Germany,2022-06-22,Pool,3,3,0,0,0,0,0,0,0,0,0,0,0,0,0,0,0,0,0,0,0,0,0,0,0,0,0
Mattia BOTTOLO,Italy,Outside Hitter,Men,Germany,2022-06-22,Pool,3,3,0,0,0,0,0,0,0,0,0,0,0,0,0,0,0,0,0,0,0,0,0,0,0,0,0
Gianluca GALASSI,Italy,Middle Blocker,Men,Germany,2022-06-22,Pool,3,3,11,7,0,1,8,4,6,2,12,0,3,6,9,0,0,0,0,1,1,0,2,0,0,0,0
Daniele LAVIA,Italy,Outside Hitter,Men,Germany,2022-06-22,Pool,3,3,9,8,2,8,18,1,2,0,3,0,1,11,12,2,0,11,13,1,0,0,1,0,0,1,1
Yuri ROMANÒ,Italy,Opposite Spiker,Men,Germany,2022-06-22,Pool,3,3,13,10,2,4,16,1,2,5,8,2,4,10,16,0,0,0,0,2,3,0,5,0,0,0,0
Simone ANZANI,Italy,Middle Blocker,Men,Germany,2022-06-22,Pool,3,3,9,4,1,0,5,4,2,2,8,1,1,11,13,0,0,0,0,1,3,1,5,0,0,0,0
Alessandro PICCINELLI,Italy,Libero,Men,Germany,2022-06-22,Pool,3,3,0,0,0,0,0,0,0,0,0,0,0,0,0,0,0,0,0,0,0,0,0,0,0,0,0
Leandro Ausibio MOSCA,Italy,Middle Blocker,Men,Germany,2022-06-22,Pool,3,3,0,0,0,0,0,0,0,0,0,0,0,0,0,0,0,0,0,0,0,0,0,0,0,0,0
Giulio PINALI,Italy,Opposite Spiker,Men,Argentina,2022-06-12,Pool,3,4,9,9,3,11,23,0,0,4,4,0,3,2,5,0,0,0,0,0,3,1,4,0,0,2,2
Francesco RECINE,Italy,Outside Hitter,Men,Argentina,2022-06-12,Pool,3,4,15,13,4,6,23,2,3,2,7,0,4,15,19,5,1,23,29,5,0,3,8,0,0,4,4
Simone GIANNELLI,Italy,Setter,Men,Argentina,2022-06-12,Pool,3,4,3,1,0,3,4,1,2,3,6,1,2,12,15,0,0,0,0,6,7,2,15,52,0,35,87
Marco FALASCHI,Italy,Setter,Men,Argentina,2022-06-12,Pool,3,4,0,0,0,0,0,0,0,1,1,0,1,2,3,0,0,0,0,0,0,0,0,5,1,4,10
Davide GARDINI,Italy,Outside Hitter,Men,Argentina,2022-06-12,Pool,3,4,0,0,0,0,0,0,0,0,0,0,0,0,0,0,0,0,0,0,0,0,0,0,0,0,0
Mattia BOTTOLO,Italy,Outside Hitter,Men,Argentina,2022-06-12,Pool,3,4,21,14,4,12,30,3,5,5,13,4,4,11,19,5,1,18,24,4,2,4,10,0,0,1,1
Lorenzo CORTESIA,Italy,Middle Blocker,Men,Argentina,2022-06-12,Pool,3,4,0,0,0,0,0,0,0,0,0,0,0,0,0,0,0,0,0,0,0,0,0,0,0,0,0
Gianluca GALASSI,Italy,Middle Blocker,Men,Argentina,2022-06-12,Pool,3,4,5,3,3,2,8,2,2,2,6,0,2,5,7,0,0,0,0,0,1,1,2,0,0,0,0
Yuri ROMANÒ,Italy,Opposite Spiker,Men,Argentina,2022-06-12,Pool,3,4,4,2,2,8,12,2,2,2,6,0,3,2,5,0,0,0,0,1,1,1,3,0,0,1,1
Fabrizio GIRONI,Italy,Outside Hitter,Men,Argentina,2022-06-12,Pool,3,4,0,0,0,0,0,0,0,0,0,0,0,0,0,0,0,0,0,0,0,0,0,0,0,0,0
Alessandro PICCINELLI,Italy,Libero,Men,Argentina,2022-06-12,Pool,3,4,0,0,0,0,0,0,0,0,0,0,0,0,0,9,0,11,20,17,5,5,27,0,0,4,4
Leonardo SCANFERLA,Italy,Libero,Men,Argentina,2022-06-12,Pool,3,4,0,0,0,0,0,0,0,0,0,0,0,0,0,0,0,0,0,0,0,0,0,0,0,0,0
Marco VITELLI,Italy,Middle Blocker,Men,Argentina,2022-06-12,Pool,3,4,9,5,2,5,12,2,6,7,15,2,2,14,18,0,0,0,0,3,0,0,3,1,0,2,3
Leandro Ausibio MOSCA,Italy,Middle Blocker,Men,Argentina,2022-06-12,Pool,3,4,2,1,0,0,1,1,0,0,1,0,1,3,4,0,0,1,1,1,0,0,1,0,0,0,0
Giulio PINALI,Italy,Opposite Spiker,Men,Canada,2022-06-11,Pool,3,3,0,0,1,0,1,0,0,0,0,0,0,0,0,0,0,0,0,0,0,0,0,0,0,0,0
Francesco RECINE,Italy,Outside Hitter,Men,Canada,2022-06-11,Pool,3,3,7,7,4,4,15,0,1,1,2,0,2,7,9,6,0,12,18,5,0,1,6,0,0,2,2
Simone GIANNELLI,Italy,Setter,Men,Canada,2022-06-11,Pool,3,3,9,6,0,0,6,2,1,1,4,1,4,14,19,0,0,0,0,5,1,0,6,0,0,71,71
Marco FALASCHI,Italy,Setter,Men,Canada,2022-06-11,Pool,3,3,0,0,0,0,0,0,0,0,0,0,0,0,0,0,0,0,0,0,0,0,0,0,0,0,0
Davide GARDINI,Italy,Outside Hitter,Men,Canada,2022-06-11,Pool,3,3,0,0,0,0,0,0,0,0,0,0,0,0,0,0,0,0,0,0,0,0,0,0,0,0,0
Mattia BOTTOLO,Italy,Outside Hitter,Men,Canada,2022-06-11,Pool,3,3,13,11,5,9,25,1,1,2,4,1,4,9,14,0,0,13,13,8,0,0,8,0,0,2,2
Lorenzo CORTESIA,Italy,Middle Blocker,Men,Canada,2022-06-11,Pool,3,3,0,0,0,0,0,0,0,0,0,0,0,0,0,0,0,0,0,0,0,0,0,0,0,0,0
Gianluca GALASSI,Italy,Middle Blocker,Men,Canada,2022-06-11,Pool,3,3,6,5,2,0,7,1,2,1,4,0,0,10,10,0,0,2,2,1,0,0,1,0,0,0,0
Yuri ROMANÒ,Italy,Opposite Spiker,Men,Canada,2022-06-11,Pool,3,3,13,11,3,8,22,1,1,1,3,1,2,6,9,0,0,0,0,2,0,0,2,0,0,0,0
Fabrizio GIRONI,Italy,Outside Hitter,Men,Canada,2022-06-11,Pool,3,3,0,0,0,0,0,0,0,0,0,0,0,0,0,0,0,0,0,0,0,0,0,0,0,0,0
Alessandro PICCINELLI,Italy,Libero,Men,Canada,2022-06-11,Pool,3,3,0,0,0,0,0,0,0,0,0,0,0,0,0,8,0,11,19,7,0,1,8,0,0,2,2
Leonardo SCANFERLA,Italy,Libero,Men,Canada,2022-06-11,Pool,3,3,0,0,0,0,0,0,0,0,0,0,0,0,0,0,0,0,0,0,0,0,0,0,0,0,0
Marco VITELLI,Italy,Middle Blocker,Men,Canada,2022-06-11,Pool,3,3,0,0,0,0,0,0,0,0,0,0,0,0,0,0,0,0,0,0,0,0,0,0,0,0,0
Leandro Ausibio MOSCA,Italy,Middle Blocker,Men,Canada,2022-06-11,Pool,3,3,9,7,2,0,9,2,4,5,11,0,0,12,12,0,0,0,0,2,1,0,3,0,0,0,0
Giulio PINALI,Italy,Opposite Spiker,Men,Poland,2022-06-09,Pool,3,4,0,0,0,0,0,0,0,0,0,0,0,0,0,0,0,0,0,0,0,0,0,0,0,0,0
Francesco RECINE,Italy,Outside Hitter,Men,Poland,2022-06-09,Pool,3,4,9,8,3,14,25,1,3,1,5,0,2,14,16,3,2,17,22,5,2,4,11,0,0,8,8
Simone GIANNELLI,Italy,Setter,Men,Poland,2022-06-09,Pool,3,4,4,4,0,4,8,0,3,4,7,0,5,11,16,0,0,0,0,6,2,4,12,32,0,38,70
Marco FALASCHI,Italy,Setter,Men,Poland,2022-06-09,Pool,3,4,0,0,0,0,0,0,0,0,0,0,0,0,0,0,0,0,0,0,0,0,0,0,0,0,0
Davide GARDINI,Italy,Outside Hitter,Men,Poland,2022-06-09,Pool,3,4,0,0,0,0,0,0,0,0,0,0,0,0,0,0,0,0,0,0,0,0,0,0,0,0,0
Mattia BOTTOLO,Italy,Outside Hitter,Men,Poland,2022-06-09,Pool,3,4,16,13,4,1,18,1,2,0,3,2,3,15,20,7,1,19,27,1,0,2,3,1,0,5,6
Lorenzo CORTESIA,Italy,Middle Blocker,Men,Poland,2022-06-09,Pool,3,4,2,2,0,4,6,0,2,0,2,0,2,4,6,0,0,0,0,0,0,2,2,0,0,0,0
Gianluca GALASSI,Italy,Middle Blocker,Men,Poland,2022-06-09,Pool,3,4,5,2,2,3,7,1,5,3,9,2,2,3,7,0,0,0,0,0,0,4,4,0,0,0,0
Yuri ROMANÒ,Italy,Opposite Spiker,Men,Poland,2022-06-09,Pool,3,4,16,16,5,9,30,0,7,1,8,0,6,10,16,0,0,2,2,7,1,1,9,1,0,1,2
Fabrizio GIRONI,Italy,Outside Hitter,Men,Poland,2022-06-09,Pool,3,4,0,0,0,0,0,0,0,0,0,0,0,0,0,0,0,0,0,0,0,0,0,0,0,0,0
Alessandro PICCINELLI,Italy,Libero,Men,Poland,2022-06-09,Pool,3,4,0,0,0,0,0,0,0,0,0,0,0,0,0,5,1,9,15,5,5,3,13,0,1,6,7
Leonardo SCANFERLA,Italy,Libero,Men,Poland,2022-06-09,Pool,3,4,0,0,0,0,0,0,0,0,0,0,0,0,0,0,0,0,0,0,0,0,0,0,0,0,0
Marco VITELLI,Italy,Middle Blocker,Men,Poland,2022-06-09,Pool,3,4,3,2,0,1,3,0,4,1,5,1,2,7,10,0,0,0,0,0,0,2,2,0,0,0,0
Leandro Ausibio MOSCA,Italy,Middle Blocker,Men,Poland,2022-06-09,Pool,3,4,3,1,0,1,2,2,1,5,8,0,0,4,4,0,0,0,0,1,1,0,2,0,0,1,1
Giulio PINALI,Italy,Opposite Spiker,Men,France,2022-06-08,Pool,0,3,0,0,0,0,0,0,0,0,0,0,0,0,0,0,0,0,0,0,0,0,0,0,0,0,0
Francesco RECINE,Italy,Outside Hitter,Men,France,2022-06-08,Pool,0,3,9,8,2,5,15,0,5,1,6,1,3,9,13,2,1,19,22,7,2,3,12,0,0,8,8
Simone GIANNELLI,Italy,Setter,Men,France,2022-06-08,Pool,0,3,5,0,1,2,3,4,4,1,9,1,3,8,12,0,0,0,0,8,3,1,12,45,1,22,68
Marco FALASCHI,Italy,Setter,Men,France,2022-06-08,Pool,0,3,0,0,0,0,0,0,0,0,0,0,0,0,0,0,0,0,0,0,0,0,0,0,0,0,0
Davide GARDINI,Italy,Outside Hitter,Men,France,2022-06-08,Pool,0,3,0,0,1,7,8,0,0,2,2,0,1,2,3,0,2,6,8,1,1,0,2,0,0,1,1
Mattia BOTTOLO,Italy,Outside Hitter,Men,France,2022-06-08,Pool,0,3,3,3,5,10,18,0,2,2,4,0,2,7,9,1,0,13,14,2,2,0,4,0,0,0,0
Lorenzo CORTESIA,Italy,Middle Blocker,Men,France,2022-06-08,Pool,0,3,5,5,1,2,8,0,3,4,7,0,3,5,8,0,0,2,2,2,0,1,3,0,0,1,1
Gianluca GALASSI,Italy,Middle Blocker,Men,France,2022-06-08,Pool,0,3,3,3,1,4,8,0,2,4,6,0,1,6,7,0,0,2,2,0,0,4,4,0,0,1,1
Yuri ROMANÒ,Italy,Opposite Spiker,Men,France,2022-06-08,Pool,0,3,16,14,5,13,32,2,1,0,3,0,4,9,13,0,0,1,1,3,1,5,9,0,0,2,2
Fabrizio GIRONI,Italy,Outside Hitter,Men,France,2022-06-08,Pool,0,3,0,0,0,0,0,0,0,0,0,0,0,0,0,0,0,0,0,0,0,0,0,0,0,0,0
Alessandro PICCINELLI,Italy,Libero,Men,France,2022-06-08,Pool,0,3,0,0,0,0,0,0,0,0,0,0,0,0,0,1,1,9,11,8,0,3,11,0,0,13,13
Leonardo SCANFERLA,Italy,Libero,Men,France,2022-06-08,Pool,0,3,0,0,0,0,0,0,0,0,0,0,0,0,0,0,0,0,0,1,0,0,1,0,0,1,1
Marco VITELLI,Italy,Middle Blocker,Men,France,2022-06-08,Pool,0,3,1,1,0,0,1,0,1,2,3,0,1,1,2,0,0,0,0,0,0,2,2,0,0,0,0
Leandro Ausibio MOSCA,Italy,Middle Blocker,Men,France,2022-06-08,Pool,0,3,0,0,0,0,0,0,0,0,0,0,0,0,0,0,0,0,0,0,0,0,0,0,0,0,0
Francesco RECINE,Italy,Outside Hitter,Men,Poland,2022-07-24,Finals (Bronze),0,3,0,0,0,0,0,0,0,0,0,0,0,0,0,0,0,0,0,0,0,0,0,0,0,0,0
Alessandro MICHIELETTO,Italy,Outside Hitter,Men,Poland,2022-07-24,Finals (Bronze),0,3,5,3,4,7,14,1,2,3,6,1,3,7,11,1,3,8,12,2,2,0,4,0,0,4,4
Simone GIANNELLI,Italy,Setter,Men,Poland,2022-07-24,Finals (Bronze),0,3,1,1,0,3,4,0,6,2,8,0,1,7,8,0,0,0,0,8,1,0,9,9,0,60,69
Fabio BALASO,Italy,Libero,Men,Poland,2022-07-24,Finals (Bronze),0,3,0,0,0,0,0,0,0,0,0,0,0,0,0,3,6,10,19,13,3,2,18,0,0,7,7
Riccardo SBERTOLI,Italy,Setter,Men,Poland,2022-07-24,Finals (Bronze),0,3,0,0,0,0,0,0,0,0,0,0,1,3,4,0,0,0,0,0,0,0,0,0,0,0,0
Ivan ZAYTSEV,Italy,Outside Hitter,Men,Poland,2022-07-24,Finals (Bronze),0,3,0,0,0,0,0,0,0,0,0,0,0,0,0,0,0,0,0,0,0,0,0,0,0,0,0
Mattia BOTTOLO,Italy,Outside Hitter,Men,Poland,2022-07-24,Finals (Bronze),0,3,0,0,0,0,0,0,0,0,0,0,0,0,0,0,0,0,0,0,0,0,0,0,0,0,0
Lorenzo CORTESIA,Italy,Middle Blocker,Men,Poland,2022-07-24,Finals (Bronze),0,3,0,0,0,0,0,0,0,0,0,0,0,0,0,0,0,0,0,0,0,0,0,0,0,0,0
Gianluca GALASSI,Italy,Middle Blocker,Men,Poland,2022-07-24,Finals (Bronze),0,3,3,2,1,3,6,1,1,4,6,0,2,2,4,0,0,1,1,0,0,0,0,0,0,1,1
Daniele LAVIA,Italy,Outside Hitter,Men,Poland,2022-07-24,Finals (Bronze),0,3,14,14,3,16,33,0,0,1,1,0,1,10,11,6,0,14,20,6,4,0,10,1,0,4,5
Yuri ROMANÒ,Italy,Opposite Spiker,Men,Poland,2022-07-24,Finals (Bronze),0,3,12,12,5,11,28,0,1,0,1,0,4,8,12,0,1,1,2,4,1,0,5,0,0,1,1
Simone ANZANI,Italy,Middle Blocker,Men,Poland,2022-07-24,Finals (Bronze),0,3,1,1,0,5,6,0,6,2,8,0,0,8,8,0,0,0,0,2,0,0,2,0,0,0,0
Roberto RUSSO,Italy,Middle Blocker,Men,Poland,2022-07-24,Finals (Bronze),0,3,0,0,1,0,1,0,1,2,3,0,0,2,2,0,0,0,0,2,0,0,2,0,0,1,1
Leonardo SCANFERLA,Italy,Libero,Men,Poland,2022-07-24,Finals (Bronze),0,3,0,0,0,0,0,0,0,0,0,0,0,0,0,0,0,3,3,1,1,0,2,0,0,0,0
Francesco RECINE,Italy,Outside Hitter,Men,France,2022-07-23,Semifinals,0,3,0,0,0,2,2,0,0,0,0,0,1,1,2,1,1,1,3,1,0,0,1,0,0,0,0
Alessandro MICHIELETTO,Italy,Outside Hitter,Men,France,2022-07-23,Semifinals,0,3,10,9,2,4,15,0,3,2,5,1,1,11,13,11,3,6,20,3,5,0,8,0,0,1,1
Simone GIANNELLI,Italy,Setter,Men,France,2022-07-23,Semifinals,0,3,0,0,0,1,1,0,4,1,5,0,0,11,11,0,0,1,1,3,2,0,5,14,0,38,52
Fabio BALASO,Italy,Libero,Men,France,2022-07-23,Semifinals,0,3,0,0,0,0,0,0,0,0,0,0,0,0,0,6,1,11,18,7,2,1,10,0,0,4,4
Riccardo SBERTOLI,Italy,Setter,Men,France,2022-07-23,Semifinals,0,3,0,0,0,0,0,0,2,0,2,0,0,2,2,0,0,0,0,0,0,0,0,5,0,8,13
Ivan ZAYTSEV,Italy,Outside Hitter,Men,France,2022-07-23,Semifinals,0,3,5,5,2,2,9,0,2,1,3,0,1,1,2,1,1,1,3,0,1,0,1,0,0,1,1
Mattia BOTTOLO,Italy,Outside Hitter,Men,France,2022-07-23,Semifinals,0,3,0,0,1,1,2,0,0,0,0,0,0,1,1,1,1,1,3,0,2,0,2,0,0,1,1
Lorenzo CORTESIA,Italy,Middle Blocker,Men,France,2022-07-23,Semifinals,0,3,0,0,0,0,0,0,0,0,0,0,0,0,0,0,0,0,0,0,0,0,0,0,0,0,0
Gianluca GALASSI,Italy,Middle Blocker,Men,France,2022-07-23,Semifinals,0,3,6,5,0,1,6,0,2,4,6,1,2,5,8,0,0,0,0,0,0,0,0,0,0,0,0
Daniele LAVIA,Italy,Outside Hitter,Men,France,2022-07-23,Semifinals,0,3,6,4,2,11,17,2,3,1,6,0,0,6,6,0,4,5,9,2,1,0,3,0,0,1,1
Yuri ROMANÒ,Italy,Opposite Spiker,Men,France,2022-07-23,Semifinals,0,3,6,6,1,8,15,0,1,0,1,0,3,2,5,0,0,0,0,6,1,0,7,0,0,0,0
Simone ANZANI,Italy,Middle Blocker,Men,France,2022-07-23,Semifinals,0,3,1,0,0,0,0,1,2,1,4,0,0,1,1,0,0,0,0,1,0,0,1,0,0,0,0
Roberto RUSSO,Italy,Middle Blocker,Men,France,2022-07-23,Semifinals,0,3,3,3,1,2,6,0,4,0,4,0,1,7,8,0,0,0,0,1,0,0,1,0,0,0,0
Leonardo SCANFERLA,Italy,Libero,Men,France,2022-07-23,Semifinals,0,3,0,0,0,0,0,0,0,0,0,0,0,0,0,0,0,0,0,0,0,0,0,0,0,0,0
Francesco RECINE,Italy,Outside Hitter,Men,Netherlands,2022-07-20,Quarterfinals,3,4,0,0,0,0,0,0,0,0,0,0,0,0,0,0,0,0,0,0,0,0,0,0,0,0,0
Alessandro MICHIELETTO,Italy,Outside Hitter,Men,Netherlands,2022-07-20,Quarterfinals,3,4,12,10,5,10,25,1,4,5,10,1,2,11,14,3,0,14,17,2,3,1,6,0,0,3,3
Simone GIANNELLI,Italy,Setter,Men,Netherlands,2022-07-20,Quarterfinals,3,4,3,1,0,1,2,2,7,2,11,0,1,20,21,0,0,2,2,5,1,1,7,16,1,67,84
Fabio BALASO,Italy,Libero,Men,Netherlands,2022-07-20,Quarterfinals,3,4,0,0,0,0,0,0,0,0,0,0,0,0,0,3,3,18,24,15,1,0,16,0,0,4,4
Riccardo SBERTOLI,Italy,Setter,Men,Netherlands,2022-07-20,Quarterfinals,3,4,0,0,0,0,0,0,0,0,0,0,0,0,0,0,0,0,0,0,0,0,0,0,0,0,0
Ivan ZAYTSEV,Italy,Outside Hitter,Men,Netherlands,2022-07-20,Quarterfinals,3,4,1,1,0,0,1,0,0,0,0,0,1,1,2,0,0,0,0,2,0,0,2,0,0,0,0
Mattia BOTTOLO,Italy,Outside Hitter,Men,Netherlands,2022-07-20,Quarterfinals,3,4,0,0,0,0,0,0,0,0,0,0,0,0,0,0,1,0,1,0,0,0,0,0,0,0,0
Lorenzo CORTESIA,Italy,Middle Blocker,Men,Netherlands,2022-07-20,Quarterfinals,3,4,0,0,0,0,0,0,0,0,0,0,0,0,0,0,0,0,0,0,0,0,0,0,0,0,0
Gianluca GALASSI,Italy,Middle Blocker,Men,Netherlands,2022-07-20,Quarterfinals,3,4,7,4,0,3,7,2,2,2,6,1,0,2,3,0,0,0,0,1,0,0,1,0,0,0,0
Daniele LAVIA,Italy,Outside Hitter,Men,Netherlands,2022-07-20,Quarterfinals,3,4,13,10,1,12,23,2,5,0,7,1,1,14,16,6,2,9,17,10,1,1,12,1,0,2,3
Yuri ROMANÒ,Italy,Opposite Spiker,Men,Netherlands,2022-07-20,Quarterfinals,3,4,16,12,6,8,26,0,7,5,12,4,0,12,16,0,0,1,1,1,2,0,3,0,0,1,1
Simone ANZANI,Italy,Middle Blocker,Men,Netherlands,2022-07-20,Quarterfinals,3,4,2,0,1,1,2,2,1,2,5,0,1,4,5,0,0,0,0,0,1,0,1,0,0,0,0
Roberto RUSSO,Italy,Middle Blocker,Men,Netherlands,2022-07-20,Quarterfinals,3,4,12,9,0,2,11,3,9,1,13,0,1,17,18,1,0,0,1,2,1,0,3,0,0,0,0
Leonardo SCANFERLA,Italy,Libero,Men,Netherlands,2022-07-20,Quarterfinals,3,4,0,0,0,0,0,0,0,0,0,0,0,0,0,0,0,0,0,0,0,0,0,0,0,0,0
Oreste CAVUTO,Italy,Outside Hitter,Men,Netherlands,2022-07-10,Pool,3,3,0,0,0,0,0,0,0,0,0,0,0,0,0,0,0,0,0,0,0,0,0,0,0,0,0
Alessandro MICHIELETTO,Italy,Outside Hitter,Men,Netherlands,2022-07-10,Pool,3,3,14,9,4,5,18,2,3,0,5,3,2,12,17,0,0,15,15,1,1,0,2,0,0,0,0
Simone GIANNELLI,Italy,Setter,Men,Netherlands,2022-07-10,Pool,3,3,1,1,0,0,1,0,2,0,2,0,4,9,13,0,0,1,1,1,0,0,1,11,0,58,69
Fabio BALASO,Italy,Libero,Men,Netherlands,2022-07-10,Pool,3,3,0,0,0,0,0,0,0,0,0,0,0,0,0,0,0,0,0,0,0,0,0,0,0,0,0
Riccardo SBERTOLI,Italy,Setter,Men,Netherlands,2022-07-10,Pool,3,3,0,0,0,0,0,0,0,0,0,0,0,3,3,0,0,0,0,0,0,0,0,0,0,4,4
Ivan ZAYTSEV,Italy,Outside Hitter,Men,Netherlands,2022-07-10,Pool,3,3,11,11,5,8,24,0,4,0,4,0,4,7,11,0,0,2,2,2,1,0,3,0,0,0,0
Mattia BOTTOLO,Italy,Outside Hitter,Men,Netherlands,2022-07-10,Pool,3,3,0,0,0,0,0,0,0,0,0,0,0,0,0,0,0,0,0,0,0,0,0,0,0,0,0
Lorenzo CORTESIA,Italy,Middle Blocker,Men,Netherlands,2022-07-10,Pool,3,3,0,0,0,0,0,0,0,0,0,0,0,0,0,0,0,0,0,0,0,0,0,0,0,0,0
Gianluca GALASSI,Italy,Middle Blocker,Men,Netherlands,2022-07-10,Pool,3,3,6,3,0,2,5,2,2,0,4,1,2,2,5,0,0,0,0,0,0,0,0,0,0,0,0
Daniele LAVIA,Italy,Outside Hitter,Men,Netherlands,2022-07-10,Pool,3,3,15,15,3,7,25,0,2,0,2,0,0,15,15,0,3,11,14,2,1,0,3,0,0,0,0
Yuri ROMANÒ,Italy,Opposite Spiker,Men,Netherlands,2022-07-10,Pool,3,3,0,0,0,0,0,0,0,0,0,0,0,0,0,0,0,0,0,0,0,0,0,0,0,0,0
Simone ANZANI,Italy,Middle Blocker,Men,Netherlands,2022-07-10,Pool,3,3,5,3,0,0,3,2,1,0,3,0,0,7,7,0,0,1,1,0,0,0,0,0,0,0,0
Roberto RUSSO,Italy,Middle Blocker,Men,Netherlands,2022-07-10,Pool,3,3,2,2,0,0,2,0,3,1,4,0,1,3,4,0,0,0,0,0,0,0,0,0,0,0,0
Leonardo SCANFERLA,Italy,Libero,Men,Netherlands,2022-07-10,Pool,3,3,0,0,0,0,0,0,0,0,0,0,0,0,0,0,1,15,16,8,1,0,9,0,0,1,1
Oreste CAVUTO,Italy,Outside Hitter,Men,Serbia,2022-07-08,Pool,3,3,0,0,0,0,0,0,0,0,0,0,0,0,0,0,0,0,0,0,0,0,0,0,0,0,0
Alessandro MICHIELETTO,Italy,Outside Hitter,Men,Serbia,2022-07-08,Pool,3,3,7,7,4,6,17,0,3,0,3,0,1,14,15,2,0,6,8,5,0,1,6,0,0,0,0
Simone GIANNELLI,Italy,Setter,Men,Serbia,2022-07-08,Pool,3,3,5,2,0,2,4,3,1,0,4,0,1,9,10,0,0,0,0,0,2,0,2,13,0,51,64
Fabio BALASO,Italy,Libero,Men,Serbia,2022-07-08,Pool,3,3,0,0,0,0,0,0,0,0,0,0,0,0,0,2,1,4,7,3,0,0,3,0,0,0,0
Riccardo SBERTOLI,Italy,Setter,Men,Serbia,2022-07-08,Pool,3,3,0,0,0,0,0,0,0,0,0,0,0,0,0,0,0,0,0,0,0,0,0,1,1,5,7
Ivan ZAYTSEV,Italy,Outside Hitter,Men,Serbia,2022-07-08,Pool,3,3,0,0,0,0,0,0,0,0,0,0,0,0,0,0,0,0,0,0,0,0,0,0,0,0,0
Mattia BOTTOLO,Italy,Outside Hitter,Men,Serbia,2022-07-08,Pool,3,3,0,0,0,0,0,0,0,0,0,0,0,0,0,0,0,0,0,0,0,0,0,0,0,0,0
Lorenzo CORTESIA,Italy,Middle Blocker,Men,Serbia,2022-07-08,Pool,3,3,5,3,0,4,7,2,5,0,7,0,0,3,3,0,0,0,0,0,1,0,1,0,0,0,0
Gianluca GALASSI,Italy,Middle Blocker,Men,Serbia,2022-07-08,Pool,3,3,6,3,0,2,5,3,3,0,6,0,2,4,6,0,0,0,0,0,0,0,0,0,0,1,1
Daniele LAVIA,Italy,Outside Hitter,Men,Serbia,2022-07-08,Pool,3,3,10,7,3,7,17,1,1,0,2,2,1,15,18,5,1,26,32,1,1,1,3,0,0,0,0
Yuri ROMANÒ,Italy,Opposite Spiker,Men,Serbia,2022-07-08,Pool,3,3,13,9,3,7,19,1,2,0,3,3,3,8,14,0,0,0,0,1,0,0,1,0,0,1,1
Simone ANZANI,Italy,Middle Blocker,Men,Serbia,2022-07-08,Pool,3,3,0,0,0,0,0,0,0,0,0,0,0,0,0,0,0,0,0,0,0,0,0,0,0,0,0
Roberto RUSSO,Italy,Middle Blocker,Men,Serbia,2022-07-08,Pool,3,3,10,5,0,3,8,4,4,0,8,1,2,5,8,0,0,0,0,0,0,0,0,0,0,0,0
Leonardo SCANFERLA,Italy,Libero,Men,Serbia,2022-07-08,Pool,3,3,0,0,0,0,0,0,0,0,0,0,0,0,0,0,0,4,4,0,0,2,2,0,0,0,0
Oreste CAVUTO,Italy,Outside Hitter,Men,Iran,2022-07-07,Pool,3,4,0,0,0,0,0,0,0,0,0,0,0,0,0,0,0,0,0,0,0,0,0,0,0,0,0
Alessandro MICHIELETTO,Italy,Outside Hitter,Men,Iran,2022-07-07,Pool,3,4,11,11,1,10,22,0,2,0,2,0,0,19,19,3,2,23,28,4,1,0,5,0,0,0,0
Simone GIANNELLI,Italy,Setter,Men,Iran,2022-07-07,Pool,3,4,7,2,1,1,4,2,3,0,5,3,2,11,16,0,0,2,2,2,2,0,4,26,0,70,96
Fabio BALASO,Italy,Libero,Men,Iran,2022-07-07,Pool,3,4,0,0,0,0,0,0,0,0,0,0,0,0,0,7,1,12,20,5,3,1,9,0,0,4,4
Riccardo SBERTOLI,Italy,Setter,Men,Iran,2022-07-07,Pool,3,4,0,0,0,0,0,0,0,0,0,0,1,1,2,0,0,0,0,0,0,0,0,0,0,1,1
Ivan ZAYTSEV,Italy,Outside Hitter,Men,Iran,2022-07-07,Pool,3,4,17,14,5,11,30,2,2,0,4,1,5,9,15,0,0,3,3,3,0,2,5,0,0,1,1
Mattia BOTTOLO,Italy,Outside Hitter,Men,Iran,2022-07-07,Pool,3,4,4,2,3,5,10,0,0,0,0,2,2,4,8,1,1,6,8,2,0,0,2,0,0,1,1
Lorenzo CORTESIA,Italy,Middle Blocker,Men,Iran,2022-07-07,Pool,3,4,0,0,0,0,0,0,0,0,0,0,0,0,0,0,0,0,0,0,0,0,0,0,0,0,0
Gianluca GALASSI,Italy,Middle Blocker,Men,Iran,2022-07-07,Pool,3,4,13,9,0,1,10,2,3,0,5,2,2,13,17,0,0,0,0,0,0,0,0,0,0,0,0
Daniele LAVIA,Italy,Outside Hitter,Men,Iran,2022-07-07,Pool,3,4,11,11,5,8,24,0,3,0,3,0,2,8,10,2,4,6,12,2,1,0,3,0,0,1,1
Yuri ROMANÒ,Italy,Opposite Spiker,Men,Iran,2022-07-07,Pool,3,4,0,0,0,0,0,0,0,0,0,0,0,0,0,0,0,0,0,0,0,0,0,0,0,0,0
Simone ANZANI,Italy,Middle Blocker,Men,Iran,2022-07-07,Pool,3,4,10,6,1,2,9,4,5,0,9,0,2,10,12,0,0,0,0,1,0,1,2,0,0,0,0
Roberto RUSSO,Italy,Middle Blocker,Men,Iran,2022-07-07,Pool,3,4,0,0,0,0,0,0,0,0,0,0,0,0,0,0,0,0,0,0,0,0,0,0,0,0,0
Leonardo SCANFERLA,Italy,Libero,Men,Iran,2022-07-07,Pool,3,4,0,0,0,0,0,0,0,0,0,0,0,0,0,0,0,0,0,1,1,1,3,0,0,0,0
Oreste CAVUTO,Italy,Outside Hitter,Men,Bulgaria,2022-07-05,Pool,3,3,0,0,0,0,0,0,0,0,0,0,0,0,0,0,0,0,0,0,0,0,0,0,0,0,0
Alessandro MICHIELETTO,Italy,Outside Hitter,Men,Bulgaria,2022-07-05,Pool,3,3,12,10,1,9,20,1,0,0,1,1,1,13,15,5,0,19,24,2,0,1,3,0,0,3,3
Simone GIANNELLI,Italy,Setter,Men,Bulgaria,2022-07-05,Pool,3,3,7,2,0,0,2,2,1,0,3,3,1,10,14,0,0,1,1,2,0,0,2,7,1,51,59
Fabio BALASO,Italy,Libero,Men,Bulgaria,2022-07-05,Pool,3,3,0,0,0,0,0,0,0,0,0,0,0,0,0,1,1,11,13,3,3,1,7,0,0,4,4
Riccardo SBERTOLI,Italy,Setter,Men,Bulgaria,2022-07-05,Pool,3,3,0,0,0,0,0,0,0,0,0,0,0,1,1,0,0,0,0,0,0,0,0,0,0,0,0
Ivan ZAYTSEV,Italy,Outside Hitter,Men,Bulgaria,2022-07-05,Pool,3,3,0,0,0,0,0,0,0,0,0,0,0,0,0,0,0,0,0,0,0,0,0,0,0,0,0
Mattia BOTTOLO,Italy,Outside Hitter,Men,Bulgaria,2022-07-05,Pool,3,3,0,0,0,0,0,0,0,0,0,0,0,0,0,0,0,0,0,0,0,0,0,0,0,0,0
Lorenzo CORTESIA,Italy,Middle Blocker,Men,Bulgaria,2022-07-05,Pool,3,3,0,0,0,0,0,0,0,0,0,0,0,0,0,0,0,0,0,0,0,0,0,0,0,0,0
Gianluca GALASSI,Italy,Middle Blocker,Men,Bulgaria,2022-07-05,Pool,3,3,0,0,0,0,0,0,0,0,0,0,0,4,4,0,0,0,0,0,0,1,1,0,0,0,0
Daniele LAVIA,Italy,Outside Hitter,Men,Bulgaria,2022-07-05,Pool,3,3,12,10,1,7,18,2,3,1,6,0,1,11,12,1,0,8,9,3,1,2,6,0,0,0,0
Yuri ROMANÒ,Italy,Opposite Spiker,Men,Bulgaria,2022-07-05,Pool,3,3,13,10,3,7,20,2,2,0,4,1,3,8,12,0,0,0,0,0,0,0,0,0,0,1,1
Simone ANZANI,Italy,Middle Blocker,Men,Bulgaria,2022-07-05,Pool,3,3,3,2,0,2,4,1,2,0,3,0,1,5,6,0,1,0,1,1,0,0,1,0,0,0,0
Roberto RUSSO,Italy,Middle Blocker,Men,Bulgaria,2022-07-05,Pool,3,3,7,3,0,3,6,3,5,0,8,1,2,7,10,0,0,0,0,0,0,0,0,0,0,1,1
Leonardo SCANFERLA,Italy,Libero,Men,Bulgaria,2022-07-05,Pool,3,3,0,0,0,0,0,0,0,0,0,0,0,0,0,0,0,0,0,0,0,0,0,0,0,0,0
Yuji NISHIDA,Japan,Opposite Spiker,Men,France,2022-07-21,Quarterfinals,0,3,8,6,5,11,22,0,3,1,4,2,5,4,11,0,0,0,0,3,4,0,7,0,0,0,0
Taishi ONODERA,Japan,Middle Blocker,Men,France,2022-07-21,Quarterfinals,0,3,7,5,0,1,6,1,3,1,5,1,2,10,13,0,0,1,1,1,1,0,2,0,0,1,1
Tatsunori OTSUKA,Japan,Outside Hitter,Men,France,2022-07-21,Quarterfinals,0,3,5,5,4,5,14,0,3,1,4,0,1,6,7,2,0,12,14,2,3,0,5,0,0,2,2
Akihiro YAMAUCHI,Japan,Middle Blocker,Men,France,2022-07-21,Quarterfinals,0,3,7,5,2,1,8,2,4,1,7,0,1,8,9,0,0,0,0,3,1,0,4,0,0,1,1
Kenta TAKANASHI,Japan,Outside Hitter,Men,France,2022-07-21,Quarterfinals,0,3,3,3,2,7,12,0,2,0,2,0,3,1,4,2,1,4,7,0,1,1,2,0,0,5,5
Masahiro SEKITA,Japan,Setter,Men,France,2022-07-21,Quarterfinals,0,3,0,0,0,1,1,0,0,0,0,0,0,8,8,0,1,0,1,6,3,0,9,10,0,41,51
Masaki OYA,Japan,Setter,Men,France,2022-07-21,Quarterfinals,0,3,0,0,0,0,0,0,0,0,0,0,0,0,0,0,0,1,1,0,1,1,2,4,0,5,9
Kentaro TAKAHASHI,Japan,Middle Blocker,Men,France,2022-07-21,Quarterfinals,0,3,0,0,0,0,0,0,0,0,0,0,0,0,0,0,0,0,0,0,0,0,0,0,0,0,0
Ran TAKAHASHI,Japan,Outside Hitter,Men,France,2022-07-21,Quarterfinals,0,3,4,3,2,1,6,0,0,0,0,1,2,4,7,8,1,12,21,1,1,0,2,0,0,0,0
Tomohiro OGAWA,Japan,Libero,Men,France,2022-07-21,Quarterfinals,0,3,0,0,0,0,0,0,0,0,0,0,0,0,0,0,0,0,0,0,0,0,0,0,0,0,0
Kento MIYAURA,Japan,Opposite Spiker,Men,France,2022-07-21,Quarterfinals,0,3,3,3,0,1,4,0,0,0,0,0,1,2,3,0,0,0,0,0,0,0,0,0,0,1,1
Tomohiro YAMAMOTO,Japan,Libero,Men,France,2022-07-21,Quarterfinals,0,3,0,0,0,0,0,0,0,0,0,0,0,0,0,3,0,6,9,6,0,0,6,0,0,3,3
Go MURAYAMA,Japan,Middle Blocker,Men,France,2022-07-21,Quarterfinals,0,3,0,0,0,0,0,0,0,0,0,0,0,0,0,0,0,0,0,0,0,0,0,0,0,0,0
Yuji NISHIDA,Japan,Opposite Spiker,Men,Brazil,2022-07-10,Pool,0,3,17,15,6,8,29,1,2,2,5,1,6,6,13,1,0,0,1,0,0,2,2,0,0,0,0
Taishi ONODERA,Japan,Middle Blocker,Men,Brazil,2022-07-10,Pool,0,3,3,3,1,3,7,0,1,3,4,0,1,8,9,0,0,3,3,3,4,3,10,0,0,0,0
Tatsunori OTSUKA,Japan,Outside Hitter,Men,Brazil,2022-07-10,Pool,0,3,5,3,1,3,7,1,0,1,2,1,0,8,9,3,0,11,14,4,0,0,4,0,0,2,2
Akihiro YAMAUCHI,Japan,Middle Blocker,Men,Brazil,2022-07-10,Pool,0,3,3,3,2,3,8,0,3,2,5,0,1,8,9,0,0,1,1,1,1,0,2,0,0,0,0
Kenta TAKANASHI,Japan,Outside Hitter,Men,Brazil,2022-07-10,Pool,0,3,1,1,0,0,1,0,0,0,0,0,0,0,0,0,0,0,0,1,0,0,1,0,0,2,2
Masahiro SEKITA,Japan,Setter,Men,Brazil,2022-07-10,Pool,0,3,0,0,0,0,0,0,0,3,3,0,1,9,10,0,1,0,1,3,4,2,9,29,0,40,69
Masaki OYA,Japan,Setter,Men,Brazil,2022-07-10,Pool,0,3,0,0,0,0,0,0,0,0,0,0,0,0,0,0,0,0,0,0,0,1,1,1,0,1,2
Kentaro TAKAHASHI,Japan,Middle Blocker,Men,Brazil,2022-07-10,Pool,0,3,0,0,0,0,0,0,0,0,0,0,0,0,0,0,0,0,0,0,0,0,0,0,0,0,0
Ran TAKAHASHI,Japan,Outside Hitter,Men,Brazil,2022-07-10,Pool,0,3,3,3,3,5,11,0,1,0,1,0,3,5,8,2,1,9,12,1,2,1,4,0,0,0,0
Tomohiro OGAWA,Japan,Libero,Men,Brazil,2022-07-10,Pool,0,3,0,0,0,0,0,0,0,0,0,0,0,0,0,0,0,0,0,0,0,0,0,0,0,0,0
Yuki ISHIKAWA,Japan,Outside Hitter,Men,Brazil,2022-07-10,Pool,0,3,14,12,2,3,17,1,3,2,6,1,2,9,12,8,1,8,17,3,4,0,7,0,0,6,6
Kento MIYAURA,Japan,Opposite Spiker,Men,Brazil,2022-07-10,Pool,0,3,0,0,0,0,0,0,0,0,0,0,0,0,0,0,0,0,0,0,0,0,0,0,0,0,0
Tomohiro YAMAMOTO,Japan,Libero,Men,Brazil,2022-07-10,Pool,0,3,0,0,0,0,0,0,0,0,0,0,0,0,0,4,1,6,11,8,2,2,12,0,0,0,0
Go MURAYAMA,Japan,Middle Blocker,Men,Brazil,2022-07-10,Pool,0,3,0,0,0,0,0,0,0,0,0,0,0,0,0,0,0,0,0,0,0,0,0,0,0,0,0
Yuji NISHIDA,Japan,Opposite Spiker,Men,Germany,2022-07-09,Pool,3,4,1,0,0,1,1,1,0,0,1,0,0,1,1,0,0,0,0,0,1,0,1,0,0,0,0
Taishi ONODERA,Japan,Middle Blocker,Men,Germany,2022-07-09,Pool,3,4,6,5,0,3,8,1,5,6,12,0,4,13,17,1,0,1,2,2,0,0,2,0,0,1,1
Tatsunori OTSUKA,Japan,Outside Hitter,Men,Germany,2022-07-09,Pool,3,4,0,0,0,0,0,0,0,0,0,0,0,0,0,0,0,0,0,0,0,0,0,0,0,0,0
Akihiro YAMAUCHI,Japan,Middle Blocker,Men,Germany,2022-07-09,Pool,3,4,0,0,0,0,0,0,0,0,0,0,0,0,0,0,0,0,0,0,0,0,0,0,0,0,0
Kenta TAKANASHI,Japan,Outside Hitter,Men,Germany,2022-07-09,Pool,3,4,16,14,4,3,21,2,6,6,14,0,4,7,11,3,1,16,20,4,3,1,8,0,0,5,5
Masahiro SEKITA,Japan,Setter,Men,Germany,2022-07-09,Pool,3,4,0,0,0,0,0,0,0,0,0,0,0,0,0,0,0,0,0,0,0,0,0,0,0,4,4
Masaki OYA,Japan,Setter,Men,Germany,2022-07-09,Pool,3,4,0,0,1,0,1,0,1,8,9,0,0,13,13,0,0,0,0,6,3,2,11,16,1,54,71
Kentaro TAKAHASHI,Japan,Middle Blocker,Men,Germany,2022-07-09,Pool,3,4,10,4,0,2,6,6,3,4,13,0,2,12,14,0,0,1,1,3,3,0,6,0,0,1,1
Ran TAKAHASHI,Japan,Outside Hitter,Men,Germany,2022-07-09,Pool,3,4,14,13,4,6,23,0,4,3,7,1,4,14,19,3,0,21,24,6,1,0,7,0,0,5,5
Tomohiro OGAWA,Japan,Libero,Men,Germany,2022-07-09,Pool,3,4,0,0,0,0,0,0,0,0,0,0,0,0,0,4,1,12,17,4,2,1,7,0,0,4,4
Yuki ISHIKAWA,Japan,Outside Hitter,Men,Germany,2022-07-09,Pool,3,4,1,0,0,0,0,0,0,0,0,1,1,2,4,0,0,0,0,0,0,0,0,0,0,0,0
Kento MIYAURA,Japan,Opposite Spiker,Men,Germany,2022-07-09,Pool,3,4,17,15,7,10,32,0,1,3,4,2,5,10,17,0,0,0,0,7,3,0,10,0,0,0,0
Tomohiro YAMAMOTO,Japan,Libero,Men,Germany,2022-07-09,Pool,3,4,0,0,0,0,0,0,0,0,0,0,0,0,0,0,0,0,0,0,0,0,0,0,0,0,0
Go MURAYAMA,Japan,Middle Blocker,Men,Germany,2022-07-09,Pool,3,4,1,1,0,0,1,0,0,0,0,0,0,1,1,0,0,0,0,1,0,0,1,0,0,1,1
Yuji NISHIDA,Japan,Opposite Spiker,Men,Canada,2022-07-08,Pool,3,4,18,16,2,11,29,1,5,3,9,1,6,8,15,0,0,0,0,5,5,2,12,0,0,0,0
Taishi ONODERA,Japan,Middle Blocker,Men,Canada,2022-07-08,Pool,3,4,10,9,1,2,12,1,4,2,7,0,0,10,10,1,1,2,4,2,2,0,4,0,0,1,1
Tatsunori OTSUKA,Japan,Outside Hitter,Men,Canada,2022-07-08,Pool,3,4,9,8,0,12,20,0,5,1,6,1,2,13,16,7,3,11,21,4,3,3,10,0,0,2,2
Akihiro YAMAUCHI,Japan,Middle Blocker,Men,Canada,2022-07-08,Pool,3,4,8,5,1,3,9,2,5,7,14,1,1,12,14,0,0,2,2,0,0,2,2,0,0,0,0
Kenta TAKANASHI,Japan,Outside Hitter,Men,Canada,2022-07-08,Pool,3,4,0,0,0,0,0,0,0,0,0,0,0,0,0,0,0,0,0,0,0,0,0,0,0,0,0
Masahiro SEKITA,Japan,Setter,Men,Canada,2022-07-08,Pool,3,4,1,1,0,1,2,0,1,7,8,0,2,16,18,0,0,0,0,12,3,4,19,29,0,48,77
Masaki OYA,Japan,Setter,Men,Canada,2022-07-08,Pool,3,4,0,0,0,0,0,0,0,0,0,0,0,0,0,0,0,0,0,1,0,0,1,1,0,2,3
Kentaro TAKAHASHI,Japan,Middle Blocker,Men,Canada,2022-07-08,Pool,3,4,1,0,1,0,1,1,0,0,1,0,0,1,1,0,0,0,0,1,0,0,1,0,0,0,0
Ran TAKAHASHI,Japan,Outside Hitter,Men,Canada,2022-07-08,Pool,3,4,0,0,0,0,0,0,0,0,0,0,0,0,0,0,0,1,1,0,0,0,0,0,0,0,0
Tomohiro OGAWA,Japan,Libero,Men,Canada,2022-07-08,Pool,3,4,0,0,0,0,0,0,0,0,0,0,0,0,0,0,0,0,0,0,0,0,0,0,0,0,0
Yuki ISHIKAWA,Japan,Outside Hitter,Men,Canada,2022-07-08,Pool,3,4,19,15,3,12,30,0,3,3,6,4,4,12,20,4,2,10,16,7,1,2,10,1,0,5,6
Kento MIYAURA,Japan,Opposite Spiker,Men,Canada,2022-07-08,Pool,3,4,0,0,0,2,2,0,0,0,0,0,0,2,2,0,0,0,0,0,0,0,0,0,0,0,0
Tomohiro YAMAMOTO,Japan,Libero,Men,Canada,2022-07-08,Pool,3,4,0,0,0,0,0,0,0,0,0,0,0,0,0,10,2,9,21,7,0,5,12,2,0,9,11
Go MURAYAMA,Japan,Middle Blocker,Men,Canada,2022-07-08,Pool,3,4,0,0,0,0,0,0,0,0,0,0,0,0,0,0,0,0,0,0,0,0,0,0,0,0,0
Yuji NISHIDA,Japan,Opposite Spiker,Men,Australia,2022-07-06,Pool,3,4,24,17,4,1,22,1,2,3,6,6,7,8,21,0,0,0,0,4,1,0,5,0,0,0,0
Taishi ONODERA,Japan,Middle Blocker,Men,Australia,2022-07-06,Pool,3,4,0,0,0,0,0,0,0,0,0,0,1,7,8,0,0,0,0,0,0,0,0,0,0,0,0
Tatsunori OTSUKA,Japan,Outside Hitter,Men,Australia,2022-07-06,Pool,3,4,11,11,2,6,19,0,2,1,3,0,0,13,13,9,0,14,23,2,3,1,6,1,0,1,2
Akihiro YAMAUCHI,Japan,Middle Blocker,Men,Australia,2022-07-06,Pool,3,4,7,7,0,5,12,0,7,1,8,0,2,14,16,0,0,0,0,2,1,1,4,1,0,0,1
Kenta TAKANASHI,Japan,Outside Hitter,Men,Australia,2022-07-06,Pool,3,4,0,0,0,0,0,0,0,0,0,0,0,0,0,0,0,0,0,0,0,0,0,0,0,0,0
Masahiro SEKITA,Japan,Setter,Men,Australia,2022-07-06,Pool,3,4,3,1,0,0,1,0,2,2,4,2,0,10,12,0,0,1,1,4,2,2,8,31,0,41,72
Masaki OYA,Japan,Setter,Men,Australia,2022-07-06,Pool,3,4,0,0,0,0,0,0,0,0,0,0,0,0,0,0,0,0,0,1,0,0,1,5,1,4,10
Kentaro TAKAHASHI,Japan,Middle Blocker,Men,Australia,2022-07-06,Pool,3,4,14,12,0,4,16,2,5,8,15,0,1,6,7,0,0,0,0,1,0,2,3,0,0,0,0
Ran TAKAHASHI,Japan,Outside Hitter,Men,Australia,2022-07-06,Pool,3,4,0,0,0,0,0,0,0,0,0,0,0,0,0,0,0,0,0,0,0,0,0,0,0,0,0
Tomohiro OGAWA,Japan,Libero,Men,Australia,2022-07-06,Pool,3,4,0,0,0,0,0,0,0,0,0,0,0,0,0,0,0,0,0,0,0,0,0,0,0,0,0
Yuki ISHIKAWA,Japan,Outside Hitter,Men,Australia,2022-07-06,Pool,3,4,18,11,2,6,19,2,2,1,5,5,5,9,19,9,1,13,23,4,2,4,10,2,0,4,6
Kento MIYAURA,Japan,Opposite Spiker,Men,Australia,2022-07-06,Pool,3,4,3,2,0,2,4,1,1,1,3,0,0,1,1,0,0,0,0,0,0,0,0,0,0,0,0
Tomohiro YAMAMOTO,Japan,Libero,Men,Australia,2022-07-06,Pool,3,4,0,0,0,0,0,0,0,0,0,0,0,0,0,12,0,8,20,6,5,3,14,1,0,4,5
Go MURAYAMA,Japan,Middle Blocker,Men,Australia,2022-07-06,Pool,3,4,0,0,0,0,0,0,0,0,0,0,0,0,0,0,0,0,0,0,0,0,0,0,0,0,0
Yuji NISHIDA,Japan,Opposite Spiker,Men,Slovenia,2022-06-26,Pool,3,4,12,10,5,10,25,0,6,3,9,2,4,10,16,0,0,0,0,2,2,0,4,0,0,1,1
Taishi ONODERA,Japan,Middle Blocker,Men,Slovenia,2022-06-26,Pool,3,4,0,0,0,0,0,0,0,0,0,0,0,2,2,0,0,0,0,1,0,0,1,0,0,0,0
Tatsunori OTSUKA,Japan,Outside Hitter,Men,Slovenia,2022-06-26,Pool,3,4,13,13,3,6,22,0,0,2,2,0,3,10,13,10,1,26,37,8,2,0,10,0,0,3,3
Akihiro YAMAUCHI,Japan,Middle Blocker,Men,Slovenia,2022-06-26,Pool,3,4,7,5,1,5,11,2,5,5,12,0,3,14,17,0,0,1,1,6,1,0,7,0,0,1,1
Kenta TAKANASHI,Japan,Outside Hitter,Men,Slovenia,2022-06-26,Pool,3,4,0,0,0,0,0,0,0,0,0,0,0,0,0,0,0,0,0,0,0,0,0,0,0,0,0
Masahiro SEKITA,Japan,Setter,Men,Slovenia,2022-06-26,Pool,3,4,2,1,0,1,2,1,2,4,7,0,0,16,16,0,0,2,2,5,2,0,7,20,0,71,91
Masaki OYA,Japan,Setter,Men,Slovenia,2022-06-26,Pool,3,4,0,0,0,0,0,0,0,0,0,0,0,0,0,0,0,0,0,0,0,0,0,0,0,0,0
Kentaro TAKAHASHI,Japan,Middle Blocker,Men,Slovenia,2022-06-26,Pool,3,4,11,9,0,3,12,2,2,5,9,0,3,12,15,0,0,0,0,2,0,1,3,0,0,0,0
Shoma TOMITA,Japan,Outside Hitter,Men,Slovenia,2022-06-26,Pool,3,4,0,0,1,0,1,0,0,0,0,0,0,0,0,0,0,1,1,0,0,0,0,0,0,0,0
Ran TAKAHASHI,Japan,Outside Hitter,Men,Slovenia,2022-06-26,Pool,3,4,0,0,0,0,0,0,0,0,0,0,0,0,0,0,0,0,0,0,0,0,0,0,0,0,0
Tomohiro OGAWA,Japan,Libero,Men,Slovenia,2022-06-26,Pool,3,4,0,0,0,0,0,0,0,0,0,0,0,0,0,0,0,0,0,0,0,0,0,0,0,0,0
Yuki ISHIKAWA,Japan,Outside Hitter,Men,Slovenia,2022-06-26,Pool,3,4,21,17,2,15,34,1,2,0,3,3,4,10,17,7,1,7,15,8,2,2,12,0,0,3,3
Tomohiro YAMAMOTO,Japan,Libero,Men,Slovenia,2022-06-26,Pool,3,4,0,0,0,0,0,0,0,0,0,0,0,0,0,2,0,7,9,11,1,0,12,0,0,3,3
Go MURAYAMA,Japan,Middle Blocker,Men,Slovenia,2022-06-26,Pool,3,4,0,0,0,0,0,0,0,0,0,0,0,0,0,0,0,0,0,0,0,0,0,0,0,0,0
Yuji NISHIDA,Japan,Opposite Spiker,Men,France,2022-06-25,Pool,0,3,0,0,0,0,0,0,0,0,0,0,0,0,0,0,0,0,0,0,0,0,0,0,0,0,0
Taishi ONODERA,Japan,Middle Blocker,Men,France,2022-06-25,Pool,0,3,0,0,0,0,0,0,0,0,0,0,0,0,0,0,0,0,0,0,0,0,0,0,0,0,0
Tatsunori OTSUKA,Japan,Outside Hitter,Men,France,2022-06-25,Pool,0,3,15,15,6,13,34,0,0,3,3,0,2,5,7,0,0,0,0,5,1,1,7,0,1,0,1
Akihiro YAMAUCHI,Japan,Middle Blocker,Men,France,2022-06-25,Pool,0,3,0,0,0,0,0,0,0,0,0,0,0,0,0,0,0,0,0,0,0,0,0,0,0,0,0
Kenta TAKANASHI,Japan,Outside Hitter,Men,France,2022-06-25,Pool,0,3,13,12,5,11,28,1,1,1,3,0,7,4,11,2,4,17,23,6,2,0,8,0,1,2,3
Masahiro SEKITA,Japan,Setter,Men,France,2022-06-25,Pool,0,3,0,0,0,0,0,0,0,0,0,0,0,2,2,0,0,0,0,0,0,0,0,0,0,1,1
Masaki OYA,Japan,Setter,Men,France,2022-06-25,Pool,0,3,4,3,0,1,4,1,1,5,7,0,1,12,13,0,0,1,1,6,2,2,10,16,1,64,81
Kentaro TAKAHASHI,Japan,Middle Blocker,Men,France,2022-06-25,Pool,0,3,6,6,1,2,9,0,6,10,16,0,1,6,7,0,0,0,0,4,0,0,4,0,0,1,1
Shoma TOMITA,Japan,Outside Hitter,Men,France,2022-06-25,Pool,0,3,2,2,1,8,11,0,0,0,0,0,3,7,10,7,0,16,23,10,1,1,12,0,0,3,3
Ran TAKAHASHI,Japan,Outside Hitter,Men,France,2022-06-25,Pool,0,3,0,0,0,0,0,0,0,0,0,0,0,0,0,0,0,0,0,0,0,0,0,0,0,0,0
Tomohiro OGAWA,Japan,Libero,Men,France,2022-06-25,Pool,0,3,0,0,0,0,0,0,0,0,0,0,0,0,0,2,1,11,14,8,1,5,14,0,0,5,5
Yuki ISHIKAWA,Japan,Outside Hitter,Men,France,2022-06-25,Pool,0,3,0,0,0,0,0,0,0,0,0,0,0,0,0,0,0,0,0,0,0,0,0,0,0,0,0
Tomohiro YAMAMOTO,Japan,Libero,Men,France,2022-06-25,Pool,0,3,0,0,0,0,0,0,0,0,0,0,0,0,0,0,0,1,1,0,0,0,0,0,0,0,0
Go MURAYAMA,Japan,Middle Blocker,Men,France,2022-06-25,Pool,0,3,3,2,1,3,6,0,3,3,6,1,2,11,14,0,0,0,0,4,0,1,5,0,0,0,0
Yuji NISHIDA,Japan,Opposite Spiker,Men,Italy,2022-06-24,Pool,3,5,28,22,9,9,40,1,6,2,9,5,5,6,16,0,0,1,1,4,3,0,7,0,0,2,2
Taishi ONODERA,Japan,Middle Blocker,Men,Italy,2022-06-24,Pool,3,5,6,5,1,3,9,0,3,2,5,1,1,20,22,2,0,1,3,5,1,2,8,0,0,1,1
Tatsunori OTSUKA,Japan,Outside Hitter,Men,Italy,2022-06-24,Pool,3,5,0,0,0,0,0,0,0,0,0,0,0,0,0,0,0,0,0,0,0,0,0,0,0,0,0
Akihiro YAMAUCHI,Japan,Middle Blocker,Men,Italy,2022-06-24,Pool,3,5,15,14,1,3,18,0,5,8,13,1,1,15,17,0,0,0,0,3,1,0,4,0,0,3,3
Kenta TAKANASHI,Japan,Outside Hitter,Men,Italy,2022-06-24,Pool,3,5,1,1,1,1,3,0,1,0,1,0,0,0,0,1,0,1,2,1,0,0,1,0,0,1,1
Masahiro SEKITA,Japan,Setter,Men,Italy,2022-06-24,Pool,3,5,2,1,0,0,1,0,3,1,4,1,0,18,19,0,0,2,2,6,4,3,13,24,0,81,105
Masaki OYA,Japan,Setter,Men,Italy,2022-06-24,Pool,3,5,0,0,0,0,0,0,0,0,0,0,0,0,0,0,0,0,0,0,0,0,0,0,0,0,0
Kentaro TAKAHASHI,Japan,Middle Blocker,Men,Italy,2022-06-24,Pool,3,5,0,0,0,0,0,0,0,1,1,0,0,0,0,0,0,0,0,0,0,0,0,0,0,0,0
Shoma TOMITA,Japan,Outside Hitter,Men,Italy,2022-06-24,Pool,3,5,0,0,0,0,0,0,0,0,0,0,0,0,0,0,0,0,0,0,0,0,0,0,0,1,1
Ran TAKAHASHI,Japan,Outside Hitter,Men,Italy,2022-06-24,Pool,3,5,8,7,4,8,19,1,3,1,5,0,4,9,13,5,1,21,27,4,3,0,7,0,0,2,2
Tomohiro OGAWA,Japan,Libero,Men,Italy,2022-06-24,Pool,3,5,0,0,0,0,0,0,0,0,0,0,0,0,0,0,0,0,0,0,0,0,0,0,0,0,0
Yuki ISHIKAWA,Japan,Outside Hitter,Men,Italy,2022-06-24,Pool,3,5,20,14,8,17,39,0,2,1,3,6,2,14,22,7,1,20,28,10,2,4,16,3,0,4,7
Tomohiro YAMAMOTO,Japan,Libero,Men,Italy,2022-06-24,Pool,3,5,0,0,0,0,0,0,0,0,0,0,0,0,0,6,1,11,18,14,1,0,15,1,0,4,5
Go MURAYAMA,Japan,Middle Blocker,Men,Italy,2022-06-24,Pool,3,5,0,0,0,0,0,0,0,0,0,0,0,0,0,0,0,0,0,0,0,0,0,0,0,0,0
Yuji NISHIDA,Japan,Opposite Spiker,Men,Argentina,2022-06-21,Pool,3,4,25,20,4,11,35,2,4,3,9,3,5,9,17,0,0,0,0,6,2,1,9,0,0,1,1
Taishi ONODERA,Japan,Middle Blocker,Men,Argentina,2022-06-21,Pool,3,4,9,5,0,5,10,2,2,3,7,2,2,11,15,0,0,1,1,4,0,1,5,0,0,0,0
Tatsunori OTSUKA,Japan,Outside Hitter,Men,Argentina,2022-06-21,Pool,3,4,0,0,0,1,1,0,0,0,0,0,0,0,0,0,0,0,0,0,0,0,0,0,0,1,1
Akihiro YAMAUCHI,Japan,Middle Blocker,Men,Argentina,2022-06-21,Pool,3,4,10,7,1,5,13,2,3,2,7,1,2,14,17,0,0,0,0,3,0,0,3,0,0,0,0
Kenta TAKANASHI,Japan,Outside Hitter,Men,Argentina,2022-06-21,Pool,3,4,4,4,3,3,10,0,0,1,1,0,2,3,5,4,1,11,16,4,1,0,5,0,0,2,2
Masahiro SEKITA,Japan,Setter,Men,Argentina,2022-06-21,Pool,3,4,0,0,0,0,0,0,2,2,4,0,2,14,16,0,0,0,0,8,2,0,10,15,0,69,84
Masaki OYA,Japan,Setter,Men,Argentina,2022-06-21,Pool,3,4,0,0,0,0,0,0,0,0,0,0,0,1,1,0,0,0,0,0,0,0,0,0,0,1,1
Kentaro TAKAHASHI,Japan,Middle Blocker,Men,Argentina,2022-06-21,Pool,3,4,0,0,0,0,0,0,0,0,0,0,0,0,0,0,0,0,0,0,0,0,0,0,0,0,0
Shoma TOMITA,Japan,Outside Hitter,Men,Argentina,2022-06-21,Pool,3,4,1,1,1,1,3,0,0,0,0,0,1,1,2,0,0,3,3,0,0,0,0,0,0,0,0
Ran TAKAHASHI,Japan,Outside Hitter,Men,Argentina,2022-06-21,Pool,3,4,4,4,1,1,6,0,0,0,0,0,0,4,4,4,0,5,9,3,2,0,5,0,0,3,3
Tomohiro OGAWA,Japan,Libero,Men,Argentina,2022-06-21,Pool,3,4,0,0,0,0,0,0,0,0,0,0,0,0,0,0,0,0,0,0,0,0,0,0,0,0,0
Yuki ISHIKAWA,Japan,Outside Hitter,Men,Argentina,2022-06-21,Pool,3,4,18,15,4,10,29,0,1,2,3,3,6,7,16,8,0,17,25,6,2,2,10,0,0,9,9
Tomohiro YAMAMOTO,Japan,Libero,Men,Argentina,2022-06-21,Pool,3,4,0,0,0,0,0,0,0,0,0,0,0,0,0,0,0,13,13,6,7,1,14,0,0,5,5
Go MURAYAMA,Japan,Middle Blocker,Men,Argentina,2022-06-21,Pool,3,4,0,0,0,0,0,0,0,0,0,0,0,0,0,0,0,0,0,0,0,0,0,0,0,0,0
Yuji NISHIDA,Japan,Opposite Spiker,Men,Iran,2022-06-12,Pool,3,3,17,11,3,8,22,1,1,1,3,5,4,6,15,0,0,0,0,3,0,0,3,1,0,0,1
Taishi ONODERA,Japan,Middle Blocker,Men,Iran,2022-06-12,Pool,3,3,4,2,1,1,4,2,3,2,7,0,1,4,5,1,0,1,2,4,1,0,5,0,0,0,0
Tatsunori OTSUKA,Japan,Outside Hitter,Men,Iran,2022-06-12,Pool,3,3,2,2,0,0,2,0,0,0,0,0,1,1,2,1,1,3,5,0,0,0,0,0,0,0,0
Akihiro YAMAUCHI,Japan,Middle Blocker,Men,Iran,2022-06-12,Pool,3,3,7,4,0,1,5,2,2,4,8,1,1,8,10,0,0,0,0,1,0,0,1,0,0,0,0
Masahiro SEKITA,Japan,Setter,Men,Iran,2022-06-12,Pool,3,3,0,0,0,0,0,0,1,5,6,0,1,14,15,0,0,1,1,8,1,0,9,18,1,31,50
Shoma TOMITA,Japan,Outside Hitter,Men,Iran,2022-06-12,Pool,3,3,0,0,0,0,0,0,0,0,0,0,0,0,0,0,0,0,0,0,0,0,0,0,0,0,0
Ran TAKAHASHI,Japan,Outside Hitter,Men,Iran,2022-06-12,Pool,3,3,9,6,2,8,16,0,3,3,6,3,2,8,13,4,0,6,10,9,1,0,10,2,0,2,4
Tomohiro OGAWA,Japan,Libero,Men,Iran,2022-06-12,Pool,3,3,0,0,0,0,0,0,0,0,0,0,0,0,0,0,0,0,0,0,1,0,1,0,0,0,0
Yuki ISHIKAWA,Japan,Outside Hitter,Men,Iran,2022-06-12,Pool,3,3,16,14,1,5,20,1,3,3,7,1,2,11,14,4,0,9,13,4,1,0,5,3,0,1,4
Kento MIYAURA,Japan,Opposite Spiker,Men,Iran,2022-06-12,Pool,3,3,0,0,0,0,0,0,0,0,0,0,0,0,0,0,0,0,0,0,0,0,0,0,0,0,0
Tomohiro YAMAMOTO,Japan,Libero,Men,Iran,2022-06-12,Pool,3,3,0,0,0,0,0,0,0,0,0,0,0,0,0,3,3,4,10,5,0,2,7,3,0,1,4
Motoki EIRO,Japan,Setter,Men,Iran,2022-06-12,Pool,3,3,0,0,0,1,1,0,1,0,1,0,0,0,0,0,0,0,0,0,0,0,0,2,0,4,6
Go MURAYAMA,Japan,Middle Blocker,Men,Iran,2022-06-12,Pool,3,3,0,0,0,0,0,0,0,0,0,0,0,0,0,0,0,0,0,0,0,0,0,0,0,0,0
Yuji NISHIDA,Japan,Opposite Spiker,Men,United States,2022-06-10,Pool,2,5,0,0,0,0,0,0,0,0,0,0,0,0,0,0,0,0,0,0,0,0,0,0,0,0,0
Taishi ONODERA,Japan,Middle Blocker,Men,United States,2022-06-10,Pool,2,5,5,5,1,2,8,0,3,2,5,0,1,11,12,1,0,0,1,2,2,1,5,0,1,0,1
Tatsunori OTSUKA,Japan,Outside Hitter,Men,United States,2022-06-10,Pool,2,5,5,5,3,11,19,0,1,2,3,0,1,4,5,2,0,4,6,3,1,0,4,0,0,0,0
Akihiro YAMAUCHI,Japan,Middle Blocker,Men,United States,2022-06-10,Pool,2,5,6,6,0,6,12,0,8,7,15,0,2,18,20,0,0,0,0,4,1,2,7,0,0,0,0
Masahiro SEKITA,Japan,Setter,Men,United States,2022-06-10,Pool,2,5,0,0,0,0,0,0,1,0,1,0,1,4,5,0,0,0,0,4,0,0,4,11,0,25,36
Shoma TOMITA,Japan,Outside Hitter,Men,United States,2022-06-10,Pool,2,5,1,1,1,1,3,0,3,0,3,0,2,1,3,2,0,7,9,4,0,0,4,0,0,1,1
Ran TAKAHASHI,Japan,Outside Hitter,Men,United States,2022-06-10,Pool,2,5,12,12,1,15,28,0,3,6,9,0,2,18,20,13,3,24,40,12,1,2,15,2,0,0,2
Tomohiro OGAWA,Japan,Libero,Men,United States,2022-06-10,Pool,2,5,0,0,0,0,0,0,0,0,0,0,0,0,0,0,0,0,0,0,0,0,0,0,0,0,0
Yuki ISHIKAWA,Japan,Outside Hitter,Men,United States,2022-06-10,Pool,2,5,9,7,4,9,20,1,4,0,5,1,3,3,7,5,1,3,9,2,1,0,3,1,1,0,2
Kento MIYAURA,Japan,Opposite Spiker,Men,United States,2022-06-10,Pool,2,5,20,19,6,17,42,1,3,7,11,0,3,11,14,0,0,0,0,11,2,1,14,0,0,2,2
Tomohiro YAMAMOTO,Japan,Libero,Men,United States,2022-06-10,Pool,2,5,0,0,0,0,0,0,0,0,0,0,0,0,0,11,0,7,18,20,2,2,24,10,0,5,15
Motoki EIRO,Japan,Setter,Men,United States,2022-06-10,Pool,2,5,4,3,1,0,4,1,0,2,3,0,0,8,8,0,0,0,0,4,0,1,5,32,2,47,81
Go MURAYAMA,Japan,Middle Blocker,Men,United States,2022-06-10,Pool,2,5,2,2,0,2,4,0,1,0,1,0,1,3,4,0,0,0,0,0,0,0,0,0,0,0,0
Yuji NISHIDA,Japan,Opposite Spiker,Men,China,2022-06-09,Pool,3,4,26,22,7,4,33,1,2,0,3,3,7,8,18,0,0,0,0,3,1,1,5,0,0,0,0
Taishi ONODERA,Japan,Middle Blocker,Men,China,2022-06-09,Pool,3,4,0,0,0,0,0,0,0,0,0,0,0,0,0,0,0,0,0,0,0,0,0,0,0,0,0
Tatsunori OTSUKA,Japan,Outside Hitter,Men,China,2022-06-09,Pool,3,4,0,0,0,1,1,0,0,0,0,0,0,0,0,1,0,0,1,0,0,0,0,0,0,0,0
Akihiro YAMAUCHI,Japan,Middle Blocker,Men,China,2022-06-09,Pool,3,4,5,5,2,1,8,0,2,2,4,0,2,8,10,0,0,0,0,2,0,1,3,1,0,0,1
Masahiro SEKITA,Japan,Setter,Men,China,2022-06-09,Pool,3,4,0,0,0,0,0,0,0,0,0,0,0,0,0,0,0,0,0,0,0,0,0,0,0,0,0
Shoma TOMITA,Japan,Outside Hitter,Men,China,2022-06-09,Pool,3,4,0,0,0,0,0,0,0,0,0,0,0,0,0,0,0,0,0,0,0,0,0,0,0,0,0
Ran TAKAHASHI,Japan,Outside Hitter,Men,China,2022-06-09,Pool,3,4,14,13,3,6,22,0,2,0,2,1,2,18,21,7,0,13,20,6,1,0,7,1,0,1,2
Tomohiro OGAWA,Japan,Libero,Men,China,2022-06-09,Pool,3,4,0,0,0,0,0,0,0,0,0,0,0,0,0,0,0,0,0,0,0,0,0,0,0,0,0
Yuki ISHIKAWA,Japan,Outside Hitter,Men,China,2022-06-09,Pool,3,4,16,11,3,7,21,2,2,3,7,3,9,7,19,7,0,14,21,5,2,0,7,3,0,0,3
Kento MIYAURA,Japan,Opposite Spiker,Men,China,2022-06-09,Pool,3,4,0,0,0,0,0,0,0,0,0,0,0,1,1,0,0,0,0,0,0,0,0,0,0,0,0
Tomohiro YAMAMOTO,Japan,Libero,Men,China,2022-06-09,Pool,3,4,0,0,0,0,0,0,0,0,0,0,0,0,0,11,0,11,22,12,1,3,16,4,0,0,4
Motoki EIRO,Japan,Setter,Men,China,2022-06-09,Pool,3,4,0,0,0,0,0,0,1,5,6,0,4,8,12,0,0,0,0,5,1,2,8,38,0,46,84
Go MURAYAMA,Japan,Middle Blocker,Men,China,2022-06-09,Pool,3,4,7,5,2,2,9,1,6,1,8,1,2,11,14,0,0,0,0,0,2,0,2,0,0,1,1
Yuji NISHIDA,Japan,Opposite Spiker,Men,Netherlands,2022-06-08,Pool,3,4,25,23,7,7,37,1,4,0,5,1,5,10,16,0,0,0,0,3,3,0,6,1,0,1,2
Taishi ONODERA,Japan,Middle Blocker,Men,Netherlands,2022-06-08,Pool,3,4,7,4,2,3,9,2,5,6,13,1,2,15,18,2,0,4,6,3,0,1,4,0,1,1,2
Tatsunori OTSUKA,Japan,Outside Hitter,Men,Netherlands,2022-06-08,Pool,3,4,3,3,0,2,5,0,1,0,1,0,0,1,1,0,0,1,1,1,0,0,1,0,0,0,0
Akihiro YAMAUCHI,Japan,Middle Blocker,Men,Netherlands,2022-06-08,Pool,3,4,1,1,1,4,6,0,3,0,3,0,0,7,7,1,0,1,2,3,0,1,4,0,0,0,0
Masahiro SEKITA,Japan,Setter,Men,Netherlands,2022-06-08,Pool,3,4,0,0,0,0,0,0,1,3,4,0,0,8,8,0,0,1,1,5,3,0,8,31,0,47,78
Shoma TOMITA,Japan,Outside Hitter,Men,Netherlands,2022-06-08,Pool,3,4,0,0,0,0,0,0,0,0,0,0,0,0,0,0,0,0,0,0,0,0,0,0,0,0,0
Ran TAKAHASHI,Japan,Outside Hitter,Men,Netherlands,2022-06-08,Pool,3,4,10,8,3,8,19,0,1,1,2,2,3,13,18,7,0,13,20,3,0,1,4,0,0,0,0
Tomohiro OGAWA,Japan,Libero,Men,Netherlands,2022-06-08,Pool,3,4,0,0,0,0,0,0,0,0,0,0,0,0,0,0,0,0,0,0,0,0,0,0,0,0,0
Yuki ISHIKAWA,Japan,Outside Hitter,Men,Netherlands,2022-06-08,Pool,3,4,12,6,5,8,19,5,7,1,13,1,3,13,17,8,1,11,20,6,2,1,9,1,0,4,5
Kento MIYAURA,Japan,Opposite Spiker,Men,Netherlands,2022-06-08,Pool,3,4,0,0,0,0,0,0,0,0,0,0,1,0,1,0,0,0,0,0,0,0,0,0,0,0,0
Tomohiro YAMAMOTO,Japan,Libero,Men,Netherlands,2022-06-08,Pool,3,4,0,0,0,0,0,0,0,0,0,0,0,0,0,10,2,10,22,12,3,2,17,1,0,1,2
Motoki EIRO,Japan,Setter,Men,Netherlands,2022-06-08,Pool,3,4,0,0,0,0,0,0,0,1,1,0,0,3,3,0,0,0,0,3,0,0,3,5,0,14,19
Go MURAYAMA,Japan,Middle Blocker,Men,Netherlands,2022-06-08,Pool,3,4,12,9,0,3,12,2,3,4,9,1,1,6,8,0,0,1,1,1,0,0,1,0,0,0,0
Wessel KEEMINK,Netherlands,Setter,Men,Italy,2022-07-20,Quarterfinals,1,4,1,1,0,0,1,0,3,3,6,0,0,14,14,0,1,0,1,10,2,0,12,14,0,82,96
Maarten VAN GARDEREN,Netherlands,Outside Hitter,Men,Italy,2022-07-20,Quarterfinals,1,4,5,4,1,9,14,1,2,2,5,0,4,4,8,3,0,6,9,2,4,0,6,0,0,2,2
Thijs TER HORST,Netherlands,Outside Hitter,Men,Italy,2022-07-20,Quarterfinals,1,4,3,3,4,3,10,0,1,0,1,0,2,1,3,5,1,1,7,2,0,0,2,0,1,1,2
Luuc VAN DER ENT,Netherlands,Middle Blocker,Men,Italy,2022-07-20,Quarterfinals,1,4,0,0,0,0,0,0,0,0,0,0,0,0,0,0,0,0,0,0,0,0,0,0,0,0,0
Gijs JORNA,Netherlands,Outside Hitter,Men,Italy,2022-07-20,Quarterfinals,1,4,4,3,0,3,6,0,1,0,1,1,1,5,7,5,1,4,10,3,1,1,5,0,0,0,0
Fabian PLAK,Netherlands,Middle Blocker,Men,Italy,2022-07-20,Quarterfinals,1,4,8,5,2,1,8,2,5,4,11,1,2,11,14,0,0,3,3,2,0,0,2,0,0,2,2
Stijn VAN TILBURG,Netherlands,Outside Hitter,Men,Italy,2022-07-20,Quarterfinals,1,4,2,2,0,1,3,0,0,0,0,0,0,0,0,0,0,0,0,0,0,0,0,0,0,1,1
Bennie Junior TUINSTRA,Netherlands,Outside Hitter,Men,Italy,2022-07-20,Quarterfinals,1,4,20,16,4,11,31,0,1,1,2,4,4,9,17,13,2,14,29,8,1,0,9,0,0,3,3
Mats BLEEKER,Netherlands,Libero,Men,Italy,2022-07-20,Quarterfinals,1,4,0,0,0,0,0,0,0,0,0,0,0,0,0,0,0,0,0,0,0,0,0,0,0,0,0
Nimir ABDEL-AZIZ,Netherlands,Opposite Spiker,Men,Italy,2022-07-20,Quarterfinals,1,4,16,16,7,18,41,0,3,2,5,0,6,5,11,0,0,1,1,6,1,0,7,0,0,1,1
Michael PARKINSON,Netherlands,Middle Blocker,Men,Italy,2022-07-20,Quarterfinals,1,4,0,0,0,0,0,0,0,0,0,0,0,1,1,0,0,0,0,0,0,0,0,0,0,0,0
Robbert ANDRINGA,Netherlands,Libero,Men,Italy,2022-07-20,Quarterfinals,1,4,0,0,0,0,0,0,0,0,0,0,0,0,0,9,2,16,27,4,3,0,7,1,0,5,6
Freek DE WEIJER,Netherlands,Setter,Men,Italy,2022-07-20,Quarterfinals,1,4,0,0,0,0,0,0,0,0,0,0,0,0,0,0,0,0,0,0,1,0,1,1,0,7,8
Twan WILTENBURG,Netherlands,Middle Blocker,Men,Italy,2022-07-20,Quarterfinals,1,4,3,2,2,2,6,1,2,3,6,0,1,7,8,0,0,1,1,1,0,1,2,0,0,1,1
Wessel KEEMINK,Netherlands,Setter,Men,Italy,2022-07-10,Pool,0,3,3,3,0,0,3,0,2,0,2,0,2,6,8,0,0,0,0,2,0,0,2,8,0,62,70
Maarten VAN GARDEREN,Netherlands,Outside Hitter,Men,Italy,2022-07-10,Pool,0,3,2,2,0,2,4,0,0,0,0,0,1,0,1,0,0,1,1,0,0,0,0,0,0,0,0
Thijs TER HORST,Netherlands,Outside Hitter,Men,Italy,2022-07-10,Pool,0,3,10,8,2,6,16,1,1,0,2,1,2,8,11,4,2,16,22,3,0,0,3,0,0,0,0
Luuc VAN DER ENT,Netherlands,Middle Blocker,Men,Italy,2022-07-10,Pool,0,3,1,1,0,3,4,0,1,0,1,0,1,6,7,0,0,3,3,0,1,0,1,0,0,0,0
Gijs JORNA,Netherlands,Outside Hitter,Men,Italy,2022-07-10,Pool,0,3,0,0,0,0,0,0,0,0,0,0,1,1,2,0,0,1,1,0,0,0,0,0,0,0,0
Fabian PLAK,Netherlands,Middle Blocker,Men,Italy,2022-07-10,Pool,0,3,2,1,0,1,2,0,1,0,1,1,0,1,2,0,0,0,0,0,0,0,0,0,0,0,0
Stijn VAN TILBURG,Netherlands,Outside Hitter,Men,Italy,2022-07-10,Pool,0,3,0,0,0,0,0,0,0,0,0,0,0,0,0,0,0,0,0,0,0,0,0,0,0,0,0
Bennie Junior TUINSTRA,Netherlands,Outside Hitter,Men,Italy,2022-07-10,Pool,0,3,8,5,1,9,15,2,1,0,3,1,4,10,15,0,1,17,18,2,0,1,3,0,0,0,0
Mats BLEEKER,Netherlands,Libero,Men,Italy,2022-07-10,Pool,0,3,0,0,0,0,0,0,0,0,0,0,0,0,0,0,0,0,0,0,0,0,0,0,0,0,0
Nimir ABDEL-AZIZ,Netherlands,Opposite Spiker,Men,Italy,2022-07-10,Pool,0,3,15,14,4,11,29,0,4,0,4,1,4,7,12,0,0,2,2,0,0,0,0,0,0,0,0
Michael PARKINSON,Netherlands,Middle Blocker,Men,Italy,2022-07-10,Pool,0,3,0,0,0,0,0,0,0,0,0,0,0,0,0,0,0,0,0,0,0,0,0,0,0,0,0
Robbert ANDRINGA,Netherlands,Libero,Men,Italy,2022-07-10,Pool,0,3,0,0,0,0,0,0,0,0,0,0,0,0,0,2,1,10,13,5,3,1,9,0,0,0,0
Freek DE WEIJER,Netherlands,Setter,Men,Italy,2022-07-10,Pool,0,3,0,0,0,0,0,0,0,0,0,0,0,0,0,0,0,0,0,0,0,0,0,0,0,0,0
Twan WILTENBURG,Netherlands,Middle Blocker,Men,Italy,2022-07-10,Pool,0,3,5,2,1,0,3,2,6,0,8,1,2,8,11,0,0,2,2,0,0,0,0,0,1,1,2
Wessel KEEMINK,Netherlands,Setter,Men,Poland,2022-07-09,Pool,0,3,4,3,0,1,4,0,0,0,0,1,1,7,9,0,0,1,1,1,1,0,2,6,0,57,63
Maarten VAN GARDEREN,Netherlands,Outside Hitter,Men,Poland,2022-07-09,Pool,0,3,7,7,4,6,17,0,4,0,4,0,3,4,7,0,1,12,13,1,2,0,3,0,0,3,3
Thijs TER HORST,Netherlands,Outside Hitter,Men,Poland,2022-07-09,Pool,0,3,3,3,0,2,5,0,0,0,0,0,1,4,5,1,0,3,4,1,0,0,1,0,0,0,0
Luuc VAN DER ENT,Netherlands,Middle Blocker,Men,Poland,2022-07-09,Pool,0,3,0,0,0,0,0,0,1,0,1,0,0,2,2,0,0,0,0,0,0,0,0,0,0,0,0
Gijs JORNA,Netherlands,Outside Hitter,Men,Poland,2022-07-09,Pool,0,3,0,0,0,0,0,0,0,0,0,0,0,2,2,0,0,4,4,0,0,0,0,0,0,0,0
Fabian PLAK,Netherlands,Middle Blocker,Men,Poland,2022-07-09,Pool,0,3,2,2,1,4,7,0,4,0,4,0,2,2,4,0,1,0,1,0,0,1,1,0,0,1,1
Stijn VAN TILBURG,Netherlands,Outside Hitter,Men,Poland,2022-07-09,Pool,0,3,0,0,0,0,0,0,0,0,0,0,0,0,0,0,0,0,0,0,0,0,0,0,0,0,0
Bennie Junior TUINSTRA,Netherlands,Outside Hitter,Men,Poland,2022-07-09,Pool,0,3,8,7,3,5,15,0,4,0,4,1,2,6,9,1,2,15,18,1,1,0,2,0,0,2,2
Mats BLEEKER,Netherlands,Libero,Men,Poland,2022-07-09,Pool,0,3,0,0,0,0,0,0,0,0,0,0,0,0,0,0,0,0,0,0,0,0,0,0,0,0,0
Nimir ABDEL-AZIZ,Netherlands,Opposite Spiker,Men,Poland,2022-07-09,Pool,0,3,19,15,5,6,26,0,0,0,0,4,5,9,18,0,0,1,1,1,1,0,2,0,0,2,2
Michael PARKINSON,Netherlands,Middle Blocker,Men,Poland,2022-07-09,Pool,0,3,0,0,0,0,0,0,0,0,0,0,0,1,1,0,0,0,0,0,0,0,0,0,0,0,0
Robbert ANDRINGA,Netherlands,Libero,Men,Poland,2022-07-09,Pool,0,3,0,0,0,0,0,0,0,0,0,0,0,0,0,1,0,20,21,4,1,1,6,0,0,3,3
Freek DE WEIJER,Netherlands,Setter,Men,Poland,2022-07-09,Pool,0,3,0,0,0,0,0,0,0,0,0,0,0,0,0,0,0,0,0,0,0,0,0,0,0,2,2
Twan WILTENBURG,Netherlands,Middle Blocker,Men,Poland,2022-07-09,Pool,0,3,4,0,0,1,1,4,3,0,7,0,2,6,8,0,0,0,0,0,2,0,2,0,0,0,0
Wessel KEEMINK,Netherlands,Setter,Men,Bulgaria,2022-07-08,Pool,1,4,0,0,1,0,1,0,1,0,1,0,0,14,14,1,0,3,4,1,0,0,1,19,0,63,82
Maarten VAN GARDEREN,Netherlands,Outside Hitter,Men,Bulgaria,2022-07-08,Pool,1,4,1,1,2,3,6,0,0,0,0,0,0,5,5,1,1,11,13,0,0,0,0,0,0,1,1
Luuc VAN DER ENT,Netherlands,Middle Blocker,Men,Bulgaria,2022-07-08,Pool,1,4,0,0,0,0,0,0,0,0,0,0,0,1,1,0,1,0,1,0,0,0,0,0,0,0,0
Gijs JORNA,Netherlands,Outside Hitter,Men,Bulgaria,2022-07-08,Pool,1,4,5,4,4,11,19,0,2,0,2,1,0,12,13,0,2,15,17,1,1,1,3,0,0,2,2
Fabian PLAK,Netherlands,Middle Blocker,Men,Bulgaria,2022-07-08,Pool,1,4,8,7,1,2,10,1,7,1,9,0,3,7,10,0,0,2,2,0,0,0,0,0,0,0,0
Stijn VAN TILBURG,Netherlands,Outside Hitter,Men,Bulgaria,2022-07-08,Pool,1,4,0,0,0,0,0,0,0,0,0,0,0,0,0,0,0,0,0,0,0,0,0,0,0,0,0
Bennie Junior TUINSTRA,Netherlands,Outside Hitter,Men,Bulgaria,2022-07-08,Pool,1,4,8,6,2,5,13,0,0,0,0,2,1,6,9,1,1,14,16,2,0,1,3,0,0,6,6
Mats BLEEKER,Netherlands,Libero,Men,Bulgaria,2022-07-08,Pool,1,4,0,0,0,0,0,0,0,0,0,0,0,0,0,0,0,0,0,0,0,0,0,0,0,0,0
Nimir ABDEL-AZIZ,Netherlands,Opposite Spiker,Men,Bulgaria,2022-07-08,Pool,1,4,25,22,10,14,46,1,2,0,3,2,5,11,18,0,0,2,2,5,0,1,6,0,1,2,3
Michael PARKINSON,Netherlands,Middle Blocker,Men,Bulgaria,2022-07-08,Pool,1,4,8,6,0,0,6,1,5,0,6,1,0,5,6,0,0,2,2,0,0,0,0,0,1,2,3
Robbert ANDRINGA,Netherlands,Libero,Men,Bulgaria,2022-07-08,Pool,1,4,0,0,0,0,0,0,0,0,0,0,0,0,0,15,0,10,25,9,4,2,15,0,0,0,0
Freek DE WEIJER,Netherlands,Setter,Men,Bulgaria,2022-07-08,Pool,1,4,0,0,0,0,0,0,2,0,2,0,2,1,3,0,0,0,0,0,0,0,0,7,0,11,18
Twan WILTENBURG,Netherlands,Middle Blocker,Men,Bulgaria,2022-07-08,Pool,1,4,2,2,2,1,5,0,3,0,3,0,0,5,5,0,0,2,2,1,0,0,1,0,0,0,0
Wessel KEEMINK,Netherlands,Setter,Men,China,2022-07-06,Pool,3,3,0,0,0,0,0,0,0,0,0,0,1,15,16,0,0,0,0,0,1,0,1,7,0,63,70
Maarten VAN GARDEREN,Netherlands,Outside Hitter,Men,China,2022-07-06,Pool,3,3,1,1,0,0,1,0,0,0,0,0,0,0,0,0,0,2,2,0,0,0,0,0,0,0,0
Thijs TER HORST,Netherlands,Outside Hitter,Men,China,2022-07-06,Pool,3,3,14,10,2,4,16,2,0,0,2,2,2,7,11,2,0,17,19,4,0,0,4,0,0,0,0
Luuc VAN DER ENT,Netherlands,Middle Blocker,Men,China,2022-07-06,Pool,3,3,0,0,0,0,0,0,0,0,0,0,0,0,0,0,0,0,0,0,0,0,0,0,0,0,0
Gijs JORNA,Netherlands,Outside Hitter,Men,China,2022-07-06,Pool,3,3,7,5,2,1,8,1,0,0,1,1,0,7,8,0,0,13,13,3,1,2,6,0,0,0,0
Fabian PLAK,Netherlands,Middle Blocker,Men,China,2022-07-06,Pool,3,3,9,4,0,1,5,5,4,1,10,0,3,9,12,0,0,0,0,2,0,0,2,0,0,0,0
Stijn VAN TILBURG,Netherlands,Outside Hitter,Men,China,2022-07-06,Pool,3,3,0,0,0,0,0,0,0,0,0,0,0,0,0,0,0,0,0,0,0,0,0,0,0,0,0
Bennie Junior TUINSTRA,Netherlands,Outside Hitter,Men,China,2022-07-06,Pool,3,3,0,0,2,4,6,0,0,0,0,0,1,2,3,3,0,5,8,0,0,0,0,0,0,1,1
Mats BLEEKER,Netherlands,Libero,Men,China,2022-07-06,Pool,3,3,0,0,0,0,0,0,0,0,0,0,0,0,0,0,0,0,0,0,0,0,0,0,0,0,0
Nimir ABDEL-AZIZ,Netherlands,Opposite Spiker,Men,China,2022-07-06,Pool,3,3,30,21,2,11,34,3,2,0,5,6,3,7,16,0,0,2,2,0,0,0,0,0,0,0,0
Michael PARKINSON,Netherlands,Middle Blocker,Men,China,2022-07-06,Pool,3,3,0,0,0,0,0,0,0,0,0,0,0,0,0,0,0,0,0,0,0,0,0,0,0,0,0
Robbert ANDRINGA,Netherlands,Libero,Men,China,2022-07-06,Pool,3,3,0,0,0,0,0,0,0,0,0,0,0,0,0,0,0,5,5,1,2,1,4,0,0,0,0
Freek DE WEIJER,Netherlands,Setter,Men,China,2022-07-06,Pool,3,3,0,0,0,0,0,0,0,0,0,0,0,0,0,0,0,0,0,0,0,0,0,0,0,0,0
Twan WILTENBURG,Netherlands,Middle Blocker,Men,China,2022-07-06,Pool,3,3,5,2,0,2,4,2,3,0,5,1,1,9,11,0,0,0,0,1,0,0,1,0,0,0,0
Wessel KEEMINK,Netherlands,Setter,Men,Argentina,2022-06-25,Pool,3,5,2,1,0,1,2,1,2,2,5,0,0,17,17,0,0,1,1,10,2,1,13,12,0,93,105
Thijs TER HORST,Netherlands,Outside Hitter,Men,Argentina,2022-06-25,Pool,3,5,0,0,1,1,2,0,1,0,1,0,0,0,0,0,1,0,1,0,0,0,0,0,0,0,0
Luuc VAN DER ENT,Netherlands,Middle Blocker,Men,Argentina,2022-06-25,Pool,3,5,0,0,0,0,0,0,0,0,0,0,0,0,0,0,0,0,0,0,0,0,0,0,0,0,0
Gijs JORNA,Netherlands,Outside Hitter,Men,Argentina,2022-06-25,Pool,3,5,12,10,5,9,24,1,0,0,1,1,3,16,20,7,1,27,35,18,4,1,23,0,0,2,2
Fabian PLAK,Netherlands,Middle Blocker,Men,Argentina,2022-06-25,Pool,3,5,14,5,1,4,10,4,4,5,13,5,4,10,19,0,0,2,2,1,0,0,1,1,0,3,4
Steven OTTEVANGER,Netherlands,Libero,Men,Argentina,2022-06-25,Pool,3,5,0,0,0,0,0,0,0,0,0,0,0,0,0,0,0,0,0,0,0,0,0,0,0,0,0
Stijn VAN TILBURG,Netherlands,Outside Hitter,Men,Argentina,2022-06-25,Pool,3,5,7,7,2,2,11,0,2,2,4,0,1,0,1,0,0,0,0,1,1,0,2,0,0,0,0
Bennie Junior TUINSTRA,Netherlands,Outside Hitter,Men,Argentina,2022-06-25,Pool,3,5,18,17,1,13,31,1,5,2,8,0,4,16,20,5,1,18,24,4,1,1,6,0,0,3,3
Nimir ABDEL-AZIZ,Netherlands,Opposite Spiker,Men,Argentina,2022-06-25,Pool,3,5,24,21,8,13,42,1,2,1,4,2,5,6,13,0,0,0,0,3,2,0,5,0,0,4,4
Gijs VAN SOLKEMA,Netherlands,Setter,Men,Argentina,2022-06-25,Pool,3,5,0,0,0,0,0,0,1,1,2,0,0,2,2,0,0,0,0,0,0,0,0,0,0,1,1
Michael PARKINSON,Netherlands,Middle Blocker,Men,Argentina,2022-06-25,Pool,3,5,5,5,0,1,6,0,5,1,6,0,1,6,7,0,0,0,0,3,1,0,4,0,0,1,1
Robbert ANDRINGA,Netherlands,Libero,Men,Argentina,2022-06-25,Pool,3,5,0,0,0,0,0,0,0,0,0,0,0,0,0,9,1,15,25,10,3,0,13,0,0,6,6
Twan WILTENBURG,Netherlands,Middle Blocker,Men,Argentina,2022-06-25,Pool,3,5,0,0,0,0,0,0,0,0,0,0,2,4,6,0,0,0,0,0,0,0,0,0,0,1,1
Wessel KEEMINK,Netherlands,Setter,Men,Germany,2022-06-24,Pool,3,4,3,2,0,1,3,0,4,5,9,1,1,12,14,0,0,0,0,4,1,2,7,12,1,85,98
Thijs TER HORST,Netherlands,Outside Hitter,Men,Germany,2022-06-24,Pool,3,4,5,3,1,2,6,2,0,0,2,0,1,1,2,0,0,7,7,1,0,0,1,0,0,0,0
Luuc VAN DER ENT,Netherlands,Middle Blocker,Men,Germany,2022-06-24,Pool,3,4,2,0,0,0,0,2,3,1,6,0,0,3,3,0,0,0,0,0,1,0,1,0,0,0,0
Gijs JORNA,Netherlands,Outside Hitter,Men,Germany,2022-06-24,Pool,3,4,11,10,3,10,23,1,4,3,8,0,2,19,21,9,0,14,23,16,2,0,18,1,0,7,8
Fabian PLAK,Netherlands,Middle Blocker,Men,Germany,2022-06-24,Pool,3,4,8,5,0,4,9,2,5,5,12,1,4,8,13,0,0,0,0,7,0,0,7,0,0,1,1
Steven OTTEVANGER,Netherlands,Libero,Men,Germany,2022-06-24,Pool,3,4,0,0,0,0,0,0,0,0,0,0,0,0,0,0,0,0,0,0,0,0,0,0,0,0,0
Stijn VAN TILBURG,Netherlands,Outside Hitter,Men,Germany,2022-06-24,Pool,3,4,0,0,0,0,0,0,0,0,0,0,0,1,1,0,0,0,0,0,0,0,0,0,0,2,2
Bennie Junior TUINSTRA,Netherlands,Outside Hitter,Men,Germany,2022-06-24,Pool,3,4,10,8,4,17,29,1,3,3,7,1,4,9,14,2,1,16,19,7,1,3,11,0,0,0,0
Nimir ABDEL-AZIZ,Netherlands,Opposite Spiker,Men,Germany,2022-06-24,Pool,3,4,31,25,5,23,53,3,0,6,9,3,5,9,17,0,0,2,2,7,5,0,12,0,0,1,1
Gijs VAN SOLKEMA,Netherlands,Setter,Men,Germany,2022-06-24,Pool,3,4,0,0,0,0,0,0,0,1,1,0,0,1,1,0,0,0,0,0,0,0,0,0,0,10,10
Michael PARKINSON,Netherlands,Middle Blocker,Men,Germany,2022-06-24,Pool,3,4,0,0,0,0,0,0,0,0,0,0,0,0,0,0,0,0,0,0,0,0,0,0,0,0,0
Robbert ANDRINGA,Netherlands,Libero,Men,Germany,2022-06-24,Pool,3,4,0,0,0,0,0,0,0,0,0,0,0,0,0,6,0,16,22,8,6,3,17,0,0,4,4
Twan WILTENBURG,Netherlands,Middle Blocker,Men,Germany,2022-06-24,Pool,3,4,8,4,0,0,4,4,4,15,23,0,4,12,16,0,0,1,1,4,0,0,4,0,1,0,1
Wessel KEEMINK,Netherlands,Setter,Men,France,2022-06-23,Pool,0,3,0,0,0,0,0,0,1,0,1,0,0,6,6,0,0,2,2,3,3,0,6,13,0,38,51
Thijs TER HORST,Netherlands,Outside Hitter,Men,France,2022-06-23,Pool,0,3,4,4,4,2,10,0,1,1,2,0,0,2,2,3,1,9,13,1,2,0,3,0,0,0,0
Luuc VAN DER ENT,Netherlands,Middle Blocker,Men,France,2022-06-23,Pool,0,3,0,0,0,0,0,0,0,0,0,0,0,0,0,0,0,0,0,0,0,0,0,0,0,0,0
Gijs JORNA,Netherlands,Outside Hitter,Men,France,2022-06-23,Pool,0,3,3,3,3,1,7,0,1,0,1,0,1,4,5,4,0,4,8,3,2,0,5,0,0,5,5
Fabian PLAK,Netherlands,Middle Blocker,Men,France,2022-06-23,Pool,0,3,3,3,0,1,4,0,5,3,8,0,2,4,6,0,0,1,1,0,0,0,0,1,0,1,2
Steven OTTEVANGER,Netherlands,Libero,Men,France,2022-06-23,Pool,0,3,0,0,0,0,0,0,0,0,0,0,0,0,0,0,0,0,0,0,0,0,0,0,0,0,0
Stijn VAN TILBURG,Netherlands,Outside Hitter,Men,France,2022-06-23,Pool,0,3,3,3,1,1,5,0,0,1,1,0,1,2,3,0,0,0,0,0,0,0,0,0,0,1,1
Bennie Junior TUINSTRA,Netherlands,Outside Hitter,Men,France,2022-06-23,Pool,0,3,11,7,3,9,19,1,1,1,3,3,2,6,11,10,2,15,27,3,1,0,4,1,0,0,1
Nimir ABDEL-AZIZ,Netherlands,Opposite Spiker,Men,France,2022-06-23,Pool,0,3,11,10,4,8,22,0,2,1,3,1,5,2,8,1,0,1,2,0,4,0,4,1,0,1,2
Gijs VAN SOLKEMA,Netherlands,Setter,Men,France,2022-06-23,Pool,0,3,0,0,0,0,0,0,0,0,0,0,0,0,0,0,0,0,0,1,0,0,1,3,0,8,11
Michael PARKINSON,Netherlands,Middle Blocker,Men,France,2022-06-23,Pool,0,3,1,0,2,1,3,0,1,1,2,1,0,2,3,0,0,1,1,0,0,0,0,0,0,0,0
Robbert ANDRINGA,Netherlands,Libero,Men,France,2022-06-23,Pool,0,3,0,0,0,0,0,0,0,0,0,0,0,0,0,2,1,4,7,8,2,0,10,0,0,3,3
Twan WILTENBURG,Netherlands,Middle Blocker,Men,France,2022-06-23,Pool,0,3,0,0,2,2,4,0,4,4,8,0,0,7,7,0,0,0,0,1,0,0,1,0,0,0,0
Wessel KEEMINK,Netherlands,Setter,Men,Slovenia,2022-06-21,Pool,3,3,1,0,1,0,1,1,1,4,6,0,0,13,13,0,0,0,0,3,0,1,4,12,0,47,59
Thijs TER HORST,Netherlands,Outside Hitter,Men,Slovenia,2022-06-21,Pool,3,3,12,9,2,3,14,1,4,3,8,2,2,6,10,3,2,10,15,4,1,1,6,0,0,4,4
Luuc VAN DER ENT,Netherlands,Middle Blocker,Men,Slovenia,2022-06-21,Pool,3,3,3,2,0,2,4,0,2,1,3,1,0,12,13,1,0,1,2,2,0,0,2,0,0,0,0
Gijs JORNA,Netherlands,Outside Hitter,Men,Slovenia,2022-06-21,Pool,3,3,0,0,0,1,1,0,0,0,0,0,0,3,3,3,0,4,7,1,0,0,1,0,0,0,0
Fabian PLAK,Netherlands,Middle Blocker,Men,Slovenia,2022-06-21,Pool,3,3,1,1,0,0,1,0,1,0,1,0,0,0,0,0,0,0,0,0,0,0,0,0,0,0,0
Steven OTTEVANGER,Netherlands,Libero,Men,Slovenia,2022-06-21,Pool,3,3,0,0,0,0,0,0,0,0,0,0,0,0,0,0,0,0,0,0,0,0,0,0,0,0,0
Stijn VAN TILBURG,Netherlands,Outside Hitter,Men,Slovenia,2022-06-21,Pool,3,3,0,0,0,0,0,0,0,0,0,0,0,0,0,0,0,0,0,0,0,0,0,0,0,0,0
Bennie Junior TUINSTRA,Netherlands,Outside Hitter,Men,Slovenia,2022-06-21,Pool,3,3,13,10,4,4,18,1,3,2,6,2,2,10,14,2,0,10,12,6,2,0,8,0,0,3,3
Nimir ABDEL-AZIZ,Netherlands,Opposite Spiker,Men,Slovenia,2022-06-21,Pool,3,3,18,15,6,13,34,0,3,4,7,3,5,3,11,0,0,0,0,6,2,1,9,1,0,2,3
Gijs VAN SOLKEMA,Netherlands,Setter,Men,Slovenia,2022-06-21,Pool,3,3,0,0,0,0,0,0,0,0,0,0,0,0,0,0,0,0,0,0,0,0,0,0,0,0,0
Michael PARKINSON,Netherlands,Middle Blocker,Men,Slovenia,2022-06-21,Pool,3,3,0,0,0,0,0,0,0,0,0,0,0,0,0,0,0,0,0,0,0,0,0,0,0,0,0
Robbert ANDRINGA,Netherlands,Libero,Men,Slovenia,2022-06-21,Pool,3,3,0,0,0,0,0,0,0,0,0,0,0,0,0,3,0,7,10,7,2,1,10,0,0,4,4
Twan WILTENBURG,Netherlands,Middle Blocker,Men,Slovenia,2022-06-21,Pool,3,3,4,1,2,1,4,2,3,10,15,1,1,8,10,0,0,1,1,1,3,0,4,0,0,1,1
Wessel KEEMINK,Netherlands,Setter,Men,Australia,2022-06-12,Pool,3,3,3,2,0,0,2,1,1,1,3,0,1,6,7,0,0,0,0,2,0,0,2,22,0,38,60
Maarten VAN GARDEREN,Netherlands,Outside Hitter,Men,Australia,2022-06-12,Pool,3,3,5,2,1,5,8,2,2,0,4,1,2,4,7,8,0,5,13,2,0,1,3,1,0,0,1
Thijs TER HORST,Netherlands,Outside Hitter,Men,Australia,2022-06-12,Pool,3,3,3,2,2,4,8,1,1,2,4,0,3,1,4,4,1,4,9,5,0,0,5,1,0,0,1
Luuc VAN DER ENT,Netherlands,Middle Blocker,Men,Australia,2022-06-12,Pool,3,3,1,0,0,1,1,0,3,3,6,1,0,3,4,1,0,0,1,0,0,0,0,0,0,0,0
Gijs JORNA,Netherlands,Outside Hitter,Men,Australia,2022-06-12,Pool,3,3,0,0,0,0,0,0,0,0,0,0,1,3,4,4,0,3,7,1,1,0,2,1,0,0,1
Fabian PLAK,Netherlands,Middle Blocker,Men,Australia,2022-06-12,Pool,3,3,10,10,0,1,11,0,3,4,7,0,2,11,13,0,0,0,0,2,0,0,2,0,0,0,0
Steven OTTEVANGER,Netherlands,Libero,Men,Australia,2022-06-12,Pool,3,3,0,0,0,0,0,0,0,0,0,0,0,0,0,0,0,0,0,0,0,0,0,0,0,0,0
Stijn VAN TILBURG,Netherlands,Outside Hitter,Men,Australia,2022-06-12,Pool,3,3,0,0,0,0,0,0,0,0,0,0,0,0,0,0,0,0,0,0,0,0,0,0,0,0,0
Bennie Junior TUINSTRA,Netherlands,Outside Hitter,Men,Australia,2022-06-12,Pool,3,3,5,4,2,3,9,0,2,0,2,1,1,4,6,1,0,6,7,2,0,1,3,1,0,1,2
Nimir ABDEL-AZIZ,Netherlands,Opposite Spiker,Men,Australia,2022-06-12,Pool,3,3,20,14,2,8,24,1,3,1,5,5,6,7,18,0,0,0,0,2,2,0,4,1,0,0,1
Gijs VAN SOLKEMA,Netherlands,Setter,Men,Australia,2022-06-12,Pool,3,3,0,0,0,0,0,0,0,0,0,0,0,0,0,0,0,0,0,0,0,0,0,0,0,0,0
Michael PARKINSON,Netherlands,Middle Blocker,Men,Australia,2022-06-12,Pool,3,3,0,0,0,0,0,0,0,0,0,0,0,0,0,0,0,0,0,0,0,0,0,0,0,0,0
Robbert ANDRINGA,Netherlands,Libero,Men,Australia,2022-06-12,Pool,3,3,0,0,0,0,0,0,0,0,0,0,0,0,0,2,0,6,8,6,1,0,7,0,0,0,0
Twan WILTENBURG,Netherlands,Middle Blocker,Men,Australia,2022-06-12,Pool,3,3,5,3,0,1,4,1,2,0,3,1,0,9,10,0,0,0,0,0,1,1,2,0,0,0,0
Wessel KEEMINK,Netherlands,Setter,Men,Iran,2022-06-10,Pool,3,3,0,0,0,1,1,0,1,2,3,0,0,12,12,0,3,0,3,3,1,1,5,25,0,46,71
Maarten VAN GARDEREN,Netherlands,Outside Hitter,Men,Iran,2022-06-10,Pool,3,3,0,0,0,0,0,0,0,0,0,0,0,0,0,0,0,0,0,0,0,0,0,0,0,0,0
Thijs TER HORST,Netherlands,Outside Hitter,Men,Iran,2022-06-10,Pool,3,3,14,14,1,5,20,0,1,4,5,0,3,5,8,0,0,7,7,5,2,1,8,0,0,1,1
Luuc VAN DER ENT,Netherlands,Middle Blocker,Men,Iran,2022-06-10,Pool,3,3,1,0,0,0,0,1,0,0,1,0,0,0,0,0,0,0,0,0,0,0,0,0,0,0,0
Gijs JORNA,Netherlands,Outside Hitter,Men,Iran,2022-06-10,Pool,3,3,0,0,0,0,0,0,0,0,0,0,0,2,2,0,0,2,2,0,0,0,0,0,0,0,0
Fabian PLAK,Netherlands,Middle Blocker,Men,Iran,2022-06-10,Pool,3,3,11,8,1,2,11,3,5,2,10,0,4,9,13,0,1,0,1,5,1,1,7,0,1,0,1
Steven OTTEVANGER,Netherlands,Libero,Men,Iran,2022-06-10,Pool,3,3,0,0,0,0,0,0,0,0,0,0,0,0,0,0,0,0,0,0,0,0,0,0,0,0,0
Stijn VAN TILBURG,Netherlands,Outside Hitter,Men,Iran,2022-06-10,Pool,3,3,0,0,0,0,0,0,0,0,0,0,0,0,0,0,0,0,0,0,0,0,0,0,0,0,0
Bennie Junior TUINSTRA,Netherlands,Outside Hitter,Men,Iran,2022-06-10,Pool,3,3,8,7,2,4,13,1,3,1,5,0,5,10,15,4,2,13,19,6,0,0,6,1,0,0,1
Nimir ABDEL-AZIZ,Netherlands,Opposite Spiker,Men,Iran,2022-06-10,Pool,3,3,20,17,1,10,28,1,1,2,4,2,5,8,15,0,0,1,1,2,2,0,4,0,0,0,0
Gijs VAN SOLKEMA,Netherlands,Setter,Men,Iran,2022-06-10,Pool,3,3,0,0,0,0,0,0,0,0,0,0,0,0,0,0,0,0,0,0,0,0,0,0,0,0,0
Michael PARKINSON,Netherlands,Middle Blocker,Men,Iran,2022-06-10,Pool,3,3,0,0,0,0,0,0,0,0,0,0,0,0,0,0,0,0,0,0,0,0,0,0,0,0,0
Robbert ANDRINGA,Netherlands,Libero,Men,Iran,2022-06-10,Pool,3,3,0,0,0,0,0,0,0,0,0,0,0,0,0,6,1,17,24,6,1,1,8,1,0,1,2
Twan WILTENBURG,Netherlands,Middle Blocker,Men,Iran,2022-06-10,Pool,3,3,4,2,0,1,3,2,2,3,7,0,0,10,10,0,0,0,0,0,2,0,2,0,0,1,1
Wessel KEEMINK,Netherlands,Setter,Men,United States,2022-06-09,Pool,0,3,0,0,0,0,0,0,0,0,0,0,0,0,0,0,0,0,0,1,0,0,1,0,1,7,8
Maarten VAN GARDEREN,Netherlands,Outside Hitter,Men,United States,2022-06-09,Pool,0,3,2,2,0,1,3,0,0,0,0,0,1,2,3,0,0,1,1,0,1,1,2,0,0,0,0
Thijs TER HORST,Netherlands,Outside Hitter,Men,United States,2022-06-09,Pool,0,3,9,9,3,8,20,0,2,0,2,0,3,3,6,7,2,15,24,4,1,0,5,1,0,1,2
Luuc VAN DER ENT,Netherlands,Middle Blocker,Men,United States,2022-06-09,Pool,0,3,0,0,0,0,0,0,0,0,0,0,0,0,0,0,0,0,0,0,0,0,0,0,0,0,0
Gijs JORNA,Netherlands,Outside Hitter,Men,United States,2022-06-09,Pool,0,3,4,3,4,6,13,1,3,2,6,0,1,8,9,8,0,14,22,4,3,1,8,3,0,1,4
Fabian PLAK,Netherlands,Middle Blocker,Men,United States,2022-06-09,Pool,0,3,0,0,0,0,0,0,0,0,0,0,0,0,0,0,0,0,0,0,0,0,0,0,0,0,0
Steven OTTEVANGER,Netherlands,Libero,Men,United States,2022-06-09,Pool,0,3,0,0,0,0,0,0,0,0,0,0,0,0,0,0,0,0,0,0,0,0,0,0,0,0,0
Stijn VAN TILBURG,Netherlands,Outside Hitter,Men,United States,2022-06-09,Pool,0,3,7,6,5,10,21,1,2,0,3,0,1,8,9,0,0,0,0,2,0,0,2,0,0,0,0
Bennie Junior TUINSTRA,Netherlands,Outside Hitter,Men,United States,2022-06-09,Pool,0,3,2,2,0,1,3,0,1,0,1,0,1,0,1,0,0,0,0,0,0,0,0,1,0,0,1
Nimir ABDEL-AZIZ,Netherlands,Opposite Spiker,Men,United States,2022-06-09,Pool,0,3,0,0,0,0,0,0,0,0,0,0,0,0,0,0,0,0,0,0,0,0,0,0,0,0,0
Gijs VAN SOLKEMA,Netherlands,Setter,Men,United States,2022-06-09,Pool,0,3,1,0,0,1,1,1,0,3,4,0,0,3,3,0,0,0,0,2,1,0,3,15,4,37,56
Michael PARKINSON,Netherlands,Middle Blocker,Men,United States,2022-06-09,Pool,0,3,3,2,1,3,6,1,2,3,6,0,1,9,10,1,0,1,2,2,0,0,2,1,0,0,1
Robbert ANDRINGA,Netherlands,Libero,Men,United States,2022-06-09,Pool,0,3,0,0,0,0,0,0,0,0,0,0,0,0,0,2,3,9,14,2,4,0,6,3,0,0,3
Twan WILTENBURG,Netherlands,Middle Blocker,Men,United States,2022-06-09,Pool,0,3,3,2,0,2,4,1,1,1,3,0,1,5,6,0,0,2,2,0,0,0,0,0,0,0,0
Wessel KEEMINK,Netherlands,Setter,Men,Japan,2022-06-08,Pool,1,4,3,1,0,2,3,2,5,2,9,0,0,10,10,1,0,0,1,3,2,1,6,20,0,54,74
Maarten VAN GARDEREN,Netherlands,Outside Hitter,Men,Japan,2022-06-08,Pool,1,4,14,12,8,9,29,2,3,1,6,0,5,9,14,4,1,19,24,4,2,1,7,1,0,0,1
Thijs TER HORST,Netherlands,Outside Hitter,Men,Japan,2022-06-08,Pool,1,4,1,1,0,1,2,0,0,0,0,0,0,1,1,1,0,0,1,0,0,0,0,0,0,0,0
Luuc VAN DER ENT,Netherlands,Middle Blocker,Men,Japan,2022-06-08,Pool,1,4,3,0,1,3,4,2,6,4,12,1,1,9,11,0,0,1,1,1,0,0,1,0,0,0,0
Gijs JORNA,Netherlands,Outside Hitter,Men,Japan,2022-06-08,Pool,1,4,1,1,1,1,3,0,0,0,0,0,0,1,1,1,1,1,3,3,0,1,4,0,0,0,0
Fabian PLAK,Netherlands,Middle Blocker,Men,Japan,2022-06-08,Pool,1,4,9,6,0,4,10,2,4,5,11,1,2,13,16,1,0,1,2,2,0,1,3,0,0,1,1
Steven OTTEVANGER,Netherlands,Libero,Men,Japan,2022-06-08,Pool,1,4,0,0,0,0,0,0,0,0,0,0,0,0,0,0,0,0,0,0,0,0,0,0,0,0,0
Stijn VAN TILBURG,Netherlands,Outside Hitter,Men,Japan,2022-06-08,Pool,1,4,0,0,0,0,0,0,0,0,0,0,0,1,1,0,0,0,0,1,0,0,1,0,0,0,0
Bennie Junior TUINSTRA,Netherlands,Outside Hitter,Men,Japan,2022-06-08,Pool,1,4,11,10,4,9,23,1,2,2,5,0,0,12,12,9,3,24,36,7,2,0,9,2,0,1,3
Nimir ABDEL-AZIZ,Netherlands,Opposite Spiker,Men,Japan,2022-06-08,Pool,1,4,18,17,6,8,31,0,2,3,5,1,7,10,18,0,0,1,1,4,1,2,7,1,0,3,4
Gijs VAN SOLKEMA,Netherlands,Setter,Men,Japan,2022-06-08,Pool,1,4,0,0,0,0,0,0,0,0,0,0,0,0,0,0,0,0,0,0,0,0,0,0,2,13,15
Michael PARKINSON,Netherlands,Middle Blocker,Men,Japan,2022-06-08,Pool,1,4,0,0,0,0,0,0,0,1,1,0,1,2,3,0,0,0,0,0,0,0,0,0,0,0,0
Robbert ANDRINGA,Netherlands,Libero,Men,Japan,2022-06-08,Pool,1,4,0,0,0,0,0,0,0,0,0,0,0,0,0,3,1,9,13,6,0,0,6,2,0,2,4
Twan WILTENBURG,Netherlands,Middle Blocker,Men,Japan,2022-06-08,Pool,1,4,0,0,0,0,0,0,0,0,0,0,0,2,2,0,0,0,0,0,1,0,1,0,0,0,0
Bartlomiej LIPINSKI,Poland,Outside Hitter,Men,France,2022-06-12,Pool,3,4,0,0,1,0,1,0,0,0,0,0,0,1,1,0,0,0,0,0,0,0,0,0,0,0,0
Maciej MUZAJ,Poland,Opposite Spiker,Men,France,2022-06-12,Pool,3,4,0,0,0,0,0,0,0,0,0,0,0,0,0,0,0,0,0,0,0,0,0,0,0,0,0
Jakub POPIWCZAK,Poland,Libero,Men,France,2022-06-12,Pool,3,4,0,0,0,0,0,0,0,0,0,0,0,0,0,2,3,15,20,8,4,0,12,0,0,3,3
Lukasz KOZUB,Poland,Setter,Men,France,2022-06-12,Pool,3,4,0,0,0,0,0,0,0,0,0,0,0,0,0,0,0,0,0,0,0,0,0,0,0,0,0
Karol KLOS,Poland,Middle Blocker,Men,France,2022-06-12,Pool,3,4,2,0,1,2,3,2,2,0,4,0,1,4,5,0,0,0,0,0,0,0,0,0,0,0,0
Rafal SZYMURA,Poland,Outside Hitter,Men,France,2022-06-12,Pool,3,4,0,0,1,2,3,0,0,1,1,0,0,1,1,0,2,3,5,2,0,0,2,0,0,0,0
Jakub KOCHANOWSKI,Poland,Middle Blocker,Men,France,2022-06-12,Pool,3,4,10,7,0,4,11,3,5,7,15,0,2,9,11,0,0,0,0,2,0,2,4,0,0,1,1
Bartosz KWOLEK,Poland,Outside Hitter,Men,France,2022-06-12,Pool,3,4,11,10,1,5,16,0,1,2,3,1,2,10,13,7,0,19,26,5,2,0,7,1,0,3,4
Tomasz FORNAL,Poland,Outside Hitter,Men,France,2022-06-12,Pool,3,4,16,12,6,12,30,2,4,4,10,2,4,8,14,2,3,13,18,6,1,1,8,0,0,1,1
Karol URBANOWICZ,Poland,Middle Blocker,Men,France,2022-06-12,Pool,3,4,0,0,0,0,0,0,0,0,0,0,0,0,0,0,0,0,0,0,0,0,0,0,0,0,0
Karol BUTRYN,Poland,Opposite Spiker,Men,France,2022-06-12,Pool,3,4,22,16,7,6,29,3,3,1,7,3,3,16,22,0,0,0,0,6,3,2,11,0,0,4,4
Kamil SZYMURA,Poland,Libero,Men,France,2022-06-12,Pool,3,4,0,0,0,0,0,0,0,0,0,0,0,0,0,0,0,0,0,0,0,0,0,0,0,0,0
Mateusz POREBA,Poland,Middle Blocker,Men,France,2022-06-12,Pool,3,4,3,2,0,1,3,0,2,3,5,1,1,12,14,0,0,0,0,1,1,1,3,0,0,3,3
Jan FIRLEJ,Poland,Setter,Men,France,2022-06-12,Pool,3,4,0,0,0,1,1,0,3,3,6,0,1,13,14,0,1,0,1,5,7,4,16,25,0,55,80
Bartlomiej LIPINSKI,Poland,Outside Hitter,Men,Bulgaria,2022-06-11,Pool,3,3,12,11,4,12,27,0,3,2,5,1,3,9,13,3,0,12,15,7,2,3,12,0,0,1,1
Maciej MUZAJ,Poland,Opposite Spiker,Men,Bulgaria,2022-06-11,Pool,3,3,13,12,1,4,17,1,3,3,7,0,4,7,11,0,0,0,0,4,4,1,9,0,0,1,1
Jakub POPIWCZAK,Poland,Libero,Men,Bulgaria,2022-06-11,Pool,3,3,0,0,0,0,0,0,0,0,0,0,0,0,0,0,0,0,0,0,0,1,1,0,0,0,0
Lukasz KOZUB,Poland,Setter,Men,Bulgaria,2022-06-11,Pool,3,3,2,1,0,0,1,1,1,3,5,0,0,7,7,0,0,1,1,1,0,4,5,39,0,32,71
Karol KLOS,Poland,Middle Blocker,Men,Bulgaria,2022-06-11,Pool,3,3,5,3,1,0,4,1,1,2,4,1,1,7,9,0,1,0,1,1,0,1,2,0,0,0,0
Rafal SZYMURA,Poland,Outside Hitter,Men,Bulgaria,2022-06-11,Pool,3,3,0,0,0,1,1,0,0,0,0,0,0,0,0,0,0,0,0,0,0,0,0,0,0,0,0
Jakub KOCHANOWSKI,Poland,Middle Blocker,Men,Bulgaria,2022-06-11,Pool,3,3,0,0,0,0,0,0,0,0,0,0,0,0,0,0,0,0,0,0,0,0,0,0,0,0,0
Bartosz KWOLEK,Poland,Outside Hitter,Men,Bulgaria,2022-06-11,Pool,3,3,12,10,2,8,20,0,3,1,4,2,1,12,15,7,1,14,22,3,1,2,6,0,1,2,3
Tomasz FORNAL,Poland,Outside Hitter,Men,Bulgaria,2022-06-11,Pool,3,3,0,0,0,0,0,0,0,0,0,0,0,0,0,0,0,0,0,0,0,0,0,0,0,0,0
Karol URBANOWICZ,Poland,Middle Blocker,Men,Bulgaria,2022-06-11,Pool,3,3,4,3,2,3,8,0,3,4,7,1,1,4,6,0,0,2,2,1,0,1,2,0,0,2,2
Karol BUTRYN,Poland,Opposite Spiker,Men,Bulgaria,2022-06-11,Pool,3,3,0,0,0,0,0,0,0,0,0,0,0,0,0,0,0,0,0,0,0,0,0,0,0,0,0
Kamil SZYMURA,Poland,Libero,Men,Bulgaria,2022-06-11,Pool,3,3,0,0,0,0,0,0,0,0,0,0,0,0,0,1,0,6,7,8,2,3,13,0,0,4,4
Mateusz POREBA,Poland,Middle Blocker,Men,Bulgaria,2022-06-11,Pool,3,3,6,4,1,0,5,1,4,4,9,1,0,12,13,1,0,0,1,1,1,1,3,0,0,0,0
Jan FIRLEJ,Poland,Setter,Men,Bulgaria,2022-06-11,Pool,3,3,0,0,0,0,0,0,0,0,0,0,0,0,0,0,0,0,0,0,0,0,0,0,0,0,0
Bartlomiej LIPINSKI,Poland,Outside Hitter,Men,Italy,2022-06-09,Pool,1,4,0,0,0,0,0,0,0,0,0,0,0,0,0,0,0,0,0,0,0,0,0,0,0,0,0
Maciej MUZAJ,Poland,Opposite Spiker,Men,Italy,2022-06-09,Pool,1,4,0,0,0,1,1,0,1,0,1,0,0,0,0,0,0,0,0,0,0,0,0,0,0,0,0
Jakub POPIWCZAK,Poland,Libero,Men,Italy,2022-06-09,Pool,1,4,0,0,0,0,0,0,0,0,0,0,0,0,0,3,2,16,21,1,3,3,7,0,0,3,3
Lukasz KOZUB,Poland,Setter,Men,Italy,2022-06-09,Pool,1,4,0,0,0,0,0,0,0,0,0,0,0,0,0,0,0,0,0,0,0,1,1,1,0,0,1
Karol KLOS,Poland,Middle Blocker,Men,Italy,2022-06-09,Pool,1,4,0,0,0,0,0,0,1,0,1,0,0,1,1,0,0,0,0,1,0,0,1,0,0,0,0
Rafal SZYMURA,Poland,Outside Hitter,Men,Italy,2022-06-09,Pool,1,4,13,13,4,9,26,0,4,5,9,0,1,13,14,10,3,13,26,7,2,2,11,0,0,6,6
Jakub KOCHANOWSKI,Poland,Middle Blocker,Men,Italy,2022-06-09,Pool,1,4,5,4,2,3,9,1,3,2,6,0,4,8,12,1,0,2,3,1,0,0,1,0,0,0,0
Bartosz KWOLEK,Poland,Outside Hitter,Men,Italy,2022-06-09,Pool,1,4,0,0,1,0,1,0,1,0,1,0,0,3,3,0,0,2,2,0,0,0,0,0,0,0,0
Tomasz FORNAL,Poland,Outside Hitter,Men,Italy,2022-06-09,Pool,1,4,12,10,4,7,21,2,0,10,12,0,8,3,11,4,0,14,18,2,3,4,9,1,0,3,4
Karol URBANOWICZ,Poland,Middle Blocker,Men,Italy,2022-06-09,Pool,1,4,0,0,0,0,0,0,0,0,0,0,0,0,0,0,0,0,0,0,0,0,0,0,0,0,0
Karol BUTRYN,Poland,Opposite Spiker,Men,Italy,2022-06-09,Pool,1,4,19,16,5,5,26,1,4,4,9,2,3,12,17,0,0,2,2,1,2,3,6,0,0,0,0
Kamil SZYMURA,Poland,Libero,Men,Italy,2022-06-09,Pool,1,4,0,0,0,0,0,0,0,0,0,0,0,0,0,0,0,0,0,0,0,0,0,0,0,0,0
Mateusz POREBA,Poland,Middle Blocker,Men,Italy,2022-06-09,Pool,1,4,8,4,3,2,9,2,6,3,11,2,3,14,19,0,0,1,1,5,0,2,7,0,0,1,1
Jan FIRLEJ,Poland,Setter,Men,Italy,2022-06-09,Pool,1,4,0,0,0,2,2,0,5,1,6,0,4,8,12,0,0,0,0,6,1,1,8,43,1,36,80
Bartlomiej LIPINSKI,Poland,Outside Hitter,Men,Argentina,2022-06-08,Pool,3,3,0,0,0,0,0,0,0,0,0,0,0,0,0,0,0,0,0,0,0,0,0,0,0,0,0
Maciej MUZAJ,Poland,Opposite Spiker,Men,Argentina,2022-06-08,Pool,3,3,10,9,6,9,24,1,0,2,3,0,2,9,11,0,0,0,0,3,1,1,5,0,1,1,2
Jakub POPIWCZAK,Poland,Libero,Men,Argentina,2022-06-08,Pool,3,3,0,0,0,0,0,0,0,0,0,0,0,0,0,7,0,5,12,10,2,2,14,0,0,7,7
Lukasz KOZUB,Poland,Setter,Men,Argentina,2022-06-08,Pool,3,3,0,0,0,0,0,0,0,0,0,0,0,0,0,0,0,0,0,0,0,0,0,0,0,0,0
Karol KLOS,Poland,Middle Blocker,Men,Argentina,2022-06-08,Pool,3,3,9,5,0,3,8,3,3,4,10,1,1,9,11,0,0,1,1,0,1,0,1,0,0,3,3
Rafal SZYMURA,Poland,Outside Hitter,Men,Argentina,2022-06-08,Pool,3,3,0,0,0,0,0,0,0,0,0,0,0,0,0,0,0,0,0,0,0,0,0,0,0,0,0
Jakub KOCHANOWSKI,Poland,Middle Blocker,Men,Argentina,2022-06-08,Pool,3,3,7,5,0,1,6,1,6,9,16,1,5,9,15,0,0,0,0,2,0,0,2,0,0,1,1
Bartosz KWOLEK,Poland,Outside Hitter,Men,Argentina,2022-06-08,Pool,3,3,8,7,4,4,15,1,2,2,5,0,3,7,10,6,2,17,25,5,2,1,8,0,0,1,1
Tomasz FORNAL,Poland,Outside Hitter,Men,Argentina,2022-06-08,Pool,3,3,14,14,1,12,27,0,2,4,6,0,4,8,12,2,0,10,12,7,1,0,8,0,0,5,5
Karol URBANOWICZ,Poland,Middle Blocker,Men,Argentina,2022-06-08,Pool,3,3,0,0,0,0,0,0,0,0,0,0,0,0,0,0,0,0,0,0,0,0,0,0,0,0,0
Karol BUTRYN,Poland,Opposite Spiker,Men,Argentina,2022-06-08,Pool,3,3,3,3,0,0,3,0,0,0,0,0,2,1,3,0,0,0,0,1,0,0,1,0,0,0,0
Kamil SZYMURA,Poland,Libero,Men,Argentina,2022-06-08,Pool,3,3,0,0,0,0,0,0,0,0,0,0,0,0,0,0,0,0,0,0,0,0,0,0,0,0,0
Mateusz POREBA,Poland,Middle Blocker,Men,Argentina,2022-06-08,Pool,3,3,0,0,0,0,0,0,0,0,0,0,0,0,0,0,0,0,0,0,0,0,0,0,0,0,0
Jan FIRLEJ,Poland,Setter,Men,Argentina,2022-06-08,Pool,3,3,4,2,0,0,2,1,2,3,6,1,0,11,12,0,1,1,2,9,4,0,13,26,0,40,66
Jakub POPIWCZAK,Poland,Libero,Men,Italy,2022-07-24,Finals (Bronze),3,3,0,0,0,0,0,0,0,0,0,0,0,0,0,0,0,0,0,0,0,0,0,0,0,0,0
Lukasz KACZMAREK,Poland,Opposite Spiker,Men,Italy,2022-07-24,Finals (Bronze),3,3,0,0,0,0,0,0,0,0,0,0,0,0,0,0,0,0,0,0,0,0,0,0,0,0,0
Bartosz KUREK,Poland,Opposite Spiker,Men,Italy,2022-07-24,Finals (Bronze),3,3,13,10,3,12,25,0,0,5,5,3,4,7,14,0,0,0,0,8,1,1,10,0,0,3,3
Karol KLOS,Poland,Middle Blocker,Men,Italy,2022-07-24,Finals (Bronze),3,3,0,0,0,0,0,0,0,0,0,0,0,0,0,0,0,0,0,0,0,0,0,0,0,0,0
Bartosz BEDNORZ,Poland,Outside Hitter,Men,Italy,2022-07-24,Finals (Bronze),3,3,0,0,0,0,0,0,0,0,0,0,0,0,0,0,0,0,0,0,0,0,0,0,0,0,0
Grzegorz LOMACZ,Poland,Setter,Men,Italy,2022-07-24,Finals (Bronze),3,3,0,0,0,0,0,0,0,0,0,0,0,0,0,0,0,0,0,0,0,0,0,0,0,0,0
Aleksander SLIWKA,Poland,Outside Hitter,Men,Italy,2022-07-24,Finals (Bronze),3,3,1,1,0,3,4,0,1,2,3,0,0,1,1,2,0,6,8,5,0,0,5,0,0,1,1
Jakub KOCHANOWSKI,Poland,Middle Blocker,Men,Italy,2022-07-24,Finals (Bronze),3,3,6,5,0,1,6,0,3,3,6,1,5,9,15,1,0,0,1,2,0,0,2,0,0,1,1
Kamil SEMENIUK,Poland,Outside Hitter,Men,Italy,2022-07-24,Finals (Bronze),3,3,12,9,0,12,21,1,6,0,7,2,2,12,16,3,0,4,7,5,1,1,7,0,0,0,0
Pawel ZATORSKI,Poland,Libero,Men,Italy,2022-07-24,Finals (Bronze),3,3,0,0,0,0,0,0,0,0,0,0,0,0,0,6,1,8,15,5,2,0,7,0,0,1,1
Marcin JANUSZ,Poland,Setter,Men,Italy,2022-07-24,Finals (Bronze),3,3,1,0,0,0,0,1,2,5,8,0,2,5,7,0,0,0,0,4,1,0,5,13,1,51,65
Mateusz BIENIEK,Poland,Middle Blocker,Men,Italy,2022-07-24,Finals (Bronze),3,3,10,6,2,2,10,1,6,5,12,3,1,8,12,0,0,0,0,1,0,0,1,0,0,3,3
Tomasz FORNAL,Poland,Outside Hitter,Men,Italy,2022-07-24,Finals (Bronze),3,3,6,6,0,2,8,0,0,0,0,0,2,3,5,9,0,8,17,3,0,0,3,0,0,3,3
Karol BUTRYN,Poland,Opposite Spiker,Men,Italy,2022-07-24,Finals (Bronze),3,3,1,0,0,0,0,0,0,0,0,1,1,2,4,0,0,0,0,1,0,0,1,0,0,0,0
Jakub POPIWCZAK,Poland,Libero,Men,United States,2022-07-23,Semifinals,0,3,0,0,0,0,0,0,0,0,0,0,0,0,0,0,0,0,0,0,0,0,0,0,0,0,0
Lukasz KACZMAREK,Poland,Opposite Spiker,Men,United States,2022-07-23,Semifinals,0,3,1,1,0,0,1,0,2,0,2,0,0,0,0,0,0,0,0,0,0,0,0,0,0,0,0
Bartosz KUREK,Poland,Opposite Spiker,Men,United States,2022-07-23,Semifinals,0,3,11,10,3,11,24,0,1,1,2,1,3,7,11,0,0,0,0,2,4,0,6,0,0,1,1
Karol KLOS,Poland,Middle Blocker,Men,United States,2022-07-23,Semifinals,0,3,0,0,0,0,0,0,0,0,0,0,0,0,0,0,0,0,0,0,0,0,0,0,0,0,0
Bartosz BEDNORZ,Poland,Outside Hitter,Men,United States,2022-07-23,Semifinals,0,3,2,2,0,2,4,0,0,1,1,0,1,3,4,1,3,2,6,0,1,0,1,0,0,0,0
Grzegorz LOMACZ,Poland,Setter,Men,United States,2022-07-23,Semifinals,0,3,0,0,0,0,0,0,1,0,1,0,0,1,1,0,0,0,0,0,0,0,0,5,0,6,11
Aleksander SLIWKA,Poland,Outside Hitter,Men,United States,2022-07-23,Semifinals,0,3,4,4,2,4,10,0,1,0,1,0,3,1,4,4,1,9,14,3,2,1,6,0,0,2,2
Jakub KOCHANOWSKI,Poland,Middle Blocker,Men,United States,2022-07-23,Semifinals,0,3,7,4,1,2,7,1,3,4,8,2,1,10,13,0,0,0,0,3,0,1,4,0,0,0,0
Kamil SEMENIUK,Poland,Outside Hitter,Men,United States,2022-07-23,Semifinals,0,3,7,7,5,8,20,0,2,0,2,0,3,4,7,8,0,14,22,4,0,0,4,0,0,0,0
Pawel ZATORSKI,Poland,Libero,Men,United States,2022-07-23,Semifinals,0,3,0,0,0,0,0,0,0,0,0,0,0,0,0,3,2,3,8,2,2,0,4,0,0,1,1
Marcin JANUSZ,Poland,Setter,Men,United States,2022-07-23,Semifinals,0,3,1,0,0,0,0,1,0,1,2,0,0,5,5,0,1,0,1,1,0,2,3,11,0,50,61
Mateusz BIENIEK,Poland,Middle Blocker,Men,United States,2022-07-23,Semifinals,0,3,5,4,0,2,6,0,2,3,5,1,3,6,10,0,0,1,1,1,0,0,1,0,0,0,0
Tomasz FORNAL,Poland,Outside Hitter,Men,United States,2022-07-23,Semifinals,0,3,2,2,0,2,4,0,0,0,0,0,2,1,3,4,2,5,11,1,0,0,1,0,0,0,0
Karol BUTRYN,Poland,Opposite Spiker,Men,United States,2022-07-23,Semifinals,0,3,0,0,0,0,0,0,0,0,0,0,0,1,1,0,0,0,0,0,1,0,1,0,0,1,1
Jakub POPIWCZAK,Poland,Libero,Men,Iran,2022-07-21,Quarterfinals,3,5,0,0,0,0,0,0,0,0,0,0,0,0,0,0,0,0,0,0,0,0,0,0,0,0,0
Lukasz KACZMAREK,Poland,Opposite Spiker,Men,Iran,2022-07-21,Quarterfinals,3,5,3,3,0,3,6,0,0,0,0,0,1,2,3,0,0,0,0,0,0,0,0,0,0,0,0
Bartosz KUREK,Poland,Opposite Spiker,Men,Iran,2022-07-21,Quarterfinals,3,5,15,13,5,10,28,1,1,5,7,1,6,6,13,0,0,0,0,1,5,0,6,0,0,2,2
Karol KLOS,Poland,Middle Blocker,Men,Iran,2022-07-21,Quarterfinals,3,5,6,2,1,0,3,3,2,0,5,1,1,10,12,1,0,0,1,0,0,2,2,0,0,0,0
Bartosz BEDNORZ,Poland,Outside Hitter,Men,Iran,2022-07-21,Quarterfinals,3,5,0,0,0,1,1,0,0,0,0,0,0,0,0,1,0,2,3,0,0,0,0,0,0,0,0
Grzegorz LOMACZ,Poland,Setter,Men,Iran,2022-07-21,Quarterfinals,3,5,0,0,0,0,0,0,1,0,1,0,0,3,3,0,0,0,0,1,1,0,2,3,0,15,18
Aleksander SLIWKA,Poland,Outside Hitter,Men,Iran,2022-07-21,Quarterfinals,3,5,10,10,1,7,18,0,1,3,4,0,2,6,8,5,1,15,21,5,5,0,10,1,0,2,3
Jakub KOCHANOWSKI,Poland,Middle Blocker,Men,Iran,2022-07-21,Quarterfinals,3,5,6,1,1,3,5,2,0,2,4,3,2,7,12,0,0,1,1,2,0,0,2,0,0,0,0
Kamil SEMENIUK,Poland,Outside Hitter,Men,Iran,2022-07-21,Quarterfinals,3,5,17,15,3,12,30,2,3,2,7,0,3,10,13,9,1,12,22,4,1,0,5,0,0,1,1
Pawel ZATORSKI,Poland,Libero,Men,Iran,2022-07-21,Quarterfinals,3,5,0,0,0,0,0,0,0,0,0,0,0,0,0,9,3,12,24,14,5,1,20,0,0,2,2
Marcin JANUSZ,Poland,Setter,Men,Iran,2022-07-21,Quarterfinals,3,5,0,0,0,0,0,0,3,0,3,0,1,11,12,0,0,0,0,3,2,0,5,14,0,66,80
Mateusz BIENIEK,Poland,Middle Blocker,Men,Iran,2022-07-21,Quarterfinals,3,5,9,6,0,3,9,2,2,4,8,1,3,14,18,1,0,1,2,3,2,0,5,0,0,0,0
Tomasz FORNAL,Poland,Outside Hitter,Men,Iran,2022-07-21,Quarterfinals,3,5,0,0,0,3,3,0,1,0,1,0,2,0,2,1,1,2,4,0,2,0,2,0,0,0,0
Karol BUTRYN,Poland,Opposite Spiker,Men,Iran,2022-07-21,Quarterfinals,3,5,0,0,0,0,0,0,0,0,0,0,2,6,8,0,0,0,0,1,0,0,1,0,0,0,0
Jakub POPIWCZAK,Poland,Libero,Men,Slovenia,2022-07-10,Pool,3,4,0,0,0,0,0,0,0,0,0,0,0,0,0,0,0,0,0,0,0,0,0,0,0,0,0
Lukasz KACZMAREK,Poland,Opposite Spiker,Men,Slovenia,2022-07-10,Pool,3,4,1,0,1,1,2,1,0,0,1,0,0,3,3,0,0,0,0,1,0,0,1,0,0,0,0
Bartosz KUREK,Poland,Opposite Spiker,Men,Slovenia,2022-07-10,Pool,3,4,23,14,3,8,25,4,1,0,5,5,6,8,19,0,0,0,0,2,0,0,2,0,0,0,0
Karol KLOS,Poland,Middle Blocker,Men,Slovenia,2022-07-10,Pool,3,4,2,0,0,0,0,2,0,0,2,0,0,2,2,0,0,0,0,0,0,0,0,0,0,0,0
Bartosz BEDNORZ,Poland,Outside Hitter,Men,Slovenia,2022-07-10,Pool,3,4,0,0,0,0,0,0,0,0,0,0,0,0,0,0,0,0,0,0,0,0,0,0,0,0,0
Aleksander SLIWKA,Poland,Outside Hitter,Men,Slovenia,2022-07-10,Pool,3,4,8,6,0,5,11,2,3,0,5,0,2,4,6,1,3,14,18,1,1,1,3,0,0,0,0
Jakub KOCHANOWSKI,Poland,Middle Blocker,Men,Slovenia,2022-07-10,Pool,3,4,6,4,2,1,7,1,1,0,2,1,2,9,12,0,0,2,2,2,0,0,2,0,0,0,0
Kamil SEMENIUK,Poland,Outside Hitter,Men,Slovenia,2022-07-10,Pool,3,4,13,11,3,11,25,1,0,0,1,1,3,19,23,0,0,14,14,4,1,0,5,0,0,1,1
Pawel ZATORSKI,Poland,Libero,Men,Slovenia,2022-07-10,Pool,3,4,0,0,0,0,0,0,0,0,0,0,0,0,0,1,4,12,17,5,5,0,10,0,0,2,2
Marcin JANUSZ,Poland,Setter,Men,Slovenia,2022-07-10,Pool,3,4,0,0,0,0,0,0,0,0,0,0,2,7,9,0,0,0,0,0,1,1,2,15,0,61,76
Mateusz BIENIEK,Poland,Middle Blocker,Men,Slovenia,2022-07-10,Pool,3,4,9,7,0,2,9,1,5,0,6,1,4,15,20,0,0,1,1,0,0,0,0,0,0,0,0
Tomasz FORNAL,Poland,Outside Hitter,Men,Slovenia,2022-07-10,Pool,3,4,7,5,1,2,8,1,0,0,1,1,1,2,4,2,0,4,6,3,0,0,3,0,0,0,0
Karol BUTRYN,Poland,Opposite Spiker,Men,Slovenia,2022-07-10,Pool,3,4,0,0,0,0,0,0,0,0,0,0,0,0,0,0,0,0,0,0,0,0,0,0,0,0,0
Jan FIRLEJ,Poland,Setter,Men,Slovenia,2022-07-10,Pool,3,4,0,0,0,0,0,0,0,0,0,0,0,0,0,0,0,0,0,0,0,0,0,5,0,4,9
Jakub POPIWCZAK,Poland,Libero,Men,Netherlands,2022-07-09,Pool,3,3,0,0,0,0,0,0,0,0,0,0,0,0,0,0,0,0,0,0,0,0,0,0,0,0,0
Lukasz KACZMAREK,Poland,Opposite Spiker,Men,Netherlands,2022-07-09,Pool,3,3,0,0,0,0,0,0,0,0,0,0,0,1,1,0,0,0,0,0,0,0,0,0,0,0,0
Bartosz KUREK,Poland,Opposite Spiker,Men,Netherlands,2022-07-09,Pool,3,3,3,2,0,1,3,0,1,0,1,1,0,2,3,0,0,0,0,0,0,0,0,0,0,1,1
Karol KLOS,Poland,Middle Blocker,Men,Netherlands,2022-07-09,Pool,3,3,10,5,0,1,6,5,2,1,8,0,1,7,8,0,0,0,0,2,0,0,2,0,0,0,0
Bartosz BEDNORZ,Poland,Outside Hitter,Men,Netherlands,2022-07-09,Pool,3,3,6,5,1,0,6,0,0,0,0,1,2,3,6,0,3,7,10,1,3,0,4,0,0,0,0
Aleksander SLIWKA,Poland,Outside Hitter,Men,Netherlands,2022-07-09,Pool,3,3,5,5,0,3,8,0,0,0,0,0,1,9,10,0,1,6,7,2,0,1,3,0,0,0,0
Jakub KOCHANOWSKI,Poland,Middle Blocker,Men,Netherlands,2022-07-09,Pool,3,3,0,0,0,0,0,0,0,0,0,0,0,0,0,0,0,0,0,0,0,0,0,0,0,0,0
Kamil SEMENIUK,Poland,Outside Hitter,Men,Netherlands,2022-07-09,Pool,3,3,10,7,0,3,10,2,1,0,3,1,1,5,7,1,0,7,8,0,0,0,0,0,0,0,0
Pawel ZATORSKI,Poland,Libero,Men,Netherlands,2022-07-09,Pool,3,3,0,0,0,0,0,0,0,0,0,0,0,0,0,4,2,9,15,3,1,1,5,0,0,5,5
Marcin JANUSZ,Poland,Setter,Men,Netherlands,2022-07-09,Pool,3,3,0,0,0,0,0,0,4,0,4,0,0,9,9,0,0,1,1,2,3,1,6,12,0,41,53
Mateusz BIENIEK,Poland,Middle Blocker,Men,Netherlands,2022-07-09,Pool,3,3,7,6,2,1,9,0,6,1,7,1,2,10,13,0,0,0,0,0,0,0,0,0,0,0,0
Tomasz FORNAL,Poland,Outside Hitter,Men,Netherlands,2022-07-09,Pool,3,3,2,2,1,2,5,0,0,0,0,0,2,4,6,0,0,8,8,2,0,0,2,0,0,0,0
Karol BUTRYN,Poland,Opposite Spiker,Men,Netherlands,2022-07-09,Pool,3,3,9,9,4,1,14,0,3,0,3,0,2,9,11,0,0,0,0,1,1,0,2,0,0,0,0
Jan FIRLEJ,Poland,Setter,Men,Netherlands,2022-07-09,Pool,3,3,0,0,0,0,0,0,0,0,0,0,0,0,0,0,0,0,0,0,0,0,0,1,0,0,1
Jakub POPIWCZAK,Poland,Libero,Men,China,2022-07-07,Pool,3,3,0,0,0,0,0,0,0,0,0,0,0,0,0,5,0,10,15,4,0,0,4,0,0,2,2
Lukasz KACZMAREK,Poland,Opposite Spiker,Men,China,2022-07-07,Pool,3,3,10,7,4,5,16,1,1,0,2,2,2,10,14,0,0,0,0,2,1,0,3,0,0,0,0
Bartosz KUREK,Poland,Opposite Spiker,Men,China,2022-07-07,Pool,3,3,0,0,0,0,0,0,0,0,0,0,0,0,0,0,0,0,0,0,0,0,0,0,0,0,0
Karol KLOS,Poland,Middle Blocker,Men,China,2022-07-07,Pool,3,3,8,8,1,0,9,0,4,0,4,0,0,6,6,0,0,0,0,0,1,0,1,0,0,1,1
Bartosz BEDNORZ,Poland,Outside Hitter,Men,China,2022-07-07,Pool,3,3,0,0,0,0,0,0,0,0,0,0,0,0,0,0,0,0,0,0,0,0,0,0,0,0,0
Aleksander SLIWKA,Poland,Outside Hitter,Men,China,2022-07-07,Pool,3,3,0,0,0,0,0,0,0,0,0,0,0,0,0,0,0,0,0,0,0,0,0,0,0,0,0
Jakub KOCHANOWSKI,Poland,Middle Blocker,Men,China,2022-07-07,Pool,3,3,8,5,1,2,8,0,1,0,1,3,2,14,19,0,0,0,0,1,0,0,1,0,0,1,1
Kamil SEMENIUK,Poland,Outside Hitter,Men,China,2022-07-07,Pool,3,3,6,5,2,3,10,1,3,0,4,0,4,6,10,3,1,11,15,1,0,0,1,0,0,1,1
Pawel ZATORSKI,Poland,Libero,Men,China,2022-07-07,Pool,3,3,0,0,0,0,0,0,0,0,0,0,0,0,0,0,0,0,0,0,0,0,0,0,0,0,0
Marcin JANUSZ,Poland,Setter,Men,China,2022-07-07,Pool,3,3,0,0,0,0,0,0,0,0,0,0,0,0,0,0,0,0,0,0,0,0,0,0,0,4,4
Mateusz BIENIEK,Poland,Middle Blocker,Men,China,2022-07-07,Pool,3,3,2,0,0,0,0,0,0,0,0,2,0,1,3,0,0,0,0,0,1,0,1,0,0,0,0
Tomasz FORNAL,Poland,Outside Hitter,Men,China,2022-07-07,Pool,3,3,20,14,1,2,17,1,3,0,4,5,1,10,16,3,1,8,12,1,0,0,1,0,0,1,1
Karol BUTRYN,Poland,Opposite Spiker,Men,China,2022-07-07,Pool,3,3,0,0,1,0,1,0,0,0,0,0,1,0,1,0,0,0,0,0,0,0,0,0,0,0,0
Jan FIRLEJ,Poland,Setter,Men,China,2022-07-07,Pool,3,3,2,1,0,0,1,1,1,0,2,0,0,6,6,0,0,1,1,0,1,0,1,17,0,33,50
Jakub POPIWCZAK,Poland,Libero,Men,Iran,2022-07-05,Pool,2,5,0,0,0,0,0,0,0,0,0,0,0,0,0,0,0,0,0,0,1,0,1,0,0,0,0
Lukasz KACZMAREK,Poland,Opposite Spiker,Men,Iran,2022-07-05,Pool,2,5,1,1,0,1,2,0,0,0,0,0,0,1,1,0,0,0,0,0,0,0,0,0,0,0,0
Bartosz KUREK,Poland,Opposite Spiker,Men,Iran,2022-07-05,Pool,2,5,23,19,4,11,34,2,2,0,4,2,3,13,18,0,0,1,1,1,4,1,6,0,0,0,0
Karol KLOS,Poland,Middle Blocker,Men,Iran,2022-07-05,Pool,2,5,4,3,0,1,4,1,2,0,3,0,0,5,5,0,0,1,1,0,0,1,1,0,0,0,0
Bartosz BEDNORZ,Poland,Outside Hitter,Men,Iran,2022-07-05,Pool,2,5,17,16,8,6,30,1,1,0,2,0,6,9,15,5,2,22,29,1,0,0,1,0,0,3,3
Aleksander SLIWKA,Poland,Outside Hitter,Men,Iran,2022-07-05,Pool,2,5,10,9,0,8,17,0,2,0,2,1,6,10,17,3,2,28,33,5,3,0,8,0,0,3,3
Jakub KOCHANOWSKI,Poland,Middle Blocker,Men,Iran,2022-07-05,Pool,2,5,5,3,2,4,9,2,3,0,5,0,3,7,10,0,0,0,0,0,0,0,0,0,0,0,0
Kamil SEMENIUK,Poland,Outside Hitter,Men,Iran,2022-07-05,Pool,2,5,0,0,0,1,1,0,0,0,0,0,1,0,1,0,1,1,2,0,0,0,0,0,0,0,0
Pawel ZATORSKI,Poland,Libero,Men,Iran,2022-07-05,Pool,2,5,0,0,0,0,0,0,0,0,0,0,0,0,0,4,3,18,25,6,3,0,9,0,0,5,5
Marcin JANUSZ,Poland,Setter,Men,Iran,2022-07-05,Pool,2,5,2,0,0,1,1,1,2,1,4,1,2,5,8,0,0,1,1,1,2,1,4,10,0,57,67
Mateusz BIENIEK,Poland,Middle Blocker,Men,Iran,2022-07-05,Pool,2,5,17,8,2,3,13,5,4,0,9,4,4,14,22,0,0,0,0,0,0,1,1,0,0,0,0
Tomasz FORNAL,Poland,Outside Hitter,Men,Iran,2022-07-05,Pool,2,5,3,1,0,0,1,0,0,0,0,2,0,3,5,0,1,2,3,2,0,0,2,0,0,0,0
Karol BUTRYN,Poland,Opposite Spiker,Men,Iran,2022-07-05,Pool,2,5,0,0,0,0,0,0,0,0,0,0,1,0,1,0,0,0,0,0,0,0,0,0,0,0,0
Jan FIRLEJ,Poland,Setter,Men,Iran,2022-07-05,Pool,2,5,0,0,0,0,0,0,0,0,0,0,0,2,2,0,0,0,0,1,2,0,3,3,1,26,30
Jakub POPIWCZAK,Poland,Libero,Men,United States,2022-06-26,Pool,3,4,0,0,0,0,0,0,0,0,0,0,0,0,0,5,3,7,15,2,3,0,5,0,0,0,0
Lukasz KACZMAREK,Poland,Opposite Spiker,Men,United States,2022-06-26,Pool,3,4,0,0,0,0,0,0,0,0,0,0,1,0,1,0,0,0,0,0,0,0,0,0,0,0,0
Bartosz KUREK,Poland,Opposite Spiker,Men,United States,2022-06-26,Pool,3,4,23,21,5,2,28,2,1,1,4,0,3,16,19,1,0,1,2,2,1,2,5,0,0,2,2
Karol KLOS,Poland,Middle Blocker,Men,United States,2022-06-26,Pool,3,4,0,0,0,0,0,0,0,0,0,0,0,0,0,0,0,0,0,0,0,0,0,0,0,0,0
Grzegorz LOMACZ,Poland,Setter,Men,United States,2022-06-26,Pool,3,4,0,0,0,0,0,0,0,0,0,0,0,0,0,0,0,0,0,0,0,1,1,1,0,5,6
Aleksander SLIWKA,Poland,Outside Hitter,Men,United States,2022-06-26,Pool,3,4,13,10,5,9,24,1,2,0,3,2,2,15,19,6,4,20,30,1,1,0,2,1,0,1,2
Jakub KOCHANOWSKI,Poland,Middle Blocker,Men,United States,2022-06-26,Pool,3,4,8,4,0,1,5,4,3,3,10,0,3,5,8,0,0,1,1,1,1,0,2,0,0,1,1
Kamil SEMENIUK,Poland,Outside Hitter,Men,United States,2022-06-26,Pool,3,4,15,14,3,11,28,0,2,3,5,1,1,14,16,5,1,16,22,2,2,0,4,0,0,1,1
Pawel ZATORSKI,Poland,Libero,Men,United States,2022-06-26,Pool,3,4,0,0,0,0,0,0,0,0,0,0,0,0,0,2,0,3,5,5,3,1,9,0,0,1,1
Bartosz KWOLEK,Poland,Outside Hitter,Men,United States,2022-06-26,Pool,3,4,1,0,0,1,1,0,0,0,0,1,1,3,5,0,0,2,2,2,0,0,2,0,0,0,0
Marcin JANUSZ,Poland,Setter,Men,United States,2022-06-26,Pool,3,4,0,0,0,0,0,0,0,1,1,0,2,7,9,0,0,0,0,5,2,0,7,18,2,70,90
Mateusz BIENIEK,Poland,Middle Blocker,Men,United States,2022-06-26,Pool,3,4,8,8,2,3,13,0,1,4,5,0,4,15,19,0,0,1,1,1,0,0,1,0,0,0,0
Tomasz FORNAL,Poland,Outside Hitter,Men,United States,2022-06-26,Pool,3,4,0,0,0,0,0,0,0,0,0,0,0,0,0,0,0,0,0,0,0,0,0,0,0,0,0
Mateusz POREBA,Poland,Middle Blocker,Men,United States,2022-06-26,Pool,3,4,0,0,0,0,0,0,0,0,0,0,0,0,0,0,0,0,0,0,0,0,0,0,0,0,0
Jakub POPIWCZAK,Poland,Libero,Men,Australia,2022-06-25,Pool,3,3,0,0,0,0,0,0,0,0,0,0,0,0,0,0,0,0,0,0,0,0,0,0,0,0,0
Lukasz KACZMAREK,Poland,Opposite Spiker,Men,Australia,2022-06-25,Pool,3,3,8,7,4,6,17,0,2,3,5,1,1,12,14,0,0,0,0,2,1,0,3,0,0,1,1
Bartosz KUREK,Poland,Opposite Spiker,Men,Australia,2022-06-25,Pool,3,3,5,5,0,1,6,0,0,1,1,0,0,1,1,0,0,0,0,0,1,0,1,0,0,0,0
Karol KLOS,Poland,Middle Blocker,Men,Australia,2022-06-25,Pool,3,3,9,6,3,2,11,2,3,5,10,1,0,12,13,0,0,0,0,1,0,0,1,1,0,0,1
Grzegorz LOMACZ,Poland,Setter,Men,Australia,2022-06-25,Pool,3,3,0,0,0,0,0,0,1,2,3,0,0,7,7,0,0,0,0,2,2,1,5,26,0,39,65
Aleksander SLIWKA,Poland,Outside Hitter,Men,Australia,2022-06-25,Pool,3,3,8,7,0,3,10,1,1,2,4,0,2,7,9,3,0,6,9,2,1,0,3,0,0,0,0
Jakub KOCHANOWSKI,Poland,Middle Blocker,Men,Australia,2022-06-25,Pool,3,3,0,0,0,0,0,0,0,0,0,0,0,0,0,0,0,0,0,0,0,0,0,0,0,0,0
Kamil SEMENIUK,Poland,Outside Hitter,Men,Australia,2022-06-25,Pool,3,3,0,0,0,0,0,0,0,0,0,0,0,0,0,0,0,0,0,0,0,0,0,0,0,0,0
Pawel ZATORSKI,Poland,Libero,Men,Australia,2022-06-25,Pool,3,3,0,0,0,0,0,0,0,0,0,0,0,0,0,4,1,7,12,3,1,1,5,1,0,1,2
Bartosz KWOLEK,Poland,Outside Hitter,Men,Australia,2022-06-25,Pool,3,3,9,8,2,4,14,1,3,1,5,0,4,12,16,7,0,13,20,2,0,2,4,1,0,0,1
Marcin JANUSZ,Poland,Setter,Men,Australia,2022-06-25,Pool,3,3,0,0,0,0,0,0,0,0,0,0,0,0,0,0,0,0,0,0,1,0,1,3,0,2,5
Mateusz BIENIEK,Poland,Middle Blocker,Men,Australia,2022-06-25,Pool,3,3,7,6,1,1,8,0,2,2,4,1,2,4,7,0,0,0,0,1,0,0,1,0,0,0,0
Tomasz FORNAL,Poland,Outside Hitter,Men,Australia,2022-06-25,Pool,3,3,4,4,0,3,7,0,0,1,1,0,0,2,2,2,0,1,3,2,0,0,2,0,0,1,1
Mateusz POREBA,Poland,Middle Blocker,Men,Australia,2022-06-25,Pool,3,3,4,2,0,1,3,1,2,1,4,1,0,4,5,0,0,0,0,0,0,0,0,0,0,0,0
Jakub POPIWCZAK,Poland,Libero,Men,Canada,2022-06-23,Pool,3,3,0,0,0,0,0,0,0,0,0,0,0,0,0,0,2,7,9,3,0,0,3,0,0,2,2
Lukasz KACZMAREK,Poland,Opposite Spiker,Men,Canada,2022-06-23,Pool,3,3,13,12,1,4,17,1,0,0,1,0,1,13,14,0,0,0,0,2,1,1,4,0,0,1,1
Bartosz KUREK,Poland,Opposite Spiker,Men,Canada,2022-06-23,Pool,3,3,1,1,0,0,1,0,0,0,0,0,0,2,2,0,0,0,0,0,0,0,0,0,0,0,0
Karol KLOS,Poland,Middle Blocker,Men,Canada,2022-06-23,Pool,3,3,9,7,0,1,8,2,1,3,6,0,0,8,8,1,0,1,2,1,0,0,1,0,0,0,0
Grzegorz LOMACZ,Poland,Setter,Men,Canada,2022-06-23,Pool,3,3,0,0,0,0,0,0,1,0,1,0,0,3,3,0,0,0,0,1,0,0,1,4,0,7,11
Aleksander SLIWKA,Poland,Outside Hitter,Men,Canada,2022-06-23,Pool,3,3,0,0,0,0,0,0,0,0,0,0,0,0,0,0,0,0,0,0,0,0,0,0,0,0,0
Jakub KOCHANOWSKI,Poland,Middle Blocker,Men,Canada,2022-06-23,Pool,3,3,4,4,1,1,6,0,1,1,2,0,3,2,5,0,0,0,0,0,0,0,0,0,0,0,0
Kamil SEMENIUK,Poland,Outside Hitter,Men,Canada,2022-06-23,Pool,3,3,6,6,0,3,9,0,0,0,0,0,3,8,11,1,0,6,7,2,0,0,2,0,0,0,0
Pawel ZATORSKI,Poland,Libero,Men,Canada,2022-06-23,Pool,3,3,0,0,0,0,0,0,0,0,0,0,0,0,0,0,0,0,0,0,0,0,0,0,0,0,0
Bartosz KWOLEK,Poland,Outside Hitter,Men,Canada,2022-06-23,Pool,3,3,2,2,1,2,5,0,0,1,1,0,0,2,2,0,0,2,2,1,0,0,1,0,0,0,0
Marcin JANUSZ,Poland,Setter,Men,Canada,2022-06-23,Pool,3,3,3,0,0,1,1,1,4,2,7,2,1,6,9,0,0,0,0,0,2,0,2,12,0,33,45
Mateusz BIENIEK,Poland,Middle Blocker,Men,Canada,2022-06-23,Pool,3,3,0,0,0,0,0,0,0,0,0,0,1,0,1,0,0,0,0,0,0,0,0,0,0,0,0
Tomasz FORNAL,Poland,Outside Hitter,Men,Canada,2022-06-23,Pool,3,3,9,7,2,5,14,1,2,3,6,1,4,8,13,7,1,9,17,6,1,0,7,0,0,3,3
Mateusz POREBA,Poland,Middle Blocker,Men,Canada,2022-06-23,Pool,3,3,5,4,0,0,4,0,0,0,0,1,0,4,5,0,0,0,0,0,0,0,0,1,0,0,1
Jakub POPIWCZAK,Poland,Libero,Men,Brazil,2022-06-22,Pool,3,4,0,0,0,0,0,0,0,0,0,0,0,0,0,0,0,0,0,0,0,0,0,0,0,0,0
Lukasz KACZMAREK,Poland,Opposite Spiker,Men,Brazil,2022-06-22,Pool,3,4,2,2,2,3,7,0,0,1,1,0,0,1,1,0,0,0,0,0,0,0,0,0,0,2,2
Bartosz KUREK,Poland,Opposite Spiker,Men,Brazil,2022-06-22,Pool,3,4,17,16,7,17,40,1,1,2,4,0,6,9,15,0,0,0,0,1,0,2,3,0,0,3,3
Karol KLOS,Poland,Middle Blocker,Men,Brazil,2022-06-22,Pool,3,4,0,0,0,0,0,0,0,0,0,0,0,0,0,0,0,0,0,0,0,0,0,0,0,0,0
Grzegorz LOMACZ,Poland,Setter,Men,Brazil,2022-06-22,Pool,3,4,0,0,0,0,0,0,0,0,0,0,0,1,1,0,0,0,0,0,0,1,1,2,0,1,3
Aleksander SLIWKA,Poland,Outside Hitter,Men,Brazil,2022-06-22,Pool,3,4,9,7,1,6,14,0,1,1,2,2,0,12,14,7,1,18,26,3,0,0,3,0,0,1,1
Jakub KOCHANOWSKI,Poland,Middle Blocker,Men,Brazil,2022-06-22,Pool,3,4,12,8,0,4,12,4,3,5,12,0,3,10,13,1,0,1,2,1,1,1,3,0,0,1,1
Kamil SEMENIUK,Poland,Outside Hitter,Men,Brazil,2022-06-22,Pool,3,4,18,12,2,10,24,2,2,2,6,4,1,10,15,3,0,13,16,1,1,0,2,0,0,0,0
Pawel ZATORSKI,Poland,Libero,Men,Brazil,2022-06-22,Pool,3,4,0,0,0,0,0,0,0,0,0,0,0,0,0,6,0,13,19,5,3,4,12,0,0,0,0
Bartosz KWOLEK,Poland,Outside Hitter,Men,Brazil,2022-06-22,Pool,3,4,0,0,0,0,0,0,0,0,0,0,0,0,0,0,0,0,0,0,0,0,0,0,0,0,0
Marcin JANUSZ,Poland,Setter,Men,Brazil,2022-06-22,Pool,3,4,1,1,0,0,1,0,1,1,2,0,1,8,9,0,0,0,0,4,3,1,8,13,0,75,88
Mateusz BIENIEK,Poland,Middle Blocker,Men,Brazil,2022-06-22,Pool,3,4,9,2,1,5,8,0,5,6,11,7,5,16,28,0,0,0,0,2,0,0,2,1,0,0,1
Tomasz FORNAL,Poland,Outside Hitter,Men,Brazil,2022-06-22,Pool,3,4,0,0,0,0,0,0,0,0,0,0,0,0,0,0,0,0,0,0,0,0,0,0,0,0,0
Mateusz POREBA,Poland,Middle Blocker,Men,Brazil,2022-06-22,Pool,3,4,0,0,0,0,0,0,0,0,0,0,0,0,0,0,0,0,0,0,0,0,0,0,0,0,0
Uros NIKOLIC,Serbia,Outside Hitter,Men,Germany,2022-06-11,Pool,2,5,0,0,0,0,0,0,0,0,0,0,0,0,0,0,0,0,0,0,0,0,0,0,0,0,0
Milan KATIC,Serbia,Outside Hitter,Men,Germany,2022-06-11,Pool,2,5,1,1,0,0,1,0,0,1,1,0,0,0,0,0,0,6,6,0,0,0,0,0,0,1,1
Nikola PEKOVIC,Serbia,Libero,Men,Germany,2022-06-11,Pool,2,5,0,0,0,0,0,0,0,0,0,0,0,0,0,0,0,0,0,9,1,2,12,0,0,2,2
Nikola JOVOVIC,Serbia,Setter,Men,Germany,2022-06-11,Pool,2,5,5,4,1,0,5,1,3,3,7,0,0,13,13,0,1,0,1,4,3,4,11,13,0,99,112
Miran KUJUNDŽIĆ,Serbia,Outside Hitter,Men,Germany,2022-06-11,Pool,2,5,16,13,7,13,33,0,1,0,1,3,6,12,21,8,3,30,41,9,1,2,12,0,0,1,1
Pavle PERIC,Serbia,Outside Hitter,Men,Germany,2022-06-11,Pool,2,5,22,18,4,14,36,1,0,4,5,3,6,11,20,1,3,17,21,5,1,3,9,0,0,7,7
Nemanja MASULOVIC,Serbia,Middle Blocker,Men,Germany,2022-06-11,Pool,2,5,13,9,0,6,15,4,8,13,25,0,0,16,16,0,0,1,1,5,1,2,8,0,0,3,3
Vuk TODOROVIC,Serbia,Setter,Men,Germany,2022-06-11,Pool,2,5,0,0,0,0,0,0,0,0,0,0,0,0,0,0,0,0,0,0,0,0,0,0,0,0,0
Lazar MARINOVIC,Serbia,Outside Hitter,Men,Germany,2022-06-11,Pool,2,5,0,0,0,0,0,0,0,0,0,0,0,0,0,0,0,0,0,0,0,0,0,0,0,0,0
Aleksandar NEDELJKOVIC,Serbia,Middle Blocker,Men,Germany,2022-06-11,Pool,2,5,8,6,2,3,11,2,12,8,22,0,0,24,24,0,0,0,0,5,2,0,7,0,1,1,2
Lazar KOPRIVICA,Serbia,Libero,Men,Germany,2022-06-11,Pool,2,5,0,0,0,0,0,0,0,0,0,0,0,0,0,6,2,18,26,8,0,0,8,0,1,3,4
Nikola MELJANAC,Serbia,Opposite Spiker,Men,Germany,2022-06-11,Pool,2,5,0,0,0,0,0,0,0,0,0,0,0,0,0,0,0,0,0,0,0,0,0,0,0,0,0
Dusan PETKOVIC,Serbia,Opposite Spiker,Men,Germany,2022-06-11,Pool,2,5,25,20,11,9,40,1,4,5,10,4,5,16,25,0,0,0,0,7,4,2,13,0,0,6,6
Andrej RUDIC,Serbia,Middle Blocker,Men,Germany,2022-06-11,Pool,2,5,0,0,0,0,0,0,0,0,0,0,1,0,1,0,0,0,0,0,0,0,0,0,0,0,0
Uros NIKOLIC,Serbia,Outside Hitter,Men,Argentina,2022-06-10,Pool,3,5,0,0,0,1,1,0,1,0,1,0,0,0,0,0,0,0,0,0,0,0,0,0,0,0,0
Milan KATIC,Serbia,Outside Hitter,Men,Argentina,2022-06-10,Pool,3,5,1,0,0,2,2,0,0,1,1,1,0,4,5,1,0,4,5,0,1,0,1,0,0,3,3
Nikola PEKOVIC,Serbia,Libero,Men,Argentina,2022-06-10,Pool,3,5,0,0,0,0,0,0,0,0,0,0,0,0,0,5,2,13,20,6,3,4,13,0,0,5,5
Nikola JOVOVIC,Serbia,Setter,Men,Argentina,2022-06-10,Pool,3,5,3,0,0,1,1,2,3,7,12,1,0,13,14,0,0,0,0,3,3,3,9,36,0,35,71
Miran KUJUNDŽIĆ,Serbia,Outside Hitter,Men,Argentina,2022-06-10,Pool,3,5,14,11,2,7,20,2,3,1,6,1,0,9,10,4,4,22,30,3,4,1,8,0,0,1,1
Pavle PERIC,Serbia,Outside Hitter,Men,Argentina,2022-06-10,Pool,3,5,12,9,5,7,21,2,4,2,8,1,2,9,12,0,2,14,16,6,5,1,12,0,1,0,1
Nemanja MASULOVIC,Serbia,Middle Blocker,Men,Argentina,2022-06-10,Pool,3,5,11,9,0,3,12,2,4,10,16,0,1,21,22,0,0,1,1,0,0,1,1,0,0,2,2
Vuk TODOROVIC,Serbia,Setter,Men,Argentina,2022-06-10,Pool,3,5,0,0,0,0,0,0,0,1,1,0,0,1,1,0,0,0,0,2,0,0,2,5,0,4,9
Lazar MARINOVIC,Serbia,Outside Hitter,Men,Argentina,2022-06-10,Pool,3,5,0,0,0,0,0,0,0,0,0,0,0,1,1,0,0,0,0,0,0,0,0,0,1,1,2
Aleksandar NEDELJKOVIC,Serbia,Middle Blocker,Men,Argentina,2022-06-10,Pool,3,5,10,6,3,2,11,2,5,8,15,2,1,14,17,0,0,0,0,0,0,0,0,0,0,0,0
Lazar KOPRIVICA,Serbia,Libero,Men,Argentina,2022-06-10,Pool,3,5,0,0,0,0,0,0,0,0,0,0,0,0,0,0,0,0,0,0,0,0,0,0,0,0,0
Nikola MELJANAC,Serbia,Opposite Spiker,Men,Argentina,2022-06-10,Pool,3,5,3,3,1,0,4,0,0,0,0,0,1,1,2,0,0,0,0,0,1,0,1,0,0,0,0
Dusan PETKOVIC,Serbia,Opposite Spiker,Men,Argentina,2022-06-10,Pool,3,5,10,9,5,10,24,1,0,4,5,0,3,6,9,0,0,0,0,4,2,1,7,0,0,0,0
Andrej RUDIC,Serbia,Middle Blocker,Men,Argentina,2022-06-10,Pool,3,5,0,0,0,0,0,0,0,0,0,0,0,0,0,0,0,0,0,0,0,0,0,0,0,0,0
Uros NIKOLIC,Serbia,Outside Hitter,Men,France,2022-06-09,Pool,1,4,3,2,0,1,3,1,2,3,6,0,2,11,13,0,0,3,3,1,2,1,4,2,0,0,2
Milan KATIC,Serbia,Outside Hitter,Men,France,2022-06-09,Pool,1,4,0,0,0,1,1,0,0,2,2,0,0,0,0,1,0,2,3,0,0,0,0,0,0,1,1
Nikola PEKOVIC,Serbia,Libero,Men,France,2022-06-09,Pool,1,4,0,0,0,0,0,0,0,0,0,0,0,0,0,1,4,16,21,14,4,4,22,1,0,9,10
Nikola JOVOVIC,Serbia,Setter,Men,France,2022-06-09,Pool,1,4,0,0,0,0,0,0,0,0,0,0,0,0,0,0,0,0,0,0,0,0,0,0,0,0,0
Miran KUJUNDŽIĆ,Serbia,Outside Hitter,Men,France,2022-06-09,Pool,1,4,0,0,0,0,0,0,0,0,0,0,0,0,0,0,0,0,0,0,0,0,0,0,0,0,0
Pavle PERIC,Serbia,Outside Hitter,Men,France,2022-06-09,Pool,1,4,21,19,3,14,36,1,2,5,8,1,3,13,17,2,2,14,18,10,3,1,14,0,1,2,3
Nemanja MASULOVIC,Serbia,Middle Blocker,Men,France,2022-06-09,Pool,1,4,11,9,1,2,12,2,4,8,14,0,0,10,10,0,0,0,0,3,1,1,5,0,0,2,2
Vuk TODOROVIC,Serbia,Setter,Men,France,2022-06-09,Pool,1,4,0,0,0,0,0,0,1,3,4,0,1,13,14,0,1,3,4,5,2,4,11,22,0,64,86
Lazar MARINOVIC,Serbia,Outside Hitter,Men,France,2022-06-09,Pool,1,4,9,8,7,6,21,1,1,6,8,0,4,10,14,5,3,19,27,6,1,1,8,1,0,3,4
Aleksandar NEDELJKOVIC,Serbia,Middle Blocker,Men,France,2022-06-09,Pool,1,4,1,1,0,0,1,0,1,0,1,0,0,2,2,0,0,0,0,0,2,0,2,0,0,0,0
Lazar KOPRIVICA,Serbia,Libero,Men,France,2022-06-09,Pool,1,4,0,0,0,0,0,0,0,0,0,0,0,0,0,0,0,0,0,0,0,0,0,0,0,0,0
Nikola MELJANAC,Serbia,Opposite Spiker,Men,France,2022-06-09,Pool,1,4,20,18,6,14,38,1,4,2,7,1,6,9,16,0,0,0,0,1,3,4,8,0,0,3,3
Dusan PETKOVIC,Serbia,Opposite Spiker,Men,France,2022-06-09,Pool,1,4,1,0,0,0,0,0,0,0,0,1,1,3,5,0,0,0,0,0,1,0,1,0,0,0,0
Andrej RUDIC,Serbia,Middle Blocker,Men,France,2022-06-09,Pool,1,4,0,0,0,0,0,0,0,0,0,0,0,3,3,0,0,0,0,0,2,0,2,0,0,0,0
Uros NIKOLIC,Serbia,Outside Hitter,Men,Bulgaria,2022-06-07,Pool,3,4,0,0,0,0,0,0,0,0,0,0,0,0,0,0,0,0,0,0,0,0,0,0,0,0,0
Milan KATIC,Serbia,Outside Hitter,Men,Bulgaria,2022-06-07,Pool,3,4,7,7,0,4,11,0,2,0,2,0,0,6,6,1,0,7,8,1,2,1,4,0,0,4,4
Nikola PEKOVIC,Serbia,Libero,Men,Bulgaria,2022-06-07,Pool,3,4,0,0,0,0,0,0,0,0,0,0,0,0,0,0,0,0,0,1,12,5,18,0,0,3,3
Nikola JOVOVIC,Serbia,Setter,Men,Bulgaria,2022-06-07,Pool,3,4,0,0,0,1,1,0,2,4,6,0,0,14,14,0,0,0,0,0,3,6,9,32,0,56,88
Miran KUJUNDŽIĆ,Serbia,Outside Hitter,Men,Bulgaria,2022-06-07,Pool,3,4,20,13,6,6,25,1,1,2,4,6,2,17,25,2,2,21,25,6,5,5,16,0,0,1,1
Pavle PERIC,Serbia,Outside Hitter,Men,Bulgaria,2022-06-07,Pool,3,4,1,1,1,0,2,0,0,0,0,0,0,1,1,0,0,2,2,0,0,0,0,0,0,0,0
Nemanja MASULOVIC,Serbia,Middle Blocker,Men,Bulgaria,2022-06-07,Pool,3,4,9,8,0,3,11,0,6,4,10,1,1,11,13,0,0,1,1,1,2,1,4,0,0,0,0
Vuk TODOROVIC,Serbia,Setter,Men,Bulgaria,2022-06-07,Pool,3,4,0,0,0,0,0,0,0,0,0,0,0,0,0,0,0,0,0,0,0,0,0,0,0,0,0
Lazar MARINOVIC,Serbia,Outside Hitter,Men,Bulgaria,2022-06-07,Pool,3,4,3,3,4,3,10,0,2,3,5,0,3,2,5,1,0,9,10,1,1,0,2,0,0,2,2
Aleksandar NEDELJKOVIC,Serbia,Middle Blocker,Men,Bulgaria,2022-06-07,Pool,3,4,9,5,1,4,10,3,3,4,10,1,0,16,17,0,0,1,1,2,4,0,6,0,1,0,1
Lazar KOPRIVICA,Serbia,Libero,Men,Bulgaria,2022-06-07,Pool,3,4,0,0,0,0,0,0,0,0,0,0,0,0,0,6,1,20,27,3,1,1,5,0,0,3,3
Nikola MELJANAC,Serbia,Opposite Spiker,Men,Bulgaria,2022-06-07,Pool,3,4,4,4,0,0,4,0,0,0,0,0,0,1,1,0,0,0,0,0,1,0,1,0,0,0,0
Dusan PETKOVIC,Serbia,Opposite Spiker,Men,Bulgaria,2022-06-07,Pool,3,4,13,13,9,9,31,0,1,1,2,0,2,9,11,0,0,0,0,4,2,5,11,0,1,2,3
Andrej RUDIC,Serbia,Middle Blocker,Men,Bulgaria,2022-06-07,Pool,3,4,0,0,0,0,0,0,0,0,0,0,0,0,0,0,0,0,0,0,0,0,0,0,0,0,0
Nemanja PETRIC,Serbia,Outside Hitter,Men,China,2022-07-10,Pool,3,4,0,0,0,0,0,0,0,0,0,0,0,0,0,0,0,0,0,0,0,0,0,0,0,0,0
Milan KATIC,Serbia,Outside Hitter,Men,China,2022-07-10,Pool,3,4,0,0,0,0,0,0,0,0,0,0,0,0,0,0,0,0,0,0,0,0,0,0,0,0,0
Nikola PEKOVIC,Serbia,Libero,Men,China,2022-07-10,Pool,3,4,0,0,0,0,0,0,0,0,0,0,0,0,0,6,0,10,16,7,4,0,11,0,0,3,3
Petar KRSMANOVIC,Serbia,Middle Blocker,Men,China,2022-07-10,Pool,3,4,6,5,2,1,8,1,8,0,9,0,1,12,13,0,0,1,1,3,0,1,4,0,1,2,3
Nikola JOVOVIC,Serbia,Setter,Men,China,2022-07-10,Pool,3,4,0,0,0,0,0,0,0,0,0,0,0,0,0,0,0,0,0,0,0,0,0,0,0,0,0
Miran KUJUNDŽIĆ,Serbia,Outside Hitter,Men,China,2022-07-10,Pool,3,4,10,9,2,2,13,0,3,0,3,1,2,18,21,1,0,13,14,5,0,1,6,0,0,0,0
Pavle PERIC,Serbia,Outside Hitter,Men,China,2022-07-10,Pool,3,4,15,12,2,10,24,2,4,0,6,1,3,13,17,3,2,25,30,2,2,0,4,0,0,2,2
Aleksandar ATANASIJEVIC,Serbia,Opposite Spiker,Men,China,2022-07-10,Pool,3,4,0,0,0,0,0,0,0,0,0,0,0,0,0,0,0,0,0,0,0,0,0,0,0,0,0
Nemanja MASULOVIC,Serbia,Middle Blocker,Men,China,2022-07-10,Pool,3,4,8,5,1,6,12,3,3,2,8,0,0,11,11,0,0,0,0,1,0,0,1,0,0,0,0
Marko PODRASCANIN,Serbia,Middle Blocker,Men,China,2022-07-10,Pool,3,4,0,0,0,0,0,0,0,0,0,0,0,0,0,0,0,0,0,0,0,0,0,0,0,0,0
Srecko LISINAC,Serbia,Middle Blocker,Men,China,2022-07-10,Pool,3,4,0,0,0,0,0,0,0,0,0,0,0,1,1,0,0,0,0,0,0,0,0,0,0,0,0
Vuk TODOROVIC,Serbia,Setter,Men,China,2022-07-10,Pool,3,4,1,1,0,0,1,0,3,0,3,0,1,14,15,0,0,0,0,1,0,1,2,20,0,63,83
Bozidar VUCICEVIC,Serbia,Opposite Spiker,Men,China,2022-07-10,Pool,3,4,18,12,6,12,30,2,1,0,3,4,4,11,19,0,0,0,0,2,0,1,3,0,1,0,1
Lazar KOPRIVICA,Serbia,Libero,Men,China,2022-07-10,Pool,3,4,0,0,0,0,0,0,0,0,0,0,0,0,0,0,0,0,0,0,0,0,0,0,0,0,0
Nemanja PETRIC,Serbia,Outside Hitter,Men,Iran,2022-07-09,Pool,0,3,0,0,0,0,0,0,0,0,0,0,0,0,0,0,0,0,0,0,0,0,0,0,0,0,0
Milan KATIC,Serbia,Outside Hitter,Men,Iran,2022-07-09,Pool,0,3,0,0,0,0,0,0,0,0,0,0,0,0,0,0,1,0,1,0,0,0,0,0,0,0,0
Nikola PEKOVIC,Serbia,Libero,Men,Iran,2022-07-09,Pool,0,3,0,0,0,0,0,0,0,0,0,0,0,0,0,0,0,0,0,1,0,0,1,0,0,0,0
Petar KRSMANOVIC,Serbia,Middle Blocker,Men,Iran,2022-07-09,Pool,0,3,0,0,0,0,0,0,0,0,0,0,0,1,1,0,0,0,0,0,0,0,0,0,0,0,0
Nikola JOVOVIC,Serbia,Setter,Men,Iran,2022-07-09,Pool,0,3,0,0,0,0,0,0,0,1,1,0,0,10,10,0,0,1,1,2,1,1,4,14,0,64,78
Miran KUJUNDŽIĆ,Serbia,Outside Hitter,Men,Iran,2022-07-09,Pool,0,3,9,7,4,6,17,1,0,0,1,1,2,8,11,1,0,28,29,2,0,0,2,0,0,2,2
Pavle PERIC,Serbia,Outside Hitter,Men,Iran,2022-07-09,Pool,0,3,10,10,7,9,26,0,3,0,3,0,3,7,10,0,2,19,21,0,0,0,0,0,0,1,1
Aleksandar ATANASIJEVIC,Serbia,Opposite Spiker,Men,Iran,2022-07-09,Pool,0,3,14,14,5,7,26,0,0,0,0,0,2,11,13,0,0,0,0,2,1,0,3,0,0,1,1
Nemanja MASULOVIC,Serbia,Middle Blocker,Men,Iran,2022-07-09,Pool,0,3,0,0,0,0,0,0,0,0,0,0,0,0,0,0,0,0,0,0,0,0,0,0,0,1,1
Marko PODRASCANIN,Serbia,Middle Blocker,Men,Iran,2022-07-09,Pool,0,3,8,4,1,2,7,4,4,1,9,0,1,9,10,0,0,1,1,0,1,0,1,0,0,0,0
Srecko LISINAC,Serbia,Middle Blocker,Men,Iran,2022-07-09,Pool,0,3,5,4,1,0,5,1,3,0,4,0,1,10,11,0,0,1,1,1,0,0,1,0,0,0,0
Vuk TODOROVIC,Serbia,Setter,Men,Iran,2022-07-09,Pool,0,3,0,0,0,0,0,0,0,0,0,0,0,0,0,0,0,0,0,0,0,0,0,0,0,0,0
Bozidar VUCICEVIC,Serbia,Opposite Spiker,Men,Iran,2022-07-09,Pool,0,3,1,1,3,1,5,0,1,0,1,0,0,1,1,0,1,0,1,0,0,0,0,0,0,0,0
Lazar KOPRIVICA,Serbia,Libero,Men,Iran,2022-07-09,Pool,0,3,0,0,0,0,0,0,0,0,0,0,0,0,0,1,3,13,17,4,3,0,7,0,0,4,4
Nemanja PETRIC,Serbia,Outside Hitter,Men,Italy,2022-07-08,Pool,0,3,8,7,4,8,19,1,0,0,1,0,2,5,7,2,2,21,25,0,0,1,1,0,0,1,1
Milan KATIC,Serbia,Outside Hitter,Men,Italy,2022-07-08,Pool,0,3,0,0,0,0,0,0,0,0,0,0,0,0,0,0,0,0,0,0,0,0,0,0,0,0,0
Nikola PEKOVIC,Serbia,Libero,Men,Italy,2022-07-08,Pool,0,3,0,0,0,0,0,0,0,0,0,0,0,0,0,0,0,0,0,1,0,0,1,0,0,0,0
Petar KRSMANOVIC,Serbia,Middle Blocker,Men,Italy,2022-07-08,Pool,0,3,0,0,1,3,4,0,0,0,0,0,0,5,5,0,0,2,2,0,1,0,1,0,0,0,0
Nikola JOVOVIC,Serbia,Setter,Men,Italy,2022-07-08,Pool,0,3,0,0,0,0,0,0,1,0,1,0,0,7,7,0,0,0,0,0,1,0,1,14,0,71,85
Miran KUJUNDŽIĆ,Serbia,Outside Hitter,Men,Italy,2022-07-08,Pool,0,3,4,3,7,5,15,1,0,0,1,0,2,3,5,0,1,7,8,1,0,0,1,0,0,1,1
Pavle PERIC,Serbia,Outside Hitter,Men,Italy,2022-07-08,Pool,0,3,4,4,4,2,10,0,0,0,0,0,1,3,4,1,0,10,11,0,0,0,0,0,0,2,2
Aleksandar ATANASIJEVIC,Serbia,Opposite Spiker,Men,Italy,2022-07-08,Pool,0,3,14,12,8,11,31,0,1,0,1,2,3,5,10,0,0,0,0,1,1,2,4,0,0,0,0
Nemanja MASULOVIC,Serbia,Middle Blocker,Men,Italy,2022-07-08,Pool,0,3,5,5,1,3,9,0,3,0,3,0,0,8,8,0,0,0,0,1,2,0,3,0,0,0,0
Marko PODRASCANIN,Serbia,Middle Blocker,Men,Italy,2022-07-08,Pool,0,3,0,0,0,0,0,0,0,0,0,0,0,0,0,0,0,0,0,0,0,0,0,0,0,0,0
Srecko LISINAC,Serbia,Middle Blocker,Men,Italy,2022-07-08,Pool,0,3,4,3,0,1,4,1,0,0,1,0,0,12,12,0,0,1,1,0,0,1,1,0,0,0,0
Vuk TODOROVIC,Serbia,Setter,Men,Italy,2022-07-08,Pool,0,3,0,0,0,0,0,0,0,0,0,0,0,1,1,0,0,0,0,0,0,0,0,0,0,4,4
Bozidar VUCICEVIC,Serbia,Opposite Spiker,Men,Italy,2022-07-08,Pool,0,3,0,0,0,0,0,0,0,0,0,0,0,0,0,0,0,0,0,0,0,0,0,0,0,0,0
Lazar KOPRIVICA,Serbia,Libero,Men,Italy,2022-07-08,Pool,0,3,0,0,0,0,0,0,0,0,0,0,0,0,0,0,3,14,17,2,1,0,3,0,0,1,1
Nemanja PETRIC,Serbia,Outside Hitter,Men,Slovenia,2022-07-06,Pool,0,3,0,0,0,0,0,0,0,0,0,0,0,0,0,0,0,0,0,0,0,0,0,0,0,0,0
Milan KATIC,Serbia,Outside Hitter,Men,Slovenia,2022-07-06,Pool,0,3,1,1,1,3,5,0,1,0,1,0,1,1,2,1,1,0,2,0,0,0,0,0,0,1,1
Nikola PEKOVIC,Serbia,Libero,Men,Slovenia,2022-07-06,Pool,0,3,0,0,0,0,0,0,0,0,0,0,0,0,0,2,1,13,16,4,2,0,6,0,0,1,1
Petar KRSMANOVIC,Serbia,Middle Blocker,Men,Slovenia,2022-07-06,Pool,0,3,0,0,0,0,0,0,0,0,0,0,0,1,1,0,0,0,0,0,1,0,1,0,0,0,0
Nikola JOVOVIC,Serbia,Setter,Men,Slovenia,2022-07-06,Pool,0,3,0,0,0,1,1,0,1,0,1,0,1,7,8,0,0,0,0,2,0,0,2,15,2,59,76
Miran KUJUNDŽIĆ,Serbia,Outside Hitter,Men,Slovenia,2022-07-06,Pool,0,3,4,4,3,5,12,0,0,0,0,0,2,5,7,0,2,11,13,3,1,0,4,0,0,0,0
Pavle PERIC,Serbia,Outside Hitter,Men,Slovenia,2022-07-06,Pool,0,3,10,7,3,12,22,1,0,0,1,2,1,9,12,3,0,28,31,0,0,2,2,0,0,1,1
Aleksandar ATANASIJEVIC,Serbia,Opposite Spiker,Men,Slovenia,2022-07-06,Pool,0,3,11,11,4,9,24,0,2,0,2,0,5,6,11,0,0,0,0,0,2,0,2,0,0,0,0
Nemanja MASULOVIC,Serbia,Middle Blocker,Men,Slovenia,2022-07-06,Pool,0,3,0,0,0,0,0,0,0,0,0,0,0,0,0,0,0,0,0,0,0,0,0,0,0,0,0
Marko PODRASCANIN,Serbia,Middle Blocker,Men,Slovenia,2022-07-06,Pool,0,3,6,4,0,1,5,2,5,0,7,0,1,5,6,0,0,0,0,0,1,0,1,1,0,0,1
Srecko LISINAC,Serbia,Middle Blocker,Men,Slovenia,2022-07-06,Pool,0,3,9,9,1,2,12,0,3,0,3,0,5,7,12,0,0,0,0,0,0,0,0,0,0,1,1
Vuk TODOROVIC,Serbia,Setter,Men,Slovenia,2022-07-06,Pool,0,3,0,0,0,0,0,0,0,0,0,0,0,0,0,0,0,0,0,0,0,0,0,0,0,4,4
Bozidar VUCICEVIC,Serbia,Opposite Spiker,Men,Slovenia,2022-07-06,Pool,0,3,0,0,2,1,3,0,0,0,0,0,0,0,0,0,0,0,0,0,0,0,0,0,0,0,0
Lazar KOPRIVICA,Serbia,Libero,Men,Slovenia,2022-07-06,Pool,0,3,0,0,0,0,0,0,0,0,0,0,0,0,0,0,0,0,0,0,0,0,0,0,0,0,0
Nemanja PETRIC,Serbia,Outside Hitter,Men,Australia,2022-06-26,Pool,3,3,0,0,0,0,0,0,0,0,0,0,0,0,0,0,0,0,0,0,0,0,0,0,0,0,0
Milan KATIC,Serbia,Outside Hitter,Men,Australia,2022-06-26,Pool,3,3,0,0,0,0,0,0,0,0,0,0,0,0,0,1,0,2,3,1,0,0,1,0,0,1,1
Nikola PEKOVIC,Serbia,Libero,Men,Australia,2022-06-26,Pool,3,3,0,0,0,0,0,0,0,0,0,0,0,0,0,0,0,0,0,0,0,0,0,0,0,0,0
Petar KRSMANOVIC,Serbia,Middle Blocker,Men,Australia,2022-06-26,Pool,3,3,0,0,0,0,0,0,0,0,0,0,0,0,0,0,0,0,0,0,0,0,0,0,0,0,0
Nikola JOVOVIC,Serbia,Setter,Men,Australia,2022-06-26,Pool,3,3,2,2,0,0,2,0,2,1,3,0,0,10,10,0,0,0,0,3,1,0,4,25,0,47,72
Miran KUJUNDŽIĆ,Serbia,Outside Hitter,Men,Australia,2022-06-26,Pool,3,3,13,13,2,2,17,0,1,0,1,0,3,10,13,4,0,7,11,0,1,0,1,0,0,0,0
Pavle PERIC,Serbia,Outside Hitter,Men,Australia,2022-06-26,Pool,3,3,11,10,2,3,15,1,1,1,3,0,0,10,10,3,1,21,25,1,1,0,2,0,0,0,0
Aleksandar ATANASIJEVIC,Serbia,Opposite Spiker,Men,Australia,2022-06-26,Pool,3,3,15,14,5,7,26,1,2,4,7,0,4,10,14,0,0,1,1,3,2,1,6,0,0,0,0
Nemanja MASULOVIC,Serbia,Middle Blocker,Men,Australia,2022-06-26,Pool,3,3,0,0,0,0,0,0,0,0,0,0,0,0,0,0,0,0,0,0,0,0,0,0,0,0,0
Marko PODRASCANIN,Serbia,Middle Blocker,Men,Australia,2022-06-26,Pool,3,3,6,4,0,3,7,1,5,2,8,1,1,13,15,0,0,0,0,3,0,0,3,0,0,0,0
Srecko LISINAC,Serbia,Middle Blocker,Men,Australia,2022-06-26,Pool,3,3,11,8,1,3,12,2,5,1,8,1,2,8,11,0,0,0,0,2,0,1,3,1,0,0,1
Lazar KOPRIVICA,Serbia,Libero,Men,Australia,2022-06-26,Pool,3,3,0,0,0,0,0,0,0,0,0,0,0,0,0,3,0,5,8,5,3,0,8,0,0,1,1
Nikola MELJANAC,Serbia,Opposite Spiker,Men,Australia,2022-06-26,Pool,3,3,0,0,0,0,0,0,0,0,0,0,0,0,0,0,0,0,0,0,0,0,0,0,0,0,0
Andrija VULIKIC,Serbia,Setter,Men,Australia,2022-06-26,Pool,3,3,0,0,0,0,0,0,0,0,0,0,0,0,0,0,0,0,0,0,0,0,0,0,0,0,0
Nemanja PETRIC,Serbia,Outside Hitter,Men,Canada,2022-06-24,Pool,3,5,0,0,0,0,0,0,0,0,0,0,0,0,0,0,0,0,0,0,1,0,1,0,0,0,0
Milan KATIC,Serbia,Outside Hitter,Men,Canada,2022-06-24,Pool,3,5,6,6,2,4,12,0,1,1,2,0,2,10,12,2,2,6,10,2,2,0,4,0,0,0,0
Nikola PEKOVIC,Serbia,Libero,Men,Canada,2022-06-24,Pool,3,5,0,0,0,0,0,0,0,0,0,0,0,0,0,5,0,15,20,8,3,0,11,0,1,2,3
Petar KRSMANOVIC,Serbia,Middle Blocker,Men,Canada,2022-06-24,Pool,3,5,0,0,0,0,0,0,0,0,0,0,0,2,2,0,0,0,0,0,0,0,0,0,0,0,0
Nikola JOVOVIC,Serbia,Setter,Men,Canada,2022-06-24,Pool,3,5,1,1,0,0,1,0,2,1,3,0,1,11,12,0,0,0,0,2,3,0,5,31,0,56,87
Miran KUJUNDŽIĆ,Serbia,Outside Hitter,Men,Canada,2022-06-24,Pool,3,5,15,12,4,5,21,1,2,1,4,2,5,10,17,7,4,32,43,2,2,0,4,0,0,1,1
Pavle PERIC,Serbia,Outside Hitter,Men,Canada,2022-06-24,Pool,3,5,2,1,3,2,6,1,0,1,2,0,2,3,5,0,2,4,6,2,1,0,3,0,0,0,0
Aleksandar ATANASIJEVIC,Serbia,Opposite Spiker,Men,Canada,2022-06-24,Pool,3,5,22,21,6,9,36,0,2,3,5,1,6,15,22,0,0,0,0,1,4,2,7,0,0,3,3
Nemanja MASULOVIC,Serbia,Middle Blocker,Men,Canada,2022-06-24,Pool,3,5,3,3,2,2,7,0,4,1,5,0,1,7,8,0,0,1,1,0,0,1,1,0,0,0,0
Marko PODRASCANIN,Serbia,Middle Blocker,Men,Canada,2022-06-24,Pool,3,5,3,2,0,0,2,1,2,0,3,0,1,6,7,0,0,0,0,1,0,0,1,0,0,0,0
Srecko LISINAC,Serbia,Middle Blocker,Men,Canada,2022-06-24,Pool,3,5,15,12,1,3,16,3,7,1,11,0,3,14,17,0,0,0,0,0,0,0,0,0,0,0,0
Lazar KOPRIVICA,Serbia,Libero,Men,Canada,2022-06-24,Pool,3,5,0,0,0,0,0,0,0,0,0,0,0,0,0,0,0,0,0,0,0,0,0,0,0,0,0
Nikola MELJANAC,Serbia,Opposite Spiker,Men,Canada,2022-06-24,Pool,3,5,0,0,0,0,0,0,0,0,0,0,0,0,0,0,0,0,0,0,0,0,0,0,0,0,0
Andrija VULIKIC,Serbia,Setter,Men,Canada,2022-06-24,Pool,3,5,0,0,0,0,0,0,0,0,0,0,0,2,2,0,0,0,0,1,0,0,1,0,0,6,6
Nemanja PETRIC,Serbia,Outside Hitter,Men,Brazil,2022-06-23,Pool,0,3,0,0,0,0,0,0,0,0,0,0,0,0,0,0,0,0,0,0,0,0,0,0,0,0,0
Milan KATIC,Serbia,Outside Hitter,Men,Brazil,2022-06-23,Pool,0,3,7,6,2,9,17,1,1,2,4,0,1,9,10,7,1,9,17,0,2,0,2,0,0,1,1
Nikola PEKOVIC,Serbia,Libero,Men,Brazil,2022-06-23,Pool,0,3,0,0,0,0,0,0,0,0,0,0,0,0,0,0,0,0,0,2,0,1,3,0,0,0,0
Petar KRSMANOVIC,Serbia,Middle Blocker,Men,Brazil,2022-06-23,Pool,0,3,4,4,0,2,6,0,4,5,9,0,3,5,8,0,0,1,1,1,0,0,1,0,0,0,0
Nikola JOVOVIC,Serbia,Setter,Men,Brazil,2022-06-23,Pool,0,3,0,0,0,0,0,0,0,0,0,0,0,0,0,0,0,0,0,0,0,0,0,0,0,0,0
Miran KUJUNDŽIĆ,Serbia,Outside Hitter,Men,Brazil,2022-06-23,Pool,0,3,2,2,2,0,4,0,2,0,2,0,0,1,1,0,0,1,1,0,0,0,0,0,0,0,0
Pavle PERIC,Serbia,Outside Hitter,Men,Brazil,2022-06-23,Pool,0,3,6,4,2,10,16,1,2,2,5,1,5,3,9,4,5,13,22,4,0,0,4,0,0,2,2
Aleksandar ATANASIJEVIC,Serbia,Opposite Spiker,Men,Brazil,2022-06-23,Pool,0,3,0,0,0,0,0,0,0,0,0,0,0,0,0,0,0,0,0,0,0,0,0,0,0,0,0
Nemanja MASULOVIC,Serbia,Middle Blocker,Men,Brazil,2022-06-23,Pool,0,3,5,4,0,3,7,0,2,1,3,1,0,11,12,0,0,1,1,1,0,1,2,0,0,0,0
Marko PODRASCANIN,Serbia,Middle Blocker,Men,Brazil,2022-06-23,Pool,0,3,0,0,0,0,0,0,0,0,0,0,0,0,0,0,0,0,0,0,0,0,0,0,0,0,0
Srecko LISINAC,Serbia,Middle Blocker,Men,Brazil,2022-06-23,Pool,0,3,0,0,0,0,0,0,0,0,0,0,0,0,0,0,0,0,0,0,0,0,0,0,0,0,0
Lazar KOPRIVICA,Serbia,Libero,Men,Brazil,2022-06-23,Pool,0,3,0,0,0,0,0,0,0,0,0,0,0,0,0,6,1,12,19,1,2,0,3,0,0,3,3
Nikola MELJANAC,Serbia,Opposite Spiker,Men,Brazil,2022-06-23,Pool,0,3,14,13,8,5,26,0,1,1,2,1,5,5,11,0,0,0,0,3,1,1,5,0,0,1,1
Andrija VULIKIC,Serbia,Setter,Men,Brazil,2022-06-23,Pool,0,3,1,0,0,2,2,1,0,1,2,0,0,9,9,0,1,0,1,0,3,0,3,13,3,57,73
Nemanja PETRIC,Serbia,Outside Hitter,Men,United States,2022-06-22,Pool,1,4,0,0,0,0,0,0,0,0,0,0,0,0,0,0,0,0,0,0,0,0,0,0,0,0,0
Milan KATIC,Serbia,Outside Hitter,Men,United States,2022-06-22,Pool,1,4,3,2,0,1,3,1,0,0,1,0,0,4,4,1,0,5,6,0,0,0,0,0,0,0,0
Nikola PEKOVIC,Serbia,Libero,Men,United States,2022-06-22,Pool,1,4,0,0,0,0,0,0,0,0,0,0,0,0,0,1,0,17,18,4,1,2,7,0,0,0,0
Petar KRSMANOVIC,Serbia,Middle Blocker,Men,United States,2022-06-22,Pool,1,4,0,0,0,0,0,0,0,0,0,0,1,3,4,0,0,0,0,0,1,0,1,0,0,1,1
Nikola JOVOVIC,Serbia,Setter,Men,United States,2022-06-22,Pool,1,4,0,0,0,0,0,0,2,1,3,0,1,8,9,0,1,0,1,2,3,0,5,23,0,56,79
Miran KUJUNDŽIĆ,Serbia,Outside Hitter,Men,United States,2022-06-22,Pool,1,4,12,11,0,7,18,0,3,0,3,1,5,11,17,9,2,21,32,2,1,2,5,0,0,0,0
Pavle PERIC,Serbia,Outside Hitter,Men,United States,2022-06-22,Pool,1,4,16,14,3,6,23,1,1,0,2,1,5,5,11,1,2,18,21,0,1,1,2,0,0,1,1
Aleksandar ATANASIJEVIC,Serbia,Opposite Spiker,Men,United States,2022-06-22,Pool,1,4,20,17,5,4,26,0,3,0,3,3,4,9,16,0,0,1,1,0,2,0,2,0,0,0,0
Nemanja MASULOVIC,Serbia,Middle Blocker,Men,United States,2022-06-22,Pool,1,4,0,0,0,1,1,0,1,1,2,0,0,1,1,0,0,0,0,0,0,0,0,1,0,0,1
Marko PODRASCANIN,Serbia,Middle Blocker,Men,United States,2022-06-22,Pool,1,4,5,4,2,5,11,0,4,1,5,1,2,11,14,0,0,1,1,2,0,0,2,0,0,1,1
Srecko LISINAC,Serbia,Middle Blocker,Men,United States,2022-06-22,Pool,1,4,5,4,0,3,7,1,6,4,11,0,2,7,9,0,0,1,1,0,0,0,0,0,0,0,0
Lazar KOPRIVICA,Serbia,Libero,Men,United States,2022-06-22,Pool,1,4,0,0,0,0,0,0,0,0,0,0,0,0,0,0,0,0,0,0,0,0,0,0,0,0,0
Nikola MELJANAC,Serbia,Opposite Spiker,Men,United States,2022-06-22,Pool,1,4,4,4,3,0,7,0,0,0,0,0,1,5,6,0,0,0,0,1,0,0,1,0,0,0,0
Andrija VULIKIC,Serbia,Setter,Men,United States,2022-06-22,Pool,1,4,1,1,0,0,1,0,0,0,0,0,1,1,2,0,0,0,0,0,2,2,4,1,0,13,14
Tonček ŠTERN,Slovenia,Opposite Spiker,Men,Poland,2022-07-10,Pool,1,4,20,15,5,4,24,2,6,0,8,3,5,7,15,0,0,1,1,3,0,2,5,0,0,2,2
Alen PAJENK,Slovenia,Middle Blocker,Men,Poland,2022-07-10,Pool,1,4,9,6,1,3,10,2,2,0,4,1,3,10,14,0,0,1,1,1,0,1,2,0,0,0,0
Jan KOZAMERNIK,Slovenia,Middle Blocker,Men,Poland,2022-07-10,Pool,1,4,6,4,0,1,5,1,2,0,3,1,3,8,12,0,0,1,1,2,0,0,2,0,0,0,0
Mitja GASPARINI,Slovenia,Opposite Spiker,Men,Poland,2022-07-10,Pool,1,4,0,0,0,0,0,0,0,0,0,0,1,0,1,0,0,0,0,0,0,0,0,0,0,0,0
Alan KOŠENINA,Slovenia,Libero,Men,Poland,2022-07-10,Pool,1,4,0,0,0,0,0,0,0,0,0,0,0,0,0,0,0,0,0,0,0,0,0,0,0,0,0
Dejan VINCIC,Slovenia,Setter,Men,Poland,2022-07-10,Pool,1,4,1,0,0,1,1,0,1,0,1,1,0,2,3,0,0,0,0,0,0,0,0,1,0,22,23
Danijel KONCILJA,Slovenia,Middle Blocker,Men,Poland,2022-07-10,Pool,1,4,0,0,0,0,0,0,0,0,0,0,0,0,0,0,0,0,0,0,0,0,0,0,0,0,0
Jani KOVAČIČ,Slovenia,Libero,Men,Poland,2022-07-10,Pool,1,4,0,0,0,0,0,0,0,0,0,0,0,0,0,2,5,15,22,1,4,0,5,0,0,0,0
Žiga ŠTERN,Slovenia,Outside Hitter,Men,Poland,2022-07-10,Pool,1,4,0,0,0,0,0,0,0,0,0,0,0,0,0,0,0,0,0,0,0,0,0,0,0,0,0
Matic VIDEČNIK,Slovenia,Middle Blocker,Men,Poland,2022-07-10,Pool,1,4,0,0,0,0,0,0,0,0,0,0,0,0,0,0,0,0,0,0,0,0,0,0,0,0,0
Gregor ROPRET,Slovenia,Setter,Men,Poland,2022-07-10,Pool,1,4,0,0,0,0,0,0,1,0,1,0,2,5,7,0,0,1,1,0,0,1,1,11,1,60,72
Tine URNAUT,Slovenia,Outside Hitter,Men,Poland,2022-07-10,Pool,1,4,9,7,2,16,25,1,0,0,1,1,3,9,13,1,2,18,21,3,1,0,4,0,0,0,0
Klemen ČEBULJ,Slovenia,Outside Hitter,Men,Poland,2022-07-10,Pool,1,4,9,9,7,12,28,0,3,0,3,0,4,9,13,0,2,29,31,2,0,1,3,0,0,0,0
Rok MOŽIČ,Slovenia,Outside Hitter,Men,Poland,2022-07-10,Pool,1,4,0,0,3,2,5,0,0,0,0,0,0,1,1,0,0,0,0,0,0,0,0,0,0,1,1
Tonček ŠTERN,Slovenia,Opposite Spiker,Men,Iran,2022-07-08,Pool,0,3,7,5,3,4,12,1,3,0,4,1,3,7,11,0,0,1,1,2,2,0,4,0,0,0,0
Alen PAJENK,Slovenia,Middle Blocker,Men,Iran,2022-07-08,Pool,0,3,1,1,1,1,3,0,1,0,1,0,2,2,4,0,0,0,0,0,0,0,0,0,0,0,0
Jan KOZAMERNIK,Slovenia,Middle Blocker,Men,Iran,2022-07-08,Pool,0,3,7,5,0,2,7,2,1,2,5,0,1,10,11,0,0,0,0,1,0,0,1,0,0,1,1
Mitja GASPARINI,Slovenia,Opposite Spiker,Men,Iran,2022-07-08,Pool,0,3,1,1,0,0,1,0,0,0,0,0,0,0,0,0,0,0,0,0,0,0,0,0,0,0,0
Alan KOŠENINA,Slovenia,Libero,Men,Iran,2022-07-08,Pool,0,3,0,0,0,0,0,0,0,0,0,0,0,0,0,0,0,0,0,0,0,0,0,0,0,0,0
Dejan VINCIC,Slovenia,Setter,Men,Iran,2022-07-08,Pool,0,3,2,0,0,1,1,1,1,0,2,1,0,8,9,0,0,1,1,0,2,0,2,15,1,42,58
Danijel KONCILJA,Slovenia,Middle Blocker,Men,Iran,2022-07-08,Pool,0,3,1,1,0,3,4,0,3,0,3,0,1,3,4,0,0,0,0,0,0,1,1,0,0,0,0
Jani KOVAČIČ,Slovenia,Libero,Men,Iran,2022-07-08,Pool,0,3,0,0,0,0,0,0,0,0,0,0,0,0,0,2,4,21,27,1,2,1,4,0,0,3,3
Žiga ŠTERN,Slovenia,Outside Hitter,Men,Iran,2022-07-08,Pool,0,3,0,0,0,0,0,0,0,0,0,0,0,0,0,0,0,0,0,0,0,0,0,0,0,0,0
Matic VIDEČNIK,Slovenia,Middle Blocker,Men,Iran,2022-07-08,Pool,0,3,0,0,0,0,0,0,0,0,0,0,0,1,1,0,0,1,1,0,0,0,0,0,0,0,0
Gregor ROPRET,Slovenia,Setter,Men,Iran,2022-07-08,Pool,0,3,0,0,0,0,0,0,0,0,0,0,0,0,0,0,0,0,0,0,0,0,0,0,0,0,0
Tine URNAUT,Slovenia,Outside Hitter,Men,Iran,2022-07-08,Pool,0,3,4,2,4,2,8,0,0,0,0,2,1,2,5,0,0,7,7,0,1,0,1,0,0,2,2
Klemen ČEBULJ,Slovenia,Outside Hitter,Men,Iran,2022-07-08,Pool,0,3,11,10,6,6,22,1,3,0,4,0,3,8,11,2,0,10,12,1,0,0,1,0,0,0,0
Rok MOŽIČ,Slovenia,Outside Hitter,Men,Iran,2022-07-08,Pool,0,3,2,2,2,1,5,0,0,0,0,0,3,2,5,0,2,6,8,1,0,0,1,0,0,0,0
Tonček ŠTERN,Slovenia,Opposite Spiker,Men,Bulgaria,2022-07-07,Pool,3,4,18,14,10,8,32,1,0,0,1,3,3,16,22,0,0,0,0,2,0,1,3,0,0,0,0
Alen PAJENK,Slovenia,Middle Blocker,Men,Bulgaria,2022-07-07,Pool,3,4,9,6,0,2,8,3,0,1,4,0,3,12,15,0,0,1,1,1,2,0,3,0,0,0,0
Jan KOZAMERNIK,Slovenia,Middle Blocker,Men,Bulgaria,2022-07-07,Pool,3,4,8,5,0,0,5,3,2,0,5,0,0,19,19,0,0,1,1,1,0,0,1,0,0,0,0
Mitja GASPARINI,Slovenia,Opposite Spiker,Men,Bulgaria,2022-07-07,Pool,3,4,0,0,0,0,0,0,0,0,0,0,0,0,0,0,0,0,0,0,0,0,0,0,0,0,0
Alan KOŠENINA,Slovenia,Libero,Men,Bulgaria,2022-07-07,Pool,3,4,0,0,0,0,0,0,0,0,0,0,0,0,0,0,0,0,0,0,0,0,0,0,0,0,0
Dejan VINCIC,Slovenia,Setter,Men,Bulgaria,2022-07-07,Pool,3,4,0,0,0,0,0,0,0,0,0,0,0,0,0,0,0,0,0,0,0,0,0,0,0,0,0
Danijel KONCILJA,Slovenia,Middle Blocker,Men,Bulgaria,2022-07-07,Pool,3,4,0,0,0,0,0,0,0,0,0,0,0,0,0,0,0,0,0,0,0,0,0,0,0,0,0
Jani KOVAČIČ,Slovenia,Libero,Men,Bulgaria,2022-07-07,Pool,3,4,0,0,0,0,0,0,0,0,0,0,0,0,0,1,0,18,19,8,2,1,11,0,0,0,0
Žiga ŠTERN,Slovenia,Outside Hitter,Men,Bulgaria,2022-07-07,Pool,3,4,2,2,0,2,4,0,1,0,1,0,0,0,0,0,1,1,2,0,0,0,0,0,0,0,0
Matic VIDEČNIK,Slovenia,Middle Blocker,Men,Bulgaria,2022-07-07,Pool,3,4,0,0,0,0,0,0,0,0,0,0,0,0,0,0,0,0,0,0,0,0,0,0,0,0,0
Gregor ROPRET,Slovenia,Setter,Men,Bulgaria,2022-07-07,Pool,3,4,1,0,0,1,1,1,2,0,3,0,2,10,12,0,1,0,1,1,0,1,2,24,2,64,90
Tine URNAUT,Slovenia,Outside Hitter,Men,Bulgaria,2022-07-07,Pool,3,4,0,0,0,0,0,0,0,0,0,0,0,0,0,0,0,0,0,0,0,0,0,0,0,0,0
Klemen ČEBULJ,Slovenia,Outside Hitter,Men,Bulgaria,2022-07-07,Pool,3,4,14,13,2,9,24,1,1,1,3,0,2,9,11,3,2,26,31,2,0,1,3,0,0,0,0
Rok MOŽIČ,Slovenia,Outside Hitter,Men,Bulgaria,2022-07-07,Pool,3,4,14,13,3,1,17,1,2,0,3,0,3,14,17,0,0,9,9,1,1,2,4,0,0,4,4
Tonček ŠTERN,Slovenia,Opposite Spiker,Men,Serbia,2022-07-06,Pool,3,3,10,8,4,6,18,1,0,0,1,1,2,12,15,0,0,0,0,1,0,0,1,0,0,1,1
Alen PAJENK,Slovenia,Middle Blocker,Men,Serbia,2022-07-06,Pool,3,3,7,6,1,1,8,1,3,0,4,0,3,9,12,0,0,0,0,1,0,0,1,0,0,0,0
Jan KOZAMERNIK,Slovenia,Middle Blocker,Men,Serbia,2022-07-06,Pool,3,3,4,2,0,3,5,2,2,0,4,0,1,9,10,0,0,1,1,0,1,0,1,0,0,0,0
Mitja GASPARINI,Slovenia,Opposite Spiker,Men,Serbia,2022-07-06,Pool,3,3,0,0,0,0,0,0,0,0,0,0,0,0,0,0,0,0,0,0,0,0,0,0,0,0,0
Alan KOŠENINA,Slovenia,Libero,Men,Serbia,2022-07-06,Pool,3,3,0,0,0,0,0,0,0,0,0,0,0,0,0,0,0,0,0,0,0,0,0,0,0,0,0
Dejan VINCIC,Slovenia,Setter,Men,Serbia,2022-07-06,Pool,3,3,2,2,0,1,3,0,3,0,3,0,1,9,10,0,0,0,0,0,0,0,0,12,0,48,60
Danijel KONCILJA,Slovenia,Middle Blocker,Men,Serbia,2022-07-06,Pool,3,3,0,0,0,0,0,0,0,0,0,0,0,0,0,0,0,0,0,0,0,0,0,0,0,0,0
Jani KOVAČIČ,Slovenia,Libero,Men,Serbia,2022-07-06,Pool,3,3,0,0,0,0,0,0,0,0,0,0,0,0,0,2,0,8,10,4,1,0,5,0,0,1,1
Žiga ŠTERN,Slovenia,Outside Hitter,Men,Serbia,2022-07-06,Pool,3,3,0,0,0,0,0,0,0,0,0,0,0,0,0,0,0,0,0,0,0,0,0,0,0,0,0
Matic VIDEČNIK,Slovenia,Middle Blocker,Men,Serbia,2022-07-06,Pool,3,3,0,0,0,0,0,0,0,0,0,0,0,0,0,0,0,0,0,0,0,0,0,0,0,0,0
Gregor ROPRET,Slovenia,Setter,Men,Serbia,2022-07-06,Pool,3,3,0,0,0,0,0,0,0,0,0,0,0,0,0,0,0,0,0,0,0,0,0,0,0,0,0
Tine URNAUT,Slovenia,Outside Hitter,Men,Serbia,2022-07-06,Pool,3,3,12,11,0,4,15,1,3,1,5,0,1,7,8,0,0,14,14,0,1,0,1,0,0,1,1
Klemen ČEBULJ,Slovenia,Outside Hitter,Men,Serbia,2022-07-06,Pool,3,3,11,7,1,7,15,1,3,0,4,3,3,12,18,4,2,12,18,5,0,0,5,0,0,0,0
Rok MOŽIČ,Slovenia,Outside Hitter,Men,Serbia,2022-07-06,Pool,3,3,0,0,0,0,0,0,0,0,0,0,0,0,0,0,0,0,0,0,0,0,0,0,0,0,0
Tonček ŠTERN,Slovenia,Opposite Spiker,Men,Japan,2022-06-26,Pool,1,4,16,14,9,3,26,1,6,3,10,1,4,10,15,0,0,0,0,3,2,0,5,0,0,2,2
Alen PAJENK,Slovenia,Middle Blocker,Men,Japan,2022-06-26,Pool,1,4,8,6,1,3,10,2,3,6,11,0,6,4,10,0,0,0,0,2,0,0,2,1,0,0,1
Jan KOZAMERNIK,Slovenia,Middle Blocker,Men,Japan,2022-06-26,Pool,1,4,8,5,0,4,9,3,5,3,11,0,1,20,21,0,0,0,0,6,1,0,7,0,0,1,1
Alan KOŠENINA,Slovenia,Libero,Men,Japan,2022-06-26,Pool,1,4,0,0,0,0,0,0,0,0,0,0,0,0,0,0,0,0,0,0,0,0,0,0,0,0,0
Crtomir BOŠNJAK,Slovenia,Outside Hitter,Men,Japan,2022-06-26,Pool,1,4,0,0,0,0,0,0,0,0,0,0,0,0,0,0,0,0,0,0,0,0,0,0,0,0,0
Dejan VINCIC,Slovenia,Setter,Men,Japan,2022-06-26,Pool,1,4,0,0,0,0,0,0,0,0,0,0,0,1,1,0,0,0,0,0,0,0,0,0,0,0,0
Sašo ŠTALEKAR,Slovenia,Middle Blocker,Men,Japan,2022-06-26,Pool,1,4,0,0,0,0,0,0,1,0,1,0,0,0,0,0,0,0,0,0,0,0,0,0,0,0,0
Danijel KONCILJA,Slovenia,Middle Blocker,Men,Japan,2022-06-26,Pool,1,4,0,0,0,0,0,0,0,1,1,0,0,0,0,0,0,0,0,0,0,1,1,0,0,0,0
Jan KLOBUCAR,Slovenia,Outside Hitter,Men,Japan,2022-06-26,Pool,1,4,0,0,0,0,0,0,0,0,0,0,0,0,0,0,0,0,0,0,0,0,0,0,0,0,0
Jani KOVAČIČ,Slovenia,Libero,Men,Japan,2022-06-26,Pool,1,4,0,0,0,0,0,0,0,0,0,0,0,0,0,11,1,11,23,6,8,2,16,0,0,4,4
Žiga ŠTERN,Slovenia,Outside Hitter,Men,Japan,2022-06-26,Pool,1,4,0,0,0,0,0,0,0,0,0,0,1,1,2,1,0,1,2,2,0,0,2,0,0,2,2
Gregor ROPRET,Slovenia,Setter,Men,Japan,2022-06-26,Pool,1,4,0,0,0,0,0,0,2,1,3,0,1,10,11,0,0,0,0,8,1,1,10,24,0,64,88
Tine URNAUT,Slovenia,Outside Hitter,Men,Japan,2022-06-26,Pool,1,4,11,9,3,11,23,1,2,1,4,1,2,11,14,6,3,22,31,4,4,1,9,0,0,2,2
Rok MOŽIČ,Slovenia,Outside Hitter,Men,Japan,2022-06-26,Pool,1,4,20,18,4,15,37,2,6,3,11,0,4,6,10,6,1,16,23,0,0,2,2,0,0,3,3
Tonček ŠTERN,Slovenia,Opposite Spiker,Men,Italy,2022-06-25,Pool,0,3,1,1,0,0,1,0,0,1,1,0,0,4,4,0,0,0,0,1,0,0,1,0,0,0,0
Alen PAJENK,Slovenia,Middle Blocker,Men,Italy,2022-06-25,Pool,0,3,0,0,0,0,0,0,0,0,0,0,0,0,0,0,0,0,0,0,0,0,0,0,0,0,0
Jan KOZAMERNIK,Slovenia,Middle Blocker,Men,Italy,2022-06-25,Pool,0,3,3,3,2,3,8,0,3,3,6,0,2,7,9,0,0,2,2,0,1,0,1,0,0,1,1
Alan KOŠENINA,Slovenia,Libero,Men,Italy,2022-06-25,Pool,0,3,0,0,0,0,0,0,0,0,0,0,0,0,0,3,1,14,18,2,9,0,11,0,0,1,1
Crtomir BOŠNJAK,Slovenia,Outside Hitter,Men,Italy,2022-06-25,Pool,0,3,2,2,1,0,3,0,0,0,0,0,1,1,2,0,0,2,2,1,0,0,1,0,0,0,0
Dejan VINCIC,Slovenia,Setter,Men,Italy,2022-06-25,Pool,0,3,1,1,0,1,2,0,0,2,2,0,0,7,7,0,0,0,0,6,1,1,8,12,0,49,61
Sašo ŠTALEKAR,Slovenia,Middle Blocker,Men,Italy,2022-06-25,Pool,0,3,2,1,0,4,5,1,4,5,10,0,0,9,9,0,0,3,3,2,0,0,2,0,0,1,1
Danijel KONCILJA,Slovenia,Middle Blocker,Men,Italy,2022-06-25,Pool,0,3,2,1,0,1,2,1,1,0,2,0,2,1,3,0,0,0,0,0,0,0,0,0,0,0,0
Jan KLOBUCAR,Slovenia,Outside Hitter,Men,Italy,2022-06-25,Pool,0,3,3,3,1,5,9,0,1,1,2,0,0,6,6,4,1,8,13,6,3,0,9,0,0,2,2
Jani KOVAČIČ,Slovenia,Libero,Men,Italy,2022-06-25,Pool,0,3,0,0,0,0,0,0,0,0,0,0,0,0,0,0,0,0,0,0,0,0,0,0,0,0,0
Žiga ŠTERN,Slovenia,Outside Hitter,Men,Italy,2022-06-25,Pool,0,3,12,11,1,6,18,1,0,1,2,0,2,5,7,2,3,4,9,2,2,1,5,0,0,3,3
Gregor ROPRET,Slovenia,Setter,Men,Italy,2022-06-25,Pool,0,3,0,0,0,0,0,0,0,0,0,0,0,1,1,0,0,1,1,0,1,0,1,0,0,4,4
Tine URNAUT,Slovenia,Outside Hitter,Men,Italy,2022-06-25,Pool,0,3,0,0,0,0,0,0,0,0,0,0,0,0,0,0,0,0,0,0,0,0,0,0,0,0,0
Rok MOŽIČ,Slovenia,Outside Hitter,Men,Italy,2022-06-25,Pool,0,3,11,10,5,9,24,1,1,2,4,0,3,7,10,3,1,8,12,4,2,1,7,0,0,0,0
Tonček ŠTERN,Slovenia,Opposite Spiker,Men,China,2022-06-11,Pool,3,4,4,4,1,3,8,0,1,2,3,0,0,2,2,0,0,0,0,1,0,0,1,0,0,0,0
Alen PAJENK,Slovenia,Middle Blocker,Men,China,2022-06-11,Pool,3,4,6,5,0,0,5,1,1,2,4,0,1,3,4,0,0,1,1,1,1,1,3,1,0,0,1
Uroš PLANINŠIČ,Slovenia,Setter,Men,China,2022-06-11,Pool,3,4,0,0,0,0,0,0,0,2,2,0,0,1,1,0,0,0,0,0,0,0,0,5,1,15,21
Jan KOZAMERNIK,Slovenia,Middle Blocker,Men,China,2022-06-11,Pool,3,4,3,2,0,0,2,1,2,0,3,0,1,3,4,0,0,0,0,0,0,0,0,0,0,0,0
Mitja GASPARINI,Slovenia,Opposite Spiker,Men,China,2022-06-11,Pool,3,4,13,12,4,4,20,1,2,2,5,0,3,13,16,0,0,0,0,3,3,1,7,0,1,0,1
Alan KOŠENINA,Slovenia,Libero,Men,China,2022-06-11,Pool,3,4,0,0,0,0,0,0,0,0,0,0,0,0,0,0,0,0,0,0,0,0,0,0,0,0,0
Crtomir BOŠNJAK,Slovenia,Outside Hitter,Men,China,2022-06-11,Pool,3,4,0,0,0,0,0,0,0,0,0,0,0,0,0,0,0,0,0,0,0,0,0,0,0,0,0
Danijel KONCILJA,Slovenia,Middle Blocker,Men,China,2022-06-11,Pool,3,4,10,9,1,2,12,1,2,3,6,0,2,9,11,1,0,0,1,3,0,0,3,1,0,0,1
Jan KLOBUCAR,Slovenia,Outside Hitter,Men,China,2022-06-11,Pool,3,4,0,0,0,0,0,0,0,0,0,0,0,1,1,1,0,0,1,0,0,0,0,0,0,0,0
Jani KOVAČIČ,Slovenia,Libero,Men,China,2022-06-11,Pool,3,4,0,0,0,0,0,0,0,0,0,0,0,0,0,9,1,18,28,12,4,0,16,3,0,1,4
Žiga ŠTERN,Slovenia,Outside Hitter,Men,China,2022-06-11,Pool,3,4,9,9,7,7,23,0,2,0,2,0,2,13,15,10,1,15,26,5,0,2,7,1,0,3,4
Matic VIDEČNIK,Slovenia,Middle Blocker,Men,China,2022-06-11,Pool,3,4,2,1,2,1,4,1,1,2,4,0,0,5,5,3,0,0,3,1,0,0,1,0,0,1,1
Gregor ROPRET,Slovenia,Setter,Men,China,2022-06-11,Pool,3,4,3,0,0,1,1,1,0,1,2,2,3,18,23,0,0,2,2,6,0,1,7,37,0,36,73
Rok MOŽIČ,Slovenia,Outside Hitter,Men,China,2022-06-11,Pool,3,4,17,14,1,13,28,3,3,1,7,0,3,9,12,6,1,6,13,6,0,0,6,1,0,0,1
Tonček ŠTERN,Slovenia,Opposite Spiker,Men,Australia,2022-06-11,Pool,3,3,10,9,5,5,19,0,4,1,5,1,4,6,11,0,0,0,0,2,1,1,4,0,0,0,0
Alen PAJENK,Slovenia,Middle Blocker,Men,Australia,2022-06-11,Pool,3,3,0,0,0,0,0,0,0,0,0,0,0,0,0,0,0,0,0,0,0,0,0,0,0,0,0
Uroš PLANINŠIČ,Slovenia,Setter,Men,Australia,2022-06-11,Pool,3,3,0,0,0,0,0,0,0,0,0,0,0,0,0,0,0,0,0,0,0,0,0,0,0,0,0
Jan KOZAMERNIK,Slovenia,Middle Blocker,Men,Australia,2022-06-11,Pool,3,3,6,2,0,1,3,3,2,1,6,1,1,6,8,0,0,0,0,1,0,0,1,0,0,1,1
Mitja GASPARINI,Slovenia,Opposite Spiker,Men,Australia,2022-06-11,Pool,3,3,0,0,0,0,0,0,0,0,0,0,0,0,0,0,0,0,0,0,0,0,0,0,0,0,0
Alan KOŠENINA,Slovenia,Libero,Men,Australia,2022-06-11,Pool,3,3,0,0,0,0,0,0,0,0,0,0,0,0,0,3,1,14,18,3,2,3,8,1,0,1,2
Crtomir BOŠNJAK,Slovenia,Outside Hitter,Men,Australia,2022-06-11,Pool,3,3,9,7,1,4,12,2,1,2,5,0,2,7,9,2,0,8,10,6,0,1,7,0,0,0,0
Danijel KONCILJA,Slovenia,Middle Blocker,Men,Australia,2022-06-11,Pool,3,3,8,6,0,4,10,2,3,5,10,0,4,4,8,0,1,0,1,2,0,0,2,0,0,0,0
Jan KLOBUCAR,Slovenia,Outside Hitter,Men,Australia,2022-06-11,Pool,3,3,0,0,0,0,0,0,0,0,0,0,0,7,7,1,0,0,1,2,0,0,2,0,0,0,0
Jani KOVAČIČ,Slovenia,Libero,Men,Australia,2022-06-11,Pool,3,3,0,0,0,0,0,0,0,0,0,0,0,0,0,0,0,0,0,0,0,0,0,0,0,0,0
Žiga ŠTERN,Slovenia,Outside Hitter,Men,Australia,2022-06-11,Pool,3,3,0,0,0,0,0,0,0,0,0,0,0,0,0,0,0,0,0,0,0,0,0,0,0,0,0
Matic VIDEČNIK,Slovenia,Middle Blocker,Men,Australia,2022-06-11,Pool,3,3,3,2,0,0,2,0,0,1,1,1,0,5,6,0,0,0,0,1,0,0,1,0,0,1,1
Gregor ROPRET,Slovenia,Setter,Men,Australia,2022-06-11,Pool,3,3,0,0,0,0,0,0,2,2,4,0,1,12,13,0,0,0,0,2,1,1,4,31,2,29,62
Rok MOŽIČ,Slovenia,Outside Hitter,Men,Australia,2022-06-11,Pool,3,3,17,17,1,3,21,0,3,2,5,0,4,8,12,11,0,10,21,3,0,2,5,0,0,0,0
Tonček ŠTERN,Slovenia,Opposite Spiker,Men,Brazil,2022-06-10,Pool,1,4,2,1,1,2,4,1,1,0,2,0,1,0,1,0,0,0,0,0,0,0,0,0,0,0,0
Alen PAJENK,Slovenia,Middle Blocker,Men,Brazil,2022-06-10,Pool,1,4,11,9,0,4,13,2,3,3,8,0,4,6,10,0,0,0,0,1,0,0,1,1,1,0,2
Uroš PLANINŠIČ,Slovenia,Setter,Men,Brazil,2022-06-10,Pool,1,4,0,0,0,0,0,0,0,0,0,0,0,0,0,0,0,0,0,1,0,0,1,2,0,2,4
Jan KOZAMERNIK,Slovenia,Middle Blocker,Men,Brazil,2022-06-10,Pool,1,4,7,6,0,2,8,0,4,4,8,1,2,12,15,1,0,0,1,4,0,1,5,0,0,0,0
Mitja GASPARINI,Slovenia,Opposite Spiker,Men,Brazil,2022-06-10,Pool,1,4,11,7,4,9,20,1,2,0,3,3,4,16,23,0,0,0,0,3,0,0,3,1,0,2,3
Alan KOŠENINA,Slovenia,Libero,Men,Brazil,2022-06-10,Pool,1,4,0,0,0,0,0,0,0,0,0,0,0,0,0,0,0,0,0,0,0,0,0,0,0,0,0
Crtomir BOŠNJAK,Slovenia,Outside Hitter,Men,Brazil,2022-06-10,Pool,1,4,0,0,0,0,0,0,0,0,0,0,1,0,1,0,0,1,1,0,0,0,0,0,0,0,0
Danijel KONCILJA,Slovenia,Middle Blocker,Men,Brazil,2022-06-10,Pool,1,4,0,0,0,1,1,0,0,0,0,0,0,0,0,0,0,0,0,0,0,0,0,0,0,0,0
Jan KLOBUCAR,Slovenia,Outside Hitter,Men,Brazil,2022-06-10,Pool,1,4,0,0,0,3,3,0,0,1,1,0,0,0,0,0,1,2,3,1,0,0,1,0,0,0,0
Jani KOVAČIČ,Slovenia,Libero,Men,Brazil,2022-06-10,Pool,1,4,0,0,0,0,0,0,0,0,0,0,0,0,0,6,0,21,27,9,1,4,14,5,0,2,7
Žiga ŠTERN,Slovenia,Outside Hitter,Men,Brazil,2022-06-10,Pool,1,4,8,7,4,6,17,1,1,1,3,0,3,7,10,7,6,19,32,3,3,1,7,1,1,4,6
Matic VIDEČNIK,Slovenia,Middle Blocker,Men,Brazil,2022-06-10,Pool,1,4,0,0,0,0,0,0,0,0,0,0,0,0,0,0,0,0,0,0,0,0,0,0,0,0,0
Gregor ROPRET,Slovenia,Setter,Men,Brazil,2022-06-10,Pool,1,4,3,2,1,0,3,0,4,0,4,1,3,7,11,0,0,0,0,7,2,0,9,42,0,38,80
Rok MOŽIČ,Slovenia,Outside Hitter,Men,Brazil,2022-06-10,Pool,1,4,22,20,6,8,34,1,1,0,2,1,5,6,12,6,1,10,17,5,0,2,7,0,0,0,0
Tonček ŠTERN,Slovenia,Opposite Spiker,Men,United States,2022-06-08,Pool,0,3,8,7,6,9,22,0,2,2,4,1,3,4,8,0,0,0,0,4,2,0,6,0,0,2,2
Alen PAJENK,Slovenia,Middle Blocker,Men,United States,2022-06-08,Pool,0,3,7,4,2,2,8,1,2,3,6,2,2,7,11,0,0,0,0,2,0,0,2,0,0,1,1
Uroš PLANINŠIČ,Slovenia,Setter,Men,United States,2022-06-08,Pool,0,3,0,0,0,0,0,0,0,0,0,0,0,0,0,0,0,0,0,0,0,0,0,0,0,1,1
Jan KOZAMERNIK,Slovenia,Middle Blocker,Men,United States,2022-06-08,Pool,0,3,4,4,2,0,6,0,2,5,7,0,2,5,7,0,0,1,1,1,0,0,1,0,0,0,0
Mitja GASPARINI,Slovenia,Opposite Spiker,Men,United States,2022-06-08,Pool,0,3,0,0,0,0,0,0,0,0,0,0,0,0,0,0,0,0,0,0,0,0,0,0,0,0,0
Alan KOŠENINA,Slovenia,Libero,Men,United States,2022-06-08,Pool,0,3,0,0,0,0,0,0,0,0,0,0,0,0,0,0,0,0,0,0,0,0,0,0,0,0,0
Crtomir BOŠNJAK,Slovenia,Outside Hitter,Men,United States,2022-06-08,Pool,0,3,0,0,2,1,3,0,0,0,0,0,0,0,0,0,0,0,0,0,0,0,0,0,0,0,0
Danijel KONCILJA,Slovenia,Middle Blocker,Men,United States,2022-06-08,Pool,0,3,0,0,0,0,0,0,0,0,0,0,0,0,0,0,0,0,0,0,0,0,0,0,0,0,0
Jan KLOBUCAR,Slovenia,Outside Hitter,Men,United States,2022-06-08,Pool,0,3,3,2,1,2,5,1,0,0,1,0,1,1,2,0,2,5,7,1,0,0,1,0,0,0,0
Jani KOVAČIČ,Slovenia,Libero,Men,United States,2022-06-08,Pool,0,3,0,0,0,0,0,0,0,0,0,0,0,0,0,6,1,11,18,5,4,1,10,0,0,5,5
Žiga ŠTERN,Slovenia,Outside Hitter,Men,United States,2022-06-08,Pool,0,3,2,2,3,3,8,0,0,0,0,0,1,7,8,3,1,10,14,7,1,0,8,0,0,0,0
Matic VIDEČNIK,Slovenia,Middle Blocker,Men,United States,2022-06-08,Pool,0,3,0,0,0,0,0,0,0,0,0,0,0,2,2,0,0,0,0,0,0,0,0,0,0,0,0
Gregor ROPRET,Slovenia,Setter,Men,United States,2022-06-08,Pool,0,3,1,0,0,0,0,1,0,1,2,0,1,7,8,0,0,0,0,2,1,0,3,20,0,16,36
Rok MOŽIČ,Slovenia,Outside Hitter,Men,United States,2022-06-08,Pool,0,3,9,8,4,13,25,1,1,1,3,0,2,5,7,5,3,13,21,4,0,2,6,0,0,0,0
Alen PAJENK,Slovenia,Middle Blocker,Men,Argentina,2022-06-23,Pool,3,4,6,6,2,5,13,0,2,6,8,0,2,11,13,0,0,0,0,2,1,0,3,1,0,1,2
Jan KOZAMERNIK,Slovenia,Middle Blocker,Men,Argentina,2022-06-23,Pool,3,4,9,5,1,2,8,3,7,8,18,1,2,14,17,0,0,0,0,4,1,2,7,0,0,0,0
Alan KOŠENINA,Slovenia,Libero,Men,Argentina,2022-06-23,Pool,3,4,0,0,0,0,0,0,0,0,0,0,0,0,0,9,3,22,34,9,3,3,15,1,0,4,5
Crtomir BOŠNJAK,Slovenia,Outside Hitter,Men,Argentina,2022-06-23,Pool,3,4,0,0,0,0,0,0,0,0,0,0,0,0,0,0,0,0,0,0,0,0,0,0,0,0,0
Dejan VINCIC,Slovenia,Setter,Men,Argentina,2022-06-23,Pool,3,4,0,0,0,0,0,0,0,0,0,0,0,1,1,0,0,0,0,0,0,0,0,0,0,0,0
Sašo ŠTALEKAR,Slovenia,Middle Blocker,Men,Argentina,2022-06-23,Pool,3,4,0,0,0,0,0,0,0,0,0,0,0,0,0,0,0,0,0,0,0,0,0,0,0,0,0
Danijel KONCILJA,Slovenia,Middle Blocker,Men,Argentina,2022-06-23,Pool,3,4,0,0,0,0,0,0,0,0,0,0,0,0,0,0,0,0,0,0,0,0,0,0,0,0,0
Jan KLOBUCAR,Slovenia,Outside Hitter,Men,Argentina,2022-06-23,Pool,3,4,0,0,0,0,0,0,0,0,0,0,0,0,0,0,0,0,0,0,0,0,0,0,0,0,0
Žiga ŠTERN,Slovenia,Outside Hitter,Men,Argentina,2022-06-23,Pool,3,4,9,8,4,5,17,1,0,3,4,0,3,14,17,3,0,6,9,5,2,1,8,0,0,3,3
Gregor ROPRET,Slovenia,Setter,Men,Argentina,2022-06-23,Pool,3,4,4,1,0,1,2,1,1,3,5,2,2,16,20,0,0,1,1,14,3,0,17,15,0,76,91
Tine URNAUT,Slovenia,Outside Hitter,Men,Argentina,2022-06-23,Pool,3,4,19,17,3,14,34,0,4,3,7,2,3,15,20,9,0,10,19,9,4,0,13,0,0,5,5
Rok MOŽIČ,Slovenia,Outside Hitter,Men,Argentina,2022-06-23,Pool,3,4,17,13,6,19,38,3,4,6,13,1,2,9,12,0,1,1,2,5,0,0,5,0,0,5,5
Alen PAJENK,Slovenia,Middle Blocker,Men,Netherlands,2022-06-21,Pool,0,3,6,5,1,5,11,0,3,5,8,1,2,8,11,0,0,1,1,2,0,0,2,0,0,1,1
Jan KOZAMERNIK,Slovenia,Middle Blocker,Men,Netherlands,2022-06-21,Pool,0,3,6,2,2,3,7,4,4,4,12,0,2,7,9,0,0,1,1,2,0,1,3,0,0,1,1
Alan KOŠENINA,Slovenia,Libero,Men,Netherlands,2022-06-21,Pool,0,3,0,0,0,0,0,0,0,0,0,0,0,0,0,2,3,12,17,10,4,0,14,0,0,2,2
Crtomir BOŠNJAK,Slovenia,Outside Hitter,Men,Netherlands,2022-06-21,Pool,0,3,0,0,0,0,0,0,0,0,0,0,0,0,0,0,0,0,0,0,0,0,0,0,0,0,0
Dejan VINCIC,Slovenia,Setter,Men,Netherlands,2022-06-21,Pool,0,3,0,0,0,0,0,0,0,0,0,0,0,1,1,0,0,1,1,0,0,0,0,1,0,0,1
Sašo ŠTALEKAR,Slovenia,Middle Blocker,Men,Netherlands,2022-06-21,Pool,0,3,0,0,0,0,0,0,0,0,0,0,0,0,0,0,0,0,0,0,0,0,0,0,0,0,0
Danijel KONCILJA,Slovenia,Middle Blocker,Men,Netherlands,2022-06-21,Pool,0,3,8,8,3,9,20,0,3,2,5,0,4,4,8,0,1,0,1,0,2,1,3,0,0,1,1
Jan KLOBUCAR,Slovenia,Outside Hitter,Men,Netherlands,2022-06-21,Pool,0,3,0,0,0,0,0,0,0,0,0,0,0,0,0,0,0,3,3,0,0,0,0,0,0,0,0
Žiga ŠTERN,Slovenia,Outside Hitter,Men,Netherlands,2022-06-21,Pool,0,3,11,11,3,9,23,0,1,3,4,0,3,9,12,5,2,6,13,6,1,1,8,0,0,0,0
Gregor ROPRET,Slovenia,Setter,Men,Netherlands,2022-06-21,Pool,0,3,2,1,0,0,1,1,2,0,3,0,2,11,13,0,0,0,0,4,0,1,5,16,1,53,70
Tine URNAUT,Slovenia,Outside Hitter,Men,Netherlands,2022-06-21,Pool,0,3,0,0,0,0,0,0,0,0,0,0,0,0,0,0,0,5,5,0,0,1,1,0,0,1,1
Rok MOŽIČ,Slovenia,Outside Hitter,Men,Netherlands,2022-06-21,Pool,0,3,12,8,2,9,19,3,1,2,6,1,4,5,10,3,3,16,22,7,0,1,8,0,0,4,4
Aaron RUSSELL,United States,Outside Hitter,Men,France,2022-07-24,Finals (Gold),2,5,20,20,4,7,31,0,4,1,5,0,3,13,16,5,2,17,24,8,4,1,13,1,0,2,3
Jeffrey JENDRYK II,United States,Middle Blocker,Men,France,2022-07-24,Finals (Gold),2,5,9,6,0,3,9,3,11,3,17,0,3,7,10,1,0,1,2,3,1,0,4,0,0,1,1
Kyle ENSING,United States,Opposite Spiker,Men,France,2022-07-24,Finals (Gold),2,5,1,1,0,4,5,0,0,0,0,0,0,1,1,0,0,0,0,2,0,0,2,0,0,0,0
Mitchell STAHL,United States,Middle Blocker,Men,France,2022-07-24,Finals (Gold),2,5,0,0,0,0,0,0,0,0,0,0,0,0,0,0,0,0,0,0,0,0,0,0,0,0,0
Torey DEFALCO,United States,Outside Hitter,Men,France,2022-07-24,Finals (Gold),2,5,13,13,6,6,25,0,2,4,6,0,2,16,18,2,1,9,12,2,3,1,6,0,1,0,1
Kyle DAGOSTINO,United States,Libero,Men,France,2022-07-24,Finals (Gold),2,5,0,0,0,0,0,0,0,0,0,0,0,0,0,0,0,0,0,0,0,0,0,0,0,0,0
Micah CHRISTENSON,United States,Setter,Men,France,2022-07-24,Finals (Gold),2,5,4,1,0,0,1,2,5,4,11,1,3,15,19,0,0,0,0,4,1,1,6,26,1,69,96
Kyle RUSSELL,United States,Opposite Spiker,Men,France,2022-07-24,Finals (Gold),2,5,4,4,2,5,11,0,1,2,3,0,2,5,7,0,0,0,0,1,0,0,1,0,0,0,0
Joshua TUANIGA,United States,Setter,Men,France,2022-07-24,Finals (Gold),2,5,0,0,0,0,0,0,0,0,0,0,0,0,0,0,0,0,0,0,0,0,0,0,0,0,0
Garrett MUAGUTUTIA,United States,Outside Hitter,Men,France,2022-07-24,Finals (Gold),2,5,11,11,0,4,15,0,4,3,7,0,1,9,10,10,2,6,18,6,1,0,7,0,0,1,1
David SMITH,United States,Middle Blocker,Men,France,2022-07-24,Finals (Gold),2,5,6,4,4,2,10,2,6,6,14,0,0,15,15,0,0,0,0,1,1,0,2,1,0,1,2
Erik SHOJI,United States,Libero,Men,France,2022-07-24,Finals (Gold),2,5,0,0,0,0,0,0,0,0,0,0,0,0,0,9,1,14,24,9,2,2,13,0,0,2,2
Cody KESSEL,United States,Outside Hitter,Men,France,2022-07-24,Finals (Gold),2,5,0,0,0,0,0,0,0,0,0,0,0,0,0,0,0,0,0,0,0,0,0,0,0,0,0
Tyler MITCHEM,United States,Middle Blocker,Men,France,2022-07-24,Finals (Gold),2,5,0,0,0,0,0,0,0,0,0,0,0,0,0,0,0,0,0,0,0,0,0,0,0,0,0
Aaron RUSSELL,United States,Outside Hitter,Men,Poland,2022-07-23,Semifinals,3,3,9,9,4,5,18,0,1,1,2,0,3,7,10,6,1,12,19,5,4,0,9,0,0,0,0
Jeffrey JENDRYK II,United States,Middle Blocker,Men,Poland,2022-07-23,Semifinals,3,3,8,6,0,2,8,1,4,6,11,1,1,8,10,0,0,0,0,0,1,0,1,0,0,0,0
Kyle ENSING,United States,Opposite Spiker,Men,Poland,2022-07-23,Semifinals,3,3,8,8,1,6,15,0,2,2,4,0,2,8,10,0,0,2,2,3,0,0,3,0,0,2,2
Mitchell STAHL,United States,Middle Blocker,Men,Poland,2022-07-23,Semifinals,3,3,0,0,0,0,0,0,0,0,0,0,0,0,0,0,0,0,0,0,0,0,0,0,0,0,0
Torey DEFALCO,United States,Outside Hitter,Men,Poland,2022-07-23,Semifinals,3,3,13,6,2,6,14,1,2,0,3,6,1,11,18,2,0,5,7,4,1,1,6,0,0,2,2
Kyle DAGOSTINO,United States,Libero,Men,Poland,2022-07-23,Semifinals,3,3,0,0,0,0,0,0,0,0,0,0,0,0,0,0,0,1,1,0,0,0,0,0,0,0,0
Micah CHRISTENSON,United States,Setter,Men,Poland,2022-07-23,Semifinals,3,3,4,3,0,1,4,1,1,0,2,0,1,12,13,0,0,0,0,2,0,0,2,12,0,43,55
Kyle RUSSELL,United States,Opposite Spiker,Men,Poland,2022-07-23,Semifinals,3,3,1,0,0,0,0,0,0,0,0,1,2,4,7,0,0,0,0,0,0,0,0,0,0,0,0
Joshua TUANIGA,United States,Setter,Men,Poland,2022-07-23,Semifinals,3,3,0,0,0,0,0,0,0,0,0,0,0,0,0,0,0,0,0,0,0,0,0,0,0,0,0
Garrett MUAGUTUTIA,United States,Outside Hitter,Men,Poland,2022-07-23,Semifinals,3,3,0,0,0,0,0,0,0,0,0,0,0,0,0,0,0,0,0,0,0,0,0,0,0,0,0
David SMITH,United States,Middle Blocker,Men,Poland,2022-07-23,Semifinals,3,3,10,6,1,1,8,3,4,4,11,1,1,4,6,0,0,0,0,3,0,0,3,0,0,1,1
Erik SHOJI,United States,Libero,Men,Poland,2022-07-23,Semifinals,3,3,0,0,0,0,0,0,0,0,0,0,0,0,0,5,3,6,14,9,2,0,11,0,0,3,3
Cody KESSEL,United States,Outside Hitter,Men,Poland,2022-07-23,Semifinals,3,3,0,0,0,0,0,0,0,0,0,0,0,0,0,0,0,0,0,0,0,0,0,0,0,0,0
Tyler MITCHEM,United States,Middle Blocker,Men,Poland,2022-07-23,Semifinals,3,3,0,0,0,0,0,0,0,0,0,0,0,0,0,0,0,0,0,0,0,0,0,0,0,0,0
Aaron RUSSELL,United States,Outside Hitter,Men,Brazil,2022-07-20,Quarterfinals,3,4,14,14,2,10,26,0,0,1,1,0,2,12,14,9,1,17,27,12,3,1,16,0,0,1,1
Jeffrey JENDRYK II,United States,Middle Blocker,Men,Brazil,2022-07-20,Quarterfinals,3,4,8,6,0,4,10,2,6,4,12,0,0,8,8,0,0,0,0,2,1,0,3,0,0,0,0
Kyle ENSING,United States,Opposite Spiker,Men,Brazil,2022-07-20,Quarterfinals,3,4,6,4,3,7,14,1,5,2,8,1,2,3,6,0,0,0,0,3,0,1,4,0,0,0,0
Mitchell STAHL,United States,Middle Blocker,Men,Brazil,2022-07-20,Quarterfinals,3,4,0,0,0,0,0,0,0,0,0,0,0,0,0,0,0,0,0,0,0,0,0,0,0,0,0
Torey DEFALCO,United States,Outside Hitter,Men,Brazil,2022-07-20,Quarterfinals,3,4,17,16,4,9,29,0,5,2,7,1,6,11,18,11,1,10,22,2,6,0,8,0,0,0,0
Kyle DAGOSTINO,United States,Libero,Men,Brazil,2022-07-20,Quarterfinals,3,4,0,0,0,0,0,0,0,0,0,0,0,0,0,0,0,0,0,0,0,0,0,0,0,0,0
Micah CHRISTENSON,United States,Setter,Men,Brazil,2022-07-20,Quarterfinals,3,4,3,0,0,1,1,1,0,0,1,2,1,24,27,0,0,0,0,4,2,0,6,34,0,66,100
Kyle RUSSELL,United States,Opposite Spiker,Men,Brazil,2022-07-20,Quarterfinals,3,4,8,8,2,6,16,0,1,2,3,0,0,7,7,0,0,0,0,4,1,1,6,0,0,0,0
Joshua TUANIGA,United States,Setter,Men,Brazil,2022-07-20,Quarterfinals,3,4,0,0,0,0,0,0,0,0,0,0,0,0,0,0,0,0,0,0,0,0,0,0,0,0,0
Garrett MUAGUTUTIA,United States,Outside Hitter,Men,Brazil,2022-07-20,Quarterfinals,3,4,0,0,0,0,0,0,0,0,0,0,1,2,3,0,0,0,0,0,1,0,1,0,0,0,0
David SMITH,United States,Middle Blocker,Men,Brazil,2022-07-20,Quarterfinals,3,4,11,8,0,3,11,3,6,9,18,0,1,10,11,1,0,1,2,5,2,0,7,0,0,0,0
Erik SHOJI,United States,Libero,Men,Brazil,2022-07-20,Quarterfinals,3,4,0,0,0,0,0,0,0,0,0,0,0,0,0,9,0,9,18,5,5,0,10,0,0,3,3
Cody KESSEL,United States,Outside Hitter,Men,Brazil,2022-07-20,Quarterfinals,3,4,0,0,0,0,0,0,0,0,0,0,0,0,0,0,0,0,0,0,0,0,0,0,0,0,0
Tyler MITCHEM,United States,Middle Blocker,Men,Brazil,2022-07-20,Quarterfinals,3,4,0,0,0,0,0,0,0,0,0,0,0,0,0,0,0,0,0,0,0,0,0,0,0,0,0
Aaron RUSSELL,United States,Outside Hitter,Men,Argentina,2022-07-10,Pool,3,5,0,0,0,0,0,0,0,0,0,0,0,0,0,0,0,0,0,0,0,0,0,0,0,0,0
Jeffrey JENDRYK II,United States,Middle Blocker,Men,Argentina,2022-07-10,Pool,3,5,0,0,0,0,0,0,0,0,0,0,0,0,0,0,0,0,0,0,0,0,0,0,0,0,0
Kyle ENSING,United States,Opposite Spiker,Men,Argentina,2022-07-10,Pool,3,5,8,7,1,5,13,1,3,4,8,0,2,11,13,0,0,0,0,6,1,1,8,1,0,1,2
Mitchell STAHL,United States,Middle Blocker,Men,Argentina,2022-07-10,Pool,3,5,11,7,1,4,12,3,7,7,17,1,8,9,18,0,0,2,2,2,0,0,2,0,0,0,0
Torey DEFALCO,United States,Outside Hitter,Men,Argentina,2022-07-10,Pool,3,5,28,25,6,12,43,3,7,1,11,0,3,13,16,5,1,24,30,5,3,1,9,0,0,7,7
Jake HANES,United States,Opposite Spiker,Men,Argentina,2022-07-10,Pool,3,5,7,7,1,6,14,0,1,2,3,0,2,4,6,0,0,0,0,2,0,0,2,0,0,1,1
Kyle DAGOSTINO,United States,Libero,Men,Argentina,2022-07-10,Pool,3,5,0,0,0,0,0,0,0,0,0,0,0,0,0,10,0,12,22,10,6,5,21,0,0,5,5
Micah CHRISTENSON,United States,Setter,Men,Argentina,2022-07-10,Pool,3,5,3,0,0,1,1,3,3,3,9,0,2,7,9,0,0,1,1,6,3,1,10,28,0,32,60
Joshua TUANIGA,United States,Setter,Men,Argentina,2022-07-10,Pool,3,5,0,0,0,1,1,0,1,2,3,0,0,7,7,0,0,0,0,1,1,2,4,20,0,18,38
Garrett MUAGUTUTIA,United States,Outside Hitter,Men,Argentina,2022-07-10,Pool,3,5,10,10,5,7,22,0,3,1,4,0,1,21,22,11,1,14,26,5,1,3,9,1,0,1,2
David SMITH,United States,Middle Blocker,Men,Argentina,2022-07-10,Pool,3,5,14,9,1,2,12,3,2,7,12,2,3,17,22,0,0,0,0,1,0,0,1,0,0,0,0
Erik SHOJI,United States,Libero,Men,Argentina,2022-07-10,Pool,3,5,0,0,0,0,0,0,0,0,0,0,0,0,0,0,0,0,0,0,0,0,0,0,0,0,0
Cody KESSEL,United States,Outside Hitter,Men,Argentina,2022-07-10,Pool,3,5,0,0,0,0,0,0,0,0,0,0,0,0,0,0,0,0,0,0,0,0,0,0,0,0,0
Tyler MITCHEM,United States,Middle Blocker,Men,Argentina,2022-07-10,Pool,3,5,0,0,0,0,0,0,0,0,0,0,0,0,0,0,0,0,0,0,0,0,0,0,0,0,0
Aaron RUSSELL,United States,Outside Hitter,Men,Canada,2022-07-09,Pool,3,3,11,10,1,12,23,1,3,4,8,0,4,4,8,4,1,7,12,7,2,1,10,1,0,2,3
Jeffrey JENDRYK II,United States,Middle Blocker,Men,Canada,2022-07-09,Pool,3,3,6,4,0,0,4,1,4,4,9,1,0,13,14,1,0,1,2,1,2,0,3,0,0,1,1
Kyle ENSING,United States,Opposite Spiker,Men,Canada,2022-07-09,Pool,3,3,13,10,0,6,16,1,3,1,5,2,1,10,13,0,0,1,1,5,2,3,10,0,0,1,1
Mitchell STAHL,United States,Middle Blocker,Men,Canada,2022-07-09,Pool,3,3,0,0,0,0,0,0,0,0,0,0,0,0,0,0,0,0,0,0,0,0,0,0,0,0,0
Torey DEFALCO,United States,Outside Hitter,Men,Canada,2022-07-09,Pool,3,3,18,17,1,5,23,0,2,4,6,1,2,8,11,5,0,9,14,2,1,0,3,0,0,5,5
Jake HANES,United States,Opposite Spiker,Men,Canada,2022-07-09,Pool,3,3,0,0,0,0,0,0,0,0,0,0,0,0,0,0,0,0,0,0,0,0,0,0,0,0,0
Kyle DAGOSTINO,United States,Libero,Men,Canada,2022-07-09,Pool,3,3,0,0,0,0,0,0,0,0,0,0,0,0,0,0,0,0,0,0,0,0,0,0,0,0,0
Micah CHRISTENSON,United States,Setter,Men,Canada,2022-07-09,Pool,3,3,3,1,0,0,1,1,1,2,4,1,3,11,15,0,0,0,0,4,1,1,6,33,1,22,56
Joshua TUANIGA,United States,Setter,Men,Canada,2022-07-09,Pool,3,3,0,0,0,0,0,0,0,0,0,0,0,0,0,0,0,0,0,0,0,0,0,0,0,0,0
Garrett MUAGUTUTIA,United States,Outside Hitter,Men,Canada,2022-07-09,Pool,3,3,0,0,0,0,0,0,0,0,0,0,0,0,0,0,0,0,0,0,0,0,0,0,0,0,0
David SMITH,United States,Middle Blocker,Men,Canada,2022-07-09,Pool,3,3,6,5,0,3,8,1,2,5,8,0,3,10,13,0,0,0,0,1,1,0,2,1,0,2,3
Erik SHOJI,United States,Libero,Men,Canada,2022-07-09,Pool,3,3,0,0,0,0,0,0,0,0,0,0,0,0,0,7,1,8,16,8,3,2,13,0,1,2,3
Cody KESSEL,United States,Outside Hitter,Men,Canada,2022-07-09,Pool,3,3,0,0,0,0,0,0,0,0,0,0,0,0,0,0,0,0,0,0,0,0,0,0,0,0,0
Tyler MITCHEM,United States,Middle Blocker,Men,Canada,2022-07-09,Pool,3,3,0,0,0,0,0,0,0,0,0,0,0,0,0,0,0,0,0,0,0,0,0,0,0,0,0
Aaron RUSSELL,United States,Outside Hitter,Men,France,2022-07-07,Pool,3,5,18,13,2,15,30,3,5,3,11,2,3,15,20,7,2,16,25,6,1,1,8,0,0,1,1
Jeffrey JENDRYK II,United States,Middle Blocker,Men,France,2022-07-07,Pool,3,5,6,5,2,1,8,1,4,9,14,0,3,9,12,0,1,0,1,4,1,2,7,0,0,0,0
Kyle ENSING,United States,Opposite Spiker,Men,France,2022-07-07,Pool,3,5,12,10,3,12,25,0,8,4,12,2,2,11,15,0,0,0,0,6,4,2,12,0,0,3,3
Mitchell STAHL,United States,Middle Blocker,Men,France,2022-07-07,Pool,3,5,0,0,0,0,0,0,0,0,0,0,0,0,0,0,0,0,0,0,0,0,0,0,0,0,0
Torey DEFALCO,United States,Outside Hitter,Men,France,2022-07-07,Pool,3,5,15,12,5,8,25,2,2,8,12,1,3,13,17,2,2,16,20,6,2,2,10,0,0,7,7
Jake HANES,United States,Opposite Spiker,Men,France,2022-07-07,Pool,3,5,0,0,0,1,1,0,2,2,4,0,2,0,2,0,0,0,0,0,0,1,1,0,0,0,0
Kyle DAGOSTINO,United States,Libero,Men,France,2022-07-07,Pool,3,5,0,0,0,0,0,0,0,0,0,0,0,0,0,0,0,0,0,0,0,0,0,0,0,0,0
Micah CHRISTENSON,United States,Setter,Men,France,2022-07-07,Pool,3,5,3,1,0,3,4,2,4,5,11,0,3,11,14,0,1,1,2,5,2,1,8,23,1,53,77
Joshua TUANIGA,United States,Setter,Men,France,2022-07-07,Pool,3,5,0,0,0,0,0,0,0,0,0,0,0,0,0,0,0,0,0,1,0,0,1,5,0,3,8
Garrett MUAGUTUTIA,United States,Outside Hitter,Men,France,2022-07-07,Pool,3,5,0,0,0,0,0,0,0,0,0,0,2,0,2,0,0,0,0,0,0,0,0,0,0,0,0
David SMITH,United States,Middle Blocker,Men,France,2022-07-07,Pool,3,5,7,5,0,1,6,1,0,5,6,1,2,17,20,0,0,2,2,3,1,0,4,0,0,3,3
Erik SHOJI,United States,Libero,Men,France,2022-07-07,Pool,3,5,0,0,0,0,0,0,0,0,0,0,0,0,0,5,1,12,18,7,3,0,10,0,1,4,5
Cody KESSEL,United States,Outside Hitter,Men,France,2022-07-07,Pool,3,5,0,0,0,0,0,0,0,0,0,0,0,0,0,0,0,0,0,0,0,0,0,0,0,0,0
Tyler MITCHEM,United States,Middle Blocker,Men,France,2022-07-07,Pool,3,5,0,0,0,0,0,0,0,0,0,0,0,0,0,0,0,0,0,0,0,0,0,0,0,0,0
Aaron RUSSELL,United States,Outside Hitter,Men,Germany,2022-07-05,Pool,3,4,23,19,3,12,34,1,4,2,7,3,1,12,16,5,0,6,11,4,1,1,6,0,0,4,4
Jeffrey JENDRYK II,United States,Middle Blocker,Men,Germany,2022-07-05,Pool,3,4,5,5,0,2,7,0,6,9,15,0,1,9,10,2,0,2,4,2,0,0,2,0,0,1,1
Kyle ENSING,United States,Opposite Spiker,Men,Germany,2022-07-05,Pool,3,4,13,12,5,8,25,0,1,7,8,1,3,6,10,0,0,0,0,4,0,2,6,0,0,1,1
Mitchell STAHL,United States,Middle Blocker,Men,Germany,2022-07-05,Pool,3,4,0,0,0,0,0,0,0,0,0,0,0,0,0,0,0,0,0,0,0,0,0,0,0,0,0
Torey DEFALCO,United States,Outside Hitter,Men,Germany,2022-07-05,Pool,3,4,12,11,2,6,19,0,3,7,10,1,4,16,21,14,1,18,33,4,1,1,6,0,0,4,4
Jake HANES,United States,Opposite Spiker,Men,Germany,2022-07-05,Pool,3,4,4,4,3,3,10,0,1,2,3,0,2,4,6,0,0,0,0,0,0,0,0,0,0,0,0
Kyle DAGOSTINO,United States,Libero,Men,Germany,2022-07-05,Pool,3,4,0,0,0,0,0,0,0,0,0,0,0,0,0,0,0,0,0,0,0,0,0,0,0,0,0
Micah CHRISTENSON,United States,Setter,Men,Germany,2022-07-05,Pool,3,4,5,3,0,1,4,1,1,4,6,1,3,11,15,0,0,0,0,10,4,1,15,33,1,53,87
Joshua TUANIGA,United States,Setter,Men,Germany,2022-07-05,Pool,3,4,0,0,0,0,0,0,0,0,0,0,0,0,0,0,0,0,0,0,0,0,0,0,0,0,0
Garrett MUAGUTUTIA,United States,Outside Hitter,Men,Germany,2022-07-05,Pool,3,4,0,0,0,0,0,0,0,0,0,0,2,2,4,0,0,0,0,1,0,0,1,0,0,0,0
David SMITH,United States,Middle Blocker,Men,Germany,2022-07-05,Pool,3,4,8,5,0,4,9,2,7,5,14,1,2,11,14,2,0,3,5,3,0,1,4,0,0,1,1
Erik SHOJI,United States,Libero,Men,Germany,2022-07-05,Pool,3,4,0,0,0,0,0,0,0,0,0,0,0,0,0,10,1,3,14,11,2,2,15,1,0,7,8
Cody KESSEL,United States,Outside Hitter,Men,Germany,2022-07-05,Pool,3,4,0,0,0,0,0,0,0,0,0,0,0,0,0,0,0,0,0,0,0,0,0,0,0,0,0
Tyler MITCHEM,United States,Middle Blocker,Men,Germany,2022-07-05,Pool,3,4,0,0,0,0,0,0,0,0,0,0,0,0,0,0,0,0,0,0,0,0,0,0,0,0,0
Aaron RUSSELL,United States,Outside Hitter,Men,Poland,2022-06-26,Pool,1,4,16,13,6,10,29,0,4,0,4,3,4,10,17,6,0,15,21,1,1,1,3,0,0,1,1
James SHAW,United States,Setter,Men,Poland,2022-06-26,Pool,1,4,0,0,0,0,0,0,1,0,1,0,0,1,1,0,0,0,0,0,0,0,0,1,0,3,4
Jeffrey JENDRYK II,United States,Middle Blocker,Men,Poland,2022-06-26,Pool,1,4,3,3,1,1,5,0,2,0,2,0,0,8,8,0,1,1,2,0,1,0,1,0,0,0,0
Kyle ENSING,United States,Opposite Spiker,Men,Poland,2022-06-26,Pool,1,4,8,8,4,6,18,0,2,0,2,0,3,7,10,0,0,0,0,0,1,1,2,0,0,2,2
Mitchell STAHL,United States,Middle Blocker,Men,Poland,2022-06-26,Pool,1,4,8,5,0,2,7,1,4,2,7,2,3,5,10,0,0,2,2,0,2,0,2,0,0,1,1
Torey DEFALCO,United States,Outside Hitter,Men,Poland,2022-06-26,Pool,1,4,14,11,3,12,26,1,2,1,4,2,0,17,19,9,3,24,36,1,1,1,3,0,0,0,0
Kyle DAGOSTINO,United States,Libero,Men,Poland,2022-06-26,Pool,1,4,0,0,0,0,0,0,0,0,0,0,0,0,0,0,0,0,0,0,0,0,0,0,0,0,0
Kyle RUSSELL,United States,Opposite Spiker,Men,Poland,2022-06-26,Pool,1,4,3,3,0,2,5,0,1,0,1,0,1,5,6,0,0,0,0,0,1,0,1,0,0,0,0
Joshua TUANIGA,United States,Setter,Men,Poland,2022-06-26,Pool,1,4,1,1,0,0,1,0,2,3,5,0,3,12,15,0,0,0,0,2,1,0,3,21,0,64,85
Thomas JAESCHKE,United States,Outside Hitter,Men,Poland,2022-06-26,Pool,1,4,0,0,0,0,0,0,0,0,0,0,0,0,0,0,0,0,0,0,0,0,0,0,0,0,0
Garrett MUAGUTUTIA,United States,Outside Hitter,Men,Poland,2022-06-26,Pool,1,4,0,0,1,0,1,0,1,0,1,0,0,0,0,0,0,1,1,0,0,0,0,0,0,0,0
David SMITH,United States,Middle Blocker,Men,Poland,2022-06-26,Pool,1,4,9,5,1,3,9,3,7,2,12,1,3,5,9,1,0,0,1,0,1,0,1,0,1,0,1
Erik SHOJI,United States,Libero,Men,Poland,2022-06-26,Pool,1,4,0,0,0,0,0,0,0,0,0,0,0,0,0,4,0,12,16,7,4,0,11,1,0,1,2
Tyler MITCHEM,United States,Middle Blocker,Men,Poland,2022-06-26,Pool,1,4,0,0,0,0,0,0,0,0,0,0,0,0,0,0,0,0,0,0,0,0,0,0,0,0,0
Aaron RUSSELL,United States,Outside Hitter,Men,Bulgaria,2022-06-25,Pool,3,4,16,10,5,8,23,2,3,1,6,4,5,8,17,5,1,17,23,1,2,0,3,0,0,0,0
James SHAW,United States,Setter,Men,Bulgaria,2022-06-25,Pool,3,4,0,0,0,0,0,0,0,0,0,0,1,3,4,0,0,0,0,0,1,0,1,2,0,6,8
Jeffrey JENDRYK II,United States,Middle Blocker,Men,Bulgaria,2022-06-25,Pool,3,4,8,7,0,3,10,1,2,4,7,0,1,14,15,0,0,0,0,2,1,0,3,1,0,0,1
Kyle ENSING,United States,Opposite Spiker,Men,Bulgaria,2022-06-25,Pool,3,4,20,17,2,3,22,2,0,3,5,1,5,4,10,0,0,0,0,1,3,0,4,0,0,1,1
Mitchell STAHL,United States,Middle Blocker,Men,Bulgaria,2022-06-25,Pool,3,4,0,0,0,1,1,0,0,0,0,0,0,1,1,0,0,0,0,0,0,0,0,0,0,0,0
Torey DEFALCO,United States,Outside Hitter,Men,Bulgaria,2022-06-25,Pool,3,4,12,10,4,11,25,0,1,1,2,2,3,17,22,6,1,17,24,1,2,1,4,0,0,1,1
Kyle DAGOSTINO,United States,Libero,Men,Bulgaria,2022-06-25,Pool,3,4,0,0,0,0,0,0,0,0,0,0,0,0,0,0,0,0,0,0,0,0,0,0,0,0,0
Kyle RUSSELL,United States,Opposite Spiker,Men,Bulgaria,2022-06-25,Pool,3,4,3,3,0,0,3,0,1,1,2,0,1,1,2,0,0,0,0,0,0,0,0,0,0,0,0
Joshua TUANIGA,United States,Setter,Men,Bulgaria,2022-06-25,Pool,3,4,1,1,0,1,2,0,5,0,5,0,1,12,13,0,0,0,0,5,4,3,12,24,1,50,75
Thomas JAESCHKE,United States,Outside Hitter,Men,Bulgaria,2022-06-25,Pool,3,4,0,0,0,0,0,0,0,0,0,0,0,0,0,0,0,0,0,0,0,0,0,0,0,0,0
Garrett MUAGUTUTIA,United States,Outside Hitter,Men,Bulgaria,2022-06-25,Pool,3,4,3,3,0,0,3,0,0,0,0,0,0,1,1,0,2,2,4,2,1,0,3,0,0,0,0
David SMITH,United States,Middle Blocker,Men,Bulgaria,2022-06-25,Pool,3,4,7,4,0,1,5,2,3,3,8,1,1,8,10,0,0,0,0,0,0,1,1,0,0,1,1
Erik SHOJI,United States,Libero,Men,Bulgaria,2022-06-25,Pool,3,4,0,0,0,0,0,0,0,0,0,0,0,0,0,7,2,9,18,8,3,2,13,1,0,2,3
Tyler MITCHEM,United States,Middle Blocker,Men,Bulgaria,2022-06-25,Pool,3,4,0,0,0,0,0,0,0,0,0,0,0,0,0,0,0,0,0,0,0,0,0,0,0,0,0
Aaron RUSSELL,United States,Outside Hitter,Men,Iran,2022-06-23,Pool,0,3,0,0,0,0,0,0,0,0,0,0,0,0,0,0,0,0,0,0,0,0,0,0,0,0,0
James SHAW,United States,Setter,Men,Iran,2022-06-23,Pool,0,3,0,0,0,1,1,0,1,0,1,0,0,2,2,0,0,0,0,0,0,0,0,5,0,16,21
Jeffrey JENDRYK II,United States,Middle Blocker,Men,Iran,2022-06-23,Pool,0,3,9,5,1,3,9,2,4,2,8,2,2,7,11,0,0,2,2,0,0,0,0,0,0,1,1
Kyle ENSING,United States,Opposite Spiker,Men,Iran,2022-06-23,Pool,0,3,11,11,6,5,22,0,3,0,3,0,1,8,9,0,0,0,0,1,1,0,2,0,0,0,0
Mitchell STAHL,United States,Middle Blocker,Men,Iran,2022-06-23,Pool,0,3,4,3,1,3,7,1,2,2,5,0,1,5,6,0,0,1,1,0,0,0,0,0,0,0,0
Torey DEFALCO,United States,Outside Hitter,Men,Iran,2022-06-23,Pool,0,3,13,13,4,7,24,0,2,0,2,0,3,8,11,4,2,23,29,0,1,1,2,1,0,0,1
Kyle DAGOSTINO,United States,Libero,Men,Iran,2022-06-23,Pool,0,3,0,0,0,0,0,0,0,0,0,0,0,0,0,5,1,16,22,3,3,2,8,1,0,1,2
Kyle RUSSELL,United States,Opposite Spiker,Men,Iran,2022-06-23,Pool,0,3,3,2,0,2,4,0,0,0,0,1,2,2,5,0,0,0,0,1,0,0,1,0,0,0,0
Joshua TUANIGA,United States,Setter,Men,Iran,2022-06-23,Pool,0,3,0,0,1,2,3,0,1,2,3,0,1,8,9,0,0,0,0,0,2,0,2,21,0,41,62
Thomas JAESCHKE,United States,Outside Hitter,Men,Iran,2022-06-23,Pool,0,3,4,3,2,6,11,1,0,0,1,0,1,5,6,3,1,4,8,3,1,1,5,0,0,1,1
Garrett MUAGUTUTIA,United States,Outside Hitter,Men,Iran,2022-06-23,Pool,0,3,3,3,1,3,7,0,0,0,0,0,0,7,7,0,1,3,4,0,0,0,0,0,1,0,1
David SMITH,United States,Middle Blocker,Men,Iran,2022-06-23,Pool,0,3,0,0,0,0,0,0,0,0,0,0,0,0,0,0,0,0,0,0,0,0,0,0,0,0,0
Erik SHOJI,United States,Libero,Men,Iran,2022-06-23,Pool,0,3,0,0,0,0,0,0,0,0,0,0,0,0,0,0,0,0,0,0,0,0,0,0,0,0,0
Tyler MITCHEM,United States,Middle Blocker,Men,Iran,2022-06-23,Pool,0,3,2,2,1,2,5,0,3,0,3,0,1,5,6,0,0,0,0,0,0,0,0,0,0,0,0
Aaron RUSSELL,United States,Outside Hitter,Men,Serbia,2022-06-22,Pool,3,4,12,10,3,3,16,1,2,0,3,1,2,11,14,3,2,12,17,2,4,0,6,1,0,1,2
James SHAW,United States,Setter,Men,Serbia,2022-06-22,Pool,3,4,0,0,0,0,0,0,0,0,0,0,0,0,0,0,0,0,0,0,0,0,0,0,0,0,0
Jeffrey JENDRYK II,United States,Middle Blocker,Men,Serbia,2022-06-22,Pool,3,4,5,5,1,6,12,0,9,3,12,0,1,14,15,0,0,4,4,0,0,0,0,0,0,0,0
Kyle ENSING,United States,Opposite Spiker,Men,Serbia,2022-06-22,Pool,3,4,13,13,4,6,23,0,5,3,8,0,3,11,14,0,0,0,0,2,1,1,4,0,0,0,0
Mitchell STAHL,United States,Middle Blocker,Men,Serbia,2022-06-22,Pool,3,4,0,0,0,0,0,0,0,0,0,0,0,0,0,0,0,0,0,0,0,0,0,0,0,0,0
Torey DEFALCO,United States,Outside Hitter,Men,Serbia,2022-06-22,Pool,3,4,25,23,3,6,32,2,3,1,6,0,6,12,18,5,3,16,24,0,4,0,4,0,0,0,0
Kyle DAGOSTINO,United States,Libero,Men,Serbia,2022-06-22,Pool,3,4,0,0,0,0,0,0,0,0,0,0,0,0,0,0,0,0,0,0,0,0,0,0,0,0,0
Kyle RUSSELL,United States,Opposite Spiker,Men,Serbia,2022-06-22,Pool,3,4,0,0,0,0,0,0,0,0,0,0,0,0,0,0,0,0,0,0,0,0,0,0,0,0,0
Joshua TUANIGA,United States,Setter,Men,Serbia,2022-06-22,Pool,3,4,2,0,0,2,2,0,1,2,3,2,3,14,19,0,0,0,0,2,4,0,6,37,0,52,89
Thomas JAESCHKE,United States,Outside Hitter,Men,Serbia,2022-06-22,Pool,3,4,0,0,0,0,0,0,0,0,0,0,0,0,0,0,0,0,0,0,0,0,0,0,0,0,0
Garrett MUAGUTUTIA,United States,Outside Hitter,Men,Serbia,2022-06-22,Pool,3,4,0,0,0,0,0,0,0,0,0,0,0,0,0,0,0,0,0,0,0,0,0,0,0,0,0
David SMITH,United States,Middle Blocker,Men,Serbia,2022-06-22,Pool,3,4,11,5,1,2,8,4,3,1,8,2,2,14,18,0,0,2,2,2,1,1,4,0,0,0,0
Erik SHOJI,United States,Libero,Men,Serbia,2022-06-22,Pool,3,4,0,0,0,0,0,0,0,0,0,0,0,0,0,9,1,14,24,4,0,2,6,0,0,1,1
Tyler MITCHEM,United States,Middle Blocker,Men,Serbia,2022-06-22,Pool,3,4,0,0,0,0,0,0,0,0,0,0,0,0,0,0,0,0,0,0,0,0,0,0,0,0,0
Aaron RUSSELL,United States,Outside Hitter,Men,Brazil,2022-06-11,Pool,3,4,10,9,6,9,24,0,5,1,6,1,5,9,15,14,0,20,34,7,2,2,11,2,0,0,2
James SHAW,United States,Setter,Men,Brazil,2022-06-11,Pool,3,4,0,0,1,0,1,0,0,0,0,0,0,2,2,0,0,0,0,0,0,0,0,3,0,7,10
Jeffrey JENDRYK II,United States,Middle Blocker,Men,Brazil,2022-06-11,Pool,3,4,12,9,1,0,10,2,4,3,9,1,3,11,15,0,0,2,2,1,1,0,2,0,0,1,1
Kyle ENSING,United States,Opposite Spiker,Men,Brazil,2022-06-11,Pool,3,4,0,0,0,0,0,0,0,0,0,0,0,0,0,0,0,0,0,0,0,0,0,0,0,0,0
Jacob PASTEUR,United States,Outside Hitter,Men,Brazil,2022-06-11,Pool,3,4,0,0,0,0,0,0,0,0,0,0,0,0,0,0,0,0,0,0,0,0,0,0,0,0,0
Jake HANES,United States,Opposite Spiker,Men,Brazil,2022-06-11,Pool,3,4,20,17,4,16,37,2,3,1,6,1,2,18,21,0,0,0,0,7,3,2,12,0,0,0,0
Kyle DAGOSTINO,United States,Libero,Men,Brazil,2022-06-11,Pool,3,4,0,0,0,0,0,0,0,0,0,0,0,0,0,11,1,6,18,12,1,0,13,7,0,1,8
Patrick GASMAN,United States,Middle Blocker,Men,Brazil,2022-06-11,Pool,3,4,0,0,0,0,0,0,0,0,0,0,0,0,0,0,0,0,0,0,0,0,0,0,0,0,0
Joshua TUANIGA,United States,Setter,Men,Brazil,2022-06-11,Pool,3,4,5,3,0,1,4,2,3,4,9,0,3,10,13,0,0,1,1,4,2,0,6,43,0,42,85
Thomas JAESCHKE,United States,Outside Hitter,Men,Brazil,2022-06-11,Pool,3,4,0,0,0,0,0,0,0,0,0,0,0,0,0,0,0,0,0,0,0,0,0,0,0,0,0
David SMITH,United States,Middle Blocker,Men,Brazil,2022-06-11,Pool,3,4,0,0,0,0,0,0,0,0,0,0,0,0,0,0,0,0,0,0,0,0,0,0,0,0,0
Mason BRIGGS,United States,Libero,Men,Brazil,2022-06-11,Pool,3,4,0,0,0,0,0,0,0,0,0,0,0,0,0,0,0,0,0,0,0,0,0,0,0,0,0
Cody KESSEL,United States,Outside Hitter,Men,Brazil,2022-06-11,Pool,3,4,8,8,3,9,20,0,4,3,7,0,1,14,15,6,2,6,14,7,1,1,9,0,0,1,1
Tyler MITCHEM,United States,Middle Blocker,Men,Brazil,2022-06-11,Pool,3,4,13,9,0,2,11,2,7,4,13,2,2,12,16,0,0,0,0,5,0,0,5,0,0,0,0
Aaron RUSSELL,United States,Outside Hitter,Men,Japan,2022-06-10,Pool,3,5,20,16,3,14,33,1,2,7,10,3,4,13,20,8,0,26,34,7,1,1,9,2,0,1,3
James SHAW,United States,Setter,Men,Japan,2022-06-10,Pool,3,5,0,0,0,0,0,0,0,0,0,0,0,0,0,0,0,0,0,2,0,0,2,5,0,6,11
Jeffrey JENDRYK II,United States,Middle Blocker,Men,Japan,2022-06-10,Pool,3,5,16,11,1,5,17,4,8,10,22,1,3,15,19,0,0,0,0,2,3,1,6,0,0,0,0
Kyle ENSING,United States,Opposite Spiker,Men,Japan,2022-06-10,Pool,3,5,20,19,2,15,36,1,4,8,13,0,4,13,17,0,0,0,0,5,2,3,10,0,0,0,0
Jacob PASTEUR,United States,Outside Hitter,Men,Japan,2022-06-10,Pool,3,5,0,0,0,0,0,0,0,0,0,0,0,0,0,0,0,0,0,0,0,0,0,0,0,0,0
Jake HANES,United States,Opposite Spiker,Men,Japan,2022-06-10,Pool,3,5,2,2,0,1,3,0,0,0,0,0,1,0,1,0,0,0,0,0,0,0,0,0,0,1,1
Kyle DAGOSTINO,United States,Libero,Men,Japan,2022-06-10,Pool,3,5,0,0,0,0,0,0,0,0,0,0,0,0,0,5,0,7,12,14,4,3,21,10,0,3,13
Patrick GASMAN,United States,Middle Blocker,Men,Japan,2022-06-10,Pool,3,5,0,0,0,0,0,0,0,0,0,0,0,0,0,0,0,0,0,0,0,0,0,0,0,0,0
Joshua TUANIGA,United States,Setter,Men,Japan,2022-06-10,Pool,3,5,3,2,1,1,4,1,2,6,9,0,5,15,20,0,0,0,0,7,0,1,8,52,0,43,95
Thomas JAESCHKE,United States,Outside Hitter,Men,Japan,2022-06-10,Pool,3,5,11,9,2,16,27,2,2,1,5,0,5,11,16,13,1,20,34,10,1,0,11,3,0,0,3
David SMITH,United States,Middle Blocker,Men,Japan,2022-06-10,Pool,3,5,6,5,2,4,11,1,6,10,17,0,3,9,12,0,0,1,1,3,0,2,5,1,0,1,2
Mason BRIGGS,United States,Libero,Men,Japan,2022-06-10,Pool,3,5,0,0,0,0,0,0,0,0,0,0,0,0,0,0,0,0,0,0,0,0,0,0,0,0,0
Cody KESSEL,United States,Outside Hitter,Men,Japan,2022-06-10,Pool,3,5,0,0,0,0,0,0,0,0,0,0,0,2,2,0,0,0,0,0,0,0,0,0,0,0,0
Tyler MITCHEM,United States,Middle Blocker,Men,Japan,2022-06-10,Pool,3,5,0,0,0,0,0,0,0,0,0,0,0,1,1,0,0,1,1,0,0,0,0,0,0,0,0
Aaron RUSSELL,United States,Outside Hitter,Men,Netherlands,2022-06-09,Pool,3,3,14,11,2,4,17,1,3,2,6,2,1,11,14,4,0,3,7,3,3,4,10,5,0,5,10
James SHAW,United States,Setter,Men,Netherlands,2022-06-09,Pool,3,3,2,1,0,1,2,1,0,0,1,0,1,1,2,0,0,0,0,0,0,0,0,6,0,6,12
Jeffrey JENDRYK II,United States,Middle Blocker,Men,Netherlands,2022-06-09,Pool,3,3,5,3,0,0,3,1,4,1,6,1,1,13,15,0,0,0,0,4,1,0,5,0,0,0,0
Kyle ENSING,United States,Opposite Spiker,Men,Netherlands,2022-06-09,Pool,3,3,14,11,3,2,16,2,1,0,3,1,3,9,13,0,0,0,0,6,0,0,6,0,0,0,0
Jacob PASTEUR,United States,Outside Hitter,Men,Netherlands,2022-06-09,Pool,3,3,0,0,0,0,0,0,0,0,0,0,0,0,0,0,0,0,0,0,0,0,0,0,0,0,0
Jake HANES,United States,Opposite Spiker,Men,Netherlands,2022-06-09,Pool,3,3,3,3,0,1,4,0,0,0,0,0,0,2,2,0,0,0,0,0,0,0,0,0,0,0,0
Kyle DAGOSTINO,United States,Libero,Men,Netherlands,2022-06-09,Pool,3,3,0,0,0,0,0,0,0,0,0,0,0,0,0,6,0,7,13,9,0,0,9,3,0,0,3
Patrick GASMAN,United States,Middle Blocker,Men,Netherlands,2022-06-09,Pool,3,3,0,0,0,0,0,0,0,0,0,0,0,0,0,0,0,0,0,0,0,0,0,0,0,0,0
Joshua TUANIGA,United States,Setter,Men,Netherlands,2022-06-09,Pool,3,3,2,2,1,0,3,0,2,2,4,0,1,6,7,0,0,0,0,3,0,0,3,17,0,20,37
Thomas JAESCHKE,United States,Outside Hitter,Men,Netherlands,2022-06-09,Pool,3,3,9,7,4,5,16,1,2,2,5,1,2,6,9,3,0,15,18,5,1,0,6,1,0,0,1
David SMITH,United States,Middle Blocker,Men,Netherlands,2022-06-09,Pool,3,3,5,3,1,1,5,2,1,4,7,0,0,12,12,0,0,0,0,1,0,0,1,2,0,0,2
Mason BRIGGS,United States,Libero,Men,Netherlands,2022-06-09,Pool,3,3,0,0,0,0,0,0,0,0,0,0,0,0,0,0,0,0,0,0,0,0,0,0,0,0,0
Cody KESSEL,United States,Outside Hitter,Men,Netherlands,2022-06-09,Pool,3,3,0,0,0,0,0,0,0,0,0,0,0,0,0,0,0,0,0,0,0,0,0,0,0,0,0
Tyler MITCHEM,United States,Middle Blocker,Men,Netherlands,2022-06-09,Pool,3,3,1,1,0,1,2,0,0,0,0,0,0,0,0,0,0,0,0,0,0,0,0,0,0,0,0
Aaron RUSSELL,United States,Outside Hitter,Men,Slovenia,2022-06-08,Pool,3,3,14,8,5,7,20,4,2,1,7,2,2,8,12,3,1,16,20,6,0,3,9,0,0,0,0
James SHAW,United States,Setter,Men,Slovenia,2022-06-08,Pool,3,3,2,1,0,0,1,1,0,1,2,0,0,0,0,0,0,0,0,0,0,0,0,1,0,1,2
Jeffrey JENDRYK II,United States,Middle Blocker,Men,Slovenia,2022-06-08,Pool,3,3,7,4,0,4,8,3,2,4,9,0,2,7,9,0,0,0,0,1,0,0,1,0,0,1,1
Kyle ENSING,United States,Opposite Spiker,Men,Slovenia,2022-06-08,Pool,3,3,14,12,3,4,19,0,0,7,7,2,1,13,16,0,0,0,0,2,1,0,3,0,0,4,4
Jacob PASTEUR,United States,Outside Hitter,Men,Slovenia,2022-06-08,Pool,3,3,0,0,0,0,0,0,0,0,0,0,0,0,0,0,0,0,0,0,0,0,0,0,0,0,0
Jake HANES,United States,Opposite Spiker,Men,Slovenia,2022-06-08,Pool,3,3,0,0,0,0,0,0,0,0,0,0,0,0,0,0,0,0,0,0,0,0,0,0,0,0,0
Kyle DAGOSTINO,United States,Libero,Men,Slovenia,2022-06-08,Pool,3,3,0,0,0,0,0,0,0,0,0,0,0,0,0,5,2,5,12,5,3,0,8,0,0,3,3
Patrick GASMAN,United States,Middle Blocker,Men,Slovenia,2022-06-08,Pool,3,3,0,0,0,0,0,0,0,0,0,0,0,0,0,0,0,0,0,0,0,0,0,0,0,0,0
Joshua TUANIGA,United States,Setter,Men,Slovenia,2022-06-08,Pool,3,3,3,2,0,0,2,0,3,4,7,1,3,9,13,0,0,0,0,5,0,1,6,17,0,12,29
Thomas JAESCHKE,United States,Outside Hitter,Men,Slovenia,2022-06-08,Pool,3,3,9,6,1,6,13,1,2,1,4,2,3,9,14,2,0,6,8,5,1,1,7,0,0,0,0
David SMITH,United States,Middle Blocker,Men,Slovenia,2022-06-08,Pool,3,3,8,3,0,1,4,5,0,2,7,0,2,8,10,0,0,1,1,4,0,0,4,0,0,1,1
Mason BRIGGS,United States,Libero,Men,Slovenia,2022-06-08,Pool,3,3,0,0,0,0,0,0,0,0,0,0,0,0,0,0,0,0,0,0,0,0,0,0,0,0,0
Cody KESSEL,United States,Outside Hitter,Men,Slovenia,2022-06-08,Pool,3,3,0,0,0,0,0,0,0,0,0,0,0,0,0,0,0,0,0,0,0,0,0,0,0,0,0
Tyler MITCHEM,United States,Middle Blocker,Men,Slovenia,2022-06-08,Pool,3,3,0,0,0,0,0,0,0,0,0,0,0,0,0,0,0,0,0,0,0,0,0,0,0,0,0
Elise VAN SAS,Belgium,Setter,Women,Japan,2022-07-03,Pool,3,5,0,0,0,0,0,0,0,0,0,0,0,0,0,0,0,0,0,0,0,0,0,0,0,2,2
Britt HERBOTS,Belgium,Outside Hitter,Women,Japan,2022-07-03,Pool,3,5,29,29,3,35,67,0,2,1,3,0,3,14,17,8,0,7,15,11,1,0,12,0,0,7,7
Nathalie LEMMENS,Belgium,Middle Blocker,Women,Japan,2022-07-03,Pool,3,5,8,6,2,3,11,2,9,4,15,0,0,16,16,0,0,0,0,2,0,0,2,0,0,2,2
Jodie GUILLIAMS,Belgium,Outside Hitter,Women,Japan,2022-07-03,Pool,3,5,3,3,5,10,18,0,2,1,3,0,0,6,6,12,0,12,24,5,1,1,7,0,0,1,1
Celine VAN GESTEL,Belgium,Outside Hitter,Women,Japan,2022-07-03,Pool,3,5,0,0,0,0,0,0,0,0,0,0,0,0,0,0,0,0,0,0,0,0,0,0,0,0,0
Nel DEMEYER,Belgium,Libero,Women,Japan,2022-07-03,Pool,3,5,0,0,0,0,0,0,0,0,0,0,0,0,0,0,0,0,0,1,0,0,1,0,0,0,0
Pauline MARTIN,Belgium,Opposite Spiker,Women,Japan,2022-07-03,Pool,3,5,0,0,0,0,0,0,0,0,0,0,0,0,0,0,0,0,0,0,0,0,0,0,0,0,0
Charlotte KRENICKY,Belgium,Setter,Women,Japan,2022-07-03,Pool,3,5,1,0,1,0,1,1,0,0,1,0,0,1,1,0,0,0,0,0,0,0,0,0,0,8,8
Marlies JANSSENS,Belgium,Middle Blocker,Women,Japan,2022-07-03,Pool,3,5,11,7,2,16,25,4,7,3,14,0,3,10,13,0,0,0,0,3,0,0,3,0,0,2,2
Jutta VAN DE VYVER,Belgium,Setter,Women,Japan,2022-07-03,Pool,3,5,3,1,0,1,2,0,1,2,3,2,2,10,14,0,0,0,0,11,0,0,11,9,0,117,126
Britt RAMPELBERG,Belgium,Libero,Women,Japan,2022-07-03,Pool,3,5,0,0,0,0,0,0,0,1,1,0,0,0,0,9,0,7,16,15,2,0,17,0,0,5,5
Silke VAN AVERMAET,Belgium,Middle Blocker,Women,Japan,2022-07-03,Pool,3,5,8,6,0,12,18,2,3,0,5,0,0,8,8,0,0,0,0,4,2,0,6,0,0,0,0
Manon STRAGIER,Belgium,Outside Hitter,Women,Japan,2022-07-03,Pool,3,5,12,7,0,9,16,2,2,2,6,3,1,13,17,17,3,11,31,9,3,0,12,0,0,1,1
Anna KOULBERG,Belgium,Middle Blocker,Women,Japan,2022-07-03,Pool,3,5,0,0,0,0,0,0,0,0,0,0,0,1,1,0,0,0,0,0,0,0,0,0,0,0,0
Elise VAN SAS,Belgium,Setter,Women,Netherlands,2022-07-01,Pool,1,4,0,0,0,0,0,0,1,0,1,0,0,0,0,0,0,0,0,0,0,0,0,0,0,0,0
Britt HERBOTS,Belgium,Outside Hitter,Women,Netherlands,2022-07-01,Pool,1,4,31,28,11,47,86,1,3,0,4,2,2,12,16,16,1,19,36,6,1,0,7,0,1,4,5
Nathalie LEMMENS,Belgium,Middle Blocker,Women,Netherlands,2022-07-01,Pool,1,4,2,0,0,5,5,2,3,3,8,0,1,11,12,0,0,0,0,0,1,0,1,0,0,1,1
Jodie GUILLIAMS,Belgium,Outside Hitter,Women,Netherlands,2022-07-01,Pool,1,4,13,12,4,16,32,1,1,2,4,0,2,12,14,14,3,25,42,16,1,1,18,0,0,3,3
Celine VAN GESTEL,Belgium,Outside Hitter,Women,Netherlands,2022-07-01,Pool,1,4,0,0,0,0,0,0,0,0,0,0,0,0,0,0,0,0,0,0,0,0,0,0,0,0,0
Nel DEMEYER,Belgium,Libero,Women,Netherlands,2022-07-01,Pool,1,4,0,0,0,0,0,0,0,0,0,0,0,0,0,0,0,1,1,10,4,0,14,0,0,7,7
Pauline MARTIN,Belgium,Opposite Spiker,Women,Netherlands,2022-07-01,Pool,1,4,0,0,0,0,0,0,0,0,0,0,0,0,0,0,0,0,0,0,0,0,0,0,0,0,0
Charlotte KRENICKY,Belgium,Setter,Women,Netherlands,2022-07-01,Pool,1,4,0,0,0,1,1,0,0,0,0,0,0,1,1,0,0,0,0,0,2,0,2,0,0,13,13
Marlies JANSSENS,Belgium,Middle Blocker,Women,Netherlands,2022-07-01,Pool,1,4,13,8,1,8,17,4,3,6,13,1,2,8,11,0,0,0,0,2,0,0,2,0,0,2,2
Jutta VAN DE VYVER,Belgium,Setter,Women,Netherlands,2022-07-01,Pool,1,4,1,1,0,1,2,0,0,1,1,0,2,16,18,0,0,1,1,14,5,0,19,5,0,127,132
Britt RAMPELBERG,Belgium,Libero,Women,Netherlands,2022-07-01,Pool,1,4,0,0,0,0,0,0,0,0,0,0,0,0,0,4,0,4,8,14,1,0,15,0,0,7,7
Silke VAN AVERMAET,Belgium,Middle Blocker,Women,Netherlands,2022-07-01,Pool,1,4,12,11,3,9,23,1,2,3,6,0,0,12,12,0,0,0,0,11,2,0,13,0,0,3,3
Manon STRAGIER,Belgium,Outside Hitter,Women,Netherlands,2022-07-01,Pool,1,4,0,0,0,0,0,0,0,0,0,0,1,3,4,0,0,0,0,1,1,0,2,0,1,0,1
Anna KOULBERG,Belgium,Middle Blocker,Women,Netherlands,2022-07-01,Pool,1,4,0,0,0,1,1,0,0,0,0,0,0,3,3,0,0,1,1,0,0,0,0,0,0,0,0
Elise VAN SAS,Belgium,Setter,Women,Germany,2022-06-30,Pool,1,4,0,0,0,0,0,0,0,0,0,0,0,0,0,0,0,0,0,0,0,0,0,0,0,1,1
Britt HERBOTS,Belgium,Outside Hitter,Women,Germany,2022-06-30,Pool,1,4,34,33,6,43,82,1,2,1,4,0,1,13,14,2,0,9,11,8,2,0,10,0,0,6,6
Nathalie LEMMENS,Belgium,Middle Blocker,Women,Germany,2022-06-30,Pool,1,4,6,5,1,4,10,1,5,1,7,0,2,8,10,0,0,0,0,3,1,0,4,0,0,1,1
Jodie GUILLIAMS,Belgium,Outside Hitter,Women,Germany,2022-06-30,Pool,1,4,8,8,2,8,18,0,1,0,1,0,2,15,17,9,2,16,27,12,1,0,13,0,0,4,4
Celine VAN GESTEL,Belgium,Outside Hitter,Women,Germany,2022-06-30,Pool,1,4,0,0,0,0,0,0,0,0,0,0,0,0,0,0,0,0,0,0,0,0,0,0,0,0,0
Nel DEMEYER,Belgium,Libero,Women,Germany,2022-06-30,Pool,1,4,0,0,0,0,0,0,0,0,0,0,0,0,0,0,0,3,3,5,1,0,6,0,0,2,2
Pauline MARTIN,Belgium,Opposite Spiker,Women,Germany,2022-06-30,Pool,1,4,0,0,0,0,0,0,0,0,0,0,0,0,0,0,0,0,0,0,0,0,0,0,0,0,0
Charlotte KRENICKY,Belgium,Setter,Women,Germany,2022-06-30,Pool,1,4,1,1,0,1,2,0,1,0,1,0,1,2,3,0,0,0,0,2,1,0,3,1,0,39,40
Marlies JANSSENS,Belgium,Middle Blocker,Women,Germany,2022-06-30,Pool,1,4,11,6,1,6,13,3,2,1,6,2,2,10,14,0,0,1,1,3,0,0,3,0,0,3,3
Jutta VAN DE VYVER,Belgium,Setter,Women,Germany,2022-06-30,Pool,1,4,0,0,0,4,4,0,2,0,2,0,0,10,10,0,0,1,1,2,1,0,3,6,1,82,89
Britt RAMPELBERG,Belgium,Libero,Women,Germany,2022-06-30,Pool,1,4,0,0,0,0,0,0,0,0,0,0,0,0,0,14,2,26,42,14,3,1,18,0,0,9,9
Silke VAN AVERMAET,Belgium,Middle Blocker,Women,Germany,2022-06-30,Pool,1,4,9,8,0,15,23,0,2,0,2,1,2,13,16,0,0,0,0,11,4,0,15,0,0,1,1
Manon STRAGIER,Belgium,Outside Hitter,Women,Germany,2022-06-30,Pool,1,4,1,0,0,0,0,0,0,0,0,1,0,1,2,0,0,0,0,0,0,0,0,0,0,0,0
Anna KOULBERG,Belgium,Middle Blocker,Women,Germany,2022-06-30,Pool,1,4,0,0,0,0,0,0,0,0,0,0,0,0,0,0,0,0,0,0,0,0,0,0,0,0,0
Elise VAN SAS,Belgium,Setter,Women,United States,2022-06-30,Pool,0,3,0,0,0,0,0,0,1,0,1,0,0,1,1,0,0,0,0,1,0,0,1,1,0,11,12
Britt HERBOTS,Belgium,Outside Hitter,Women,United States,2022-06-30,Pool,0,3,18,16,5,16,37,1,4,0,5,1,0,11,12,5,0,8,13,2,3,0,5,0,0,3,3
Nathalie LEMMENS,Belgium,Middle Blocker,Women,United States,2022-06-30,Pool,0,3,0,0,0,0,0,0,0,0,0,0,0,0,0,0,0,0,0,0,0,0,0,0,0,0,0
Jodie GUILLIAMS,Belgium,Outside Hitter,Women,United States,2022-06-30,Pool,0,3,6,4,4,14,22,0,3,0,3,2,0,8,10,7,0,17,24,2,0,0,2,0,0,0,0
Celine VAN GESTEL,Belgium,Outside Hitter,Women,United States,2022-06-30,Pool,0,3,0,0,0,0,0,0,0,0,0,0,0,0,0,0,0,0,0,0,0,0,0,0,0,0,0
Nel DEMEYER,Belgium,Libero,Women,United States,2022-06-30,Pool,0,3,0,0,0,0,0,0,0,0,0,0,0,0,0,0,0,0,0,3,4,0,7,0,0,4,4
Pauline MARTIN,Belgium,Opposite Spiker,Women,United States,2022-06-30,Pool,0,3,5,5,4,6,15,0,2,1,3,0,2,2,4,0,0,0,0,4,0,1,5,0,0,0,0
Charlotte KRENICKY,Belgium,Setter,Women,United States,2022-06-30,Pool,0,3,0,0,0,0,0,0,0,0,0,0,0,0,0,0,0,0,0,0,0,0,0,0,0,0,0
Marlies JANSSENS,Belgium,Middle Blocker,Women,United States,2022-06-30,Pool,0,3,7,4,3,7,14,2,1,1,4,1,3,6,10,1,0,0,1,2,1,0,3,0,0,1,1
Jutta VAN DE VYVER,Belgium,Setter,Women,United States,2022-06-30,Pool,0,3,2,1,0,0,1,1,0,0,1,0,0,8,8,0,0,1,1,7,2,0,9,0,1,81,82
Britt RAMPELBERG,Belgium,Libero,Women,United States,2022-06-30,Pool,0,3,0,0,0,0,0,0,0,0,0,0,0,0,0,9,2,16,27,5,1,0,6,0,0,4,4
Silke VAN AVERMAET,Belgium,Middle Blocker,Women,United States,2022-06-30,Pool,0,3,7,6,0,7,13,1,2,0,3,0,1,8,9,0,0,1,1,2,0,0,2,0,0,0,0
Manon STRAGIER,Belgium,Outside Hitter,Women,United States,2022-06-30,Pool,0,3,0,0,0,1,1,0,0,0,0,0,0,4,4,1,0,0,1,1,0,0,1,0,0,1,1
Anna KOULBERG,Belgium,Middle Blocker,Women,United States,2022-06-30,Pool,0,3,0,0,0,0,0,0,0,0,0,0,0,0,0,0,0,0,0,0,0,0,0,0,0,0,0
Elise VAN SAS,Belgium,Setter,Women,Türkiye,2022-06-05,Pool,1,4,0,0,0,1,1,0,2,2,4,0,0,1,1,0,0,0,0,2,0,1,3,7,1,14,22
Britt HERBOTS,Belgium,Outside Hitter,Women,Türkiye,2022-06-05,Pool,1,4,20,18,9,32,59,1,1,2,4,1,1,12,14,6,0,20,26,11,2,2,15,0,0,2,2
Nathalie LEMMENS,Belgium,Middle Blocker,Women,Türkiye,2022-06-05,Pool,1,4,9,5,0,6,11,2,6,9,17,2,0,10,12,0,0,0,0,2,0,2,4,1,0,2,3
Celine VAN GESTEL,Belgium,Outside Hitter,Women,Türkiye,2022-06-05,Pool,1,4,9,8,9,14,31,1,0,3,4,0,1,9,10,8,1,17,26,15,3,5,23,0,0,3,3
Nel DEMEYER,Belgium,Libero,Women,Türkiye,2022-06-05,Pool,1,4,0,0,0,0,0,0,0,0,0,0,0,0,0,0,0,0,0,0,0,0,0,0,0,0,0
Pauline MARTIN,Belgium,Opposite Spiker,Women,Türkiye,2022-06-05,Pool,1,4,13,12,3,10,25,1,1,1,3,0,2,7,9,0,0,0,0,3,4,1,8,0,0,1,1
Stien GORIS,Belgium,Outside Hitter,Women,Türkiye,2022-06-05,Pool,1,4,1,1,0,1,2,0,0,0,0,0,0,2,2,0,1,0,1,0,0,1,1,0,0,1,1
Charlotte KRENICKY,Belgium,Setter,Women,Türkiye,2022-06-05,Pool,1,4,0,0,0,0,0,0,0,0,0,0,0,0,0,0,0,0,0,0,0,0,0,0,0,0,0
Marlies JANSSENS,Belgium,Middle Blocker,Women,Türkiye,2022-06-05,Pool,1,4,0,0,0,0,0,0,0,0,0,0,0,0,0,0,0,0,0,0,0,0,0,0,0,0,0
Jutta VAN DE VYVER,Belgium,Setter,Women,Türkiye,2022-06-05,Pool,1,4,1,0,0,0,0,0,1,1,2,1,2,14,17,0,0,0,0,5,1,3,9,38,1,56,95
Britt RAMPELBERG,Belgium,Libero,Women,Türkiye,2022-06-05,Pool,1,4,0,0,0,0,0,0,0,0,0,0,0,0,0,5,1,21,27,12,1,1,14,0,0,9,9
Silke VAN AVERMAET,Belgium,Middle Blocker,Women,Türkiye,2022-06-05,Pool,1,4,7,6,1,7,14,1,2,4,7,0,2,11,13,1,0,0,1,6,0,1,7,1,1,1,3
Manon STRAGIER,Belgium,Outside Hitter,Women,Türkiye,2022-06-05,Pool,1,4,0,0,0,0,0,0,0,0,0,0,1,4,5,0,0,0,0,2,2,1,5,0,0,0,0
Anna KOULBERG,Belgium,Middle Blocker,Women,Türkiye,2022-06-05,Pool,1,4,0,0,0,0,0,0,0,0,0,0,0,0,0,0,0,0,0,0,0,0,0,0,0,0,0
Elise VAN SAS,Belgium,Setter,Women,Thailand,2022-06-04,Pool,3,5,0,0,0,0,0,0,0,2,2,0,0,0,0,0,0,0,0,0,0,0,0,0,0,2,2
Britt HERBOTS,Belgium,Outside Hitter,Women,Thailand,2022-06-04,Pool,3,5,23,22,10,34,66,1,3,5,9,0,1,21,22,4,0,15,19,14,4,1,19,0,0,3,3
Nathalie LEMMENS,Belgium,Middle Blocker,Women,Thailand,2022-06-04,Pool,3,5,10,10,0,1,11,0,8,7,15,0,1,10,11,0,0,0,0,2,1,0,3,0,0,2,2
Celine VAN GESTEL,Belgium,Outside Hitter,Women,Thailand,2022-06-04,Pool,3,5,13,12,3,29,44,1,3,5,9,0,0,12,12,11,1,22,34,24,3,1,28,0,1,2,3
Nel DEMEYER,Belgium,Libero,Women,Thailand,2022-06-04,Pool,3,5,0,0,0,0,0,0,0,0,0,0,0,0,0,1,0,2,3,2,0,0,2,0,0,0,0
Pauline MARTIN,Belgium,Opposite Spiker,Women,Thailand,2022-06-04,Pool,3,5,0,0,0,0,0,0,0,0,0,0,0,0,0,0,0,0,0,0,0,0,0,0,0,0,0
Stien GORIS,Belgium,Outside Hitter,Women,Thailand,2022-06-04,Pool,3,5,0,0,0,0,0,0,0,0,0,0,0,0,0,0,0,0,0,0,0,0,0,0,0,0,0
Charlotte KRENICKY,Belgium,Setter,Women,Thailand,2022-06-04,Pool,3,5,1,1,0,0,1,0,0,0,0,0,0,0,0,0,0,0,0,0,0,0,0,0,1,1,2
Marlies JANSSENS,Belgium,Middle Blocker,Women,Thailand,2022-06-04,Pool,3,5,14,9,3,4,16,4,4,9,17,1,2,11,14,0,0,0,0,4,2,0,6,0,0,1,1
Jutta VAN DE VYVER,Belgium,Setter,Women,Thailand,2022-06-04,Pool,3,5,3,2,0,2,4,0,2,2,4,1,2,19,22,0,0,1,1,11,2,4,17,43,2,93,138
Britt RAMPELBERG,Belgium,Libero,Women,Thailand,2022-06-04,Pool,3,5,0,0,0,0,0,0,0,0,0,0,0,0,0,9,1,27,37,11,7,2,20,1,0,12,13
Silke VAN AVERMAET,Belgium,Middle Blocker,Women,Thailand,2022-06-04,Pool,3,5,16,11,3,8,22,2,1,6,9,3,1,15,19,0,0,0,0,6,1,4,11,1,0,2,3
Manon STRAGIER,Belgium,Outside Hitter,Women,Thailand,2022-06-04,Pool,3,5,1,0,1,1,2,0,1,2,3,1,1,4,6,0,0,2,2,5,2,1,8,0,0,1,1
Anna KOULBERG,Belgium,Middle Blocker,Women,Thailand,2022-06-04,Pool,3,5,0,0,0,0,0,0,0,0,0,0,0,0,0,0,0,0,0,0,0,0,0,0,0,0,0
Elise VAN SAS,Belgium,Setter,Women,Italy,2022-06-02,Pool,1,4,0,0,0,1,1,0,0,0,0,0,0,3,3,0,0,0,0,1,0,0,1,1,0,14,15
Britt HERBOTS,Belgium,Outside Hitter,Women,Italy,2022-06-02,Pool,1,4,26,24,6,25,55,2,4,1,7,0,4,10,14,2,1,23,26,7,4,1,12,0,0,1,1
Nathalie LEMMENS,Belgium,Middle Blocker,Women,Italy,2022-06-02,Pool,1,4,8,4,2,4,10,4,3,8,15,0,1,9,10,0,0,0,0,2,2,1,5,0,0,3,3
Celine VAN GESTEL,Belgium,Outside Hitter,Women,Italy,2022-06-02,Pool,1,4,9,8,7,17,32,1,2,1,4,0,1,14,15,10,2,20,32,6,5,1,12,0,0,0,0
Nel DEMEYER,Belgium,Libero,Women,Italy,2022-06-02,Pool,1,4,0,0,0,0,0,0,0,0,0,0,0,0,0,0,0,0,0,0,0,0,0,0,0,0,0
Pauline MARTIN,Belgium,Opposite Spiker,Women,Italy,2022-06-02,Pool,1,4,11,9,4,10,23,0,1,2,3,2,1,13,16,0,0,0,0,4,2,3,9,1,1,1,3
Stien GORIS,Belgium,Outside Hitter,Women,Italy,2022-06-02,Pool,1,4,0,0,0,0,0,0,0,0,0,0,0,0,0,0,0,0,0,0,0,0,0,0,0,0,0
Charlotte KRENICKY,Belgium,Setter,Women,Italy,2022-06-02,Pool,1,4,0,0,0,0,0,0,0,0,0,0,0,0,0,0,0,0,0,0,0,0,0,0,0,0,0
Marlies JANSSENS,Belgium,Middle Blocker,Women,Italy,2022-06-02,Pool,1,4,0,0,0,0,0,0,0,0,0,0,0,0,0,0,0,0,0,0,0,0,0,0,0,0,0
Jutta VAN DE VYVER,Belgium,Setter,Women,Italy,2022-06-02,Pool,1,4,1,0,0,1,1,0,3,2,5,1,2,11,14,0,0,0,0,8,0,1,9,7,1,95,103
Britt RAMPELBERG,Belgium,Libero,Women,Italy,2022-06-02,Pool,1,4,0,0,0,0,0,0,0,0,0,0,0,0,0,6,1,17,24,9,4,2,15,0,0,5,5
Silke VAN AVERMAET,Belgium,Middle Blocker,Women,Italy,2022-06-02,Pool,1,4,10,7,3,9,19,2,8,4,14,1,0,12,13,0,0,1,1,1,1,0,2,0,0,0,0
Manon STRAGIER,Belgium,Outside Hitter,Women,Italy,2022-06-02,Pool,1,4,0,0,0,0,0,0,0,0,0,0,1,1,2,0,1,0,1,0,0,0,0,0,0,1,1
Anna KOULBERG,Belgium,Middle Blocker,Women,Italy,2022-06-02,Pool,1,4,0,0,0,0,0,0,0,0,0,0,0,1,1,0,0,0,0,0,0,0,0,0,0,0,0
Elise VAN SAS,Belgium,Setter,Women,Serbia,2022-06-01,Pool,1,4,0,0,0,0,0,0,1,0,1,0,0,0,0,0,0,0,0,0,0,0,0,1,0,0,1
Britt HERBOTS,Belgium,Outside Hitter,Women,Serbia,2022-06-01,Pool,1,4,31,27,6,42,75,1,3,4,8,3,2,10,15,5,1,18,24,4,1,1,6,0,0,2,2
Nathalie LEMMENS,Belgium,Middle Blocker,Women,Serbia,2022-06-01,Pool,1,4,2,1,0,2,3,1,3,4,8,0,0,4,4,0,0,0,0,0,1,0,1,0,0,2,2
Celine VAN GESTEL,Belgium,Outside Hitter,Women,Serbia,2022-06-01,Pool,1,4,9,8,6,21,35,0,4,4,8,1,1,14,16,5,1,24,30,10,3,5,18,0,0,3,3
Nel DEMEYER,Belgium,Libero,Women,Serbia,2022-06-01,Pool,1,4,0,0,0,0,0,0,0,0,0,0,0,0,0,1,1,5,7,5,4,1,10,0,0,3,3
Pauline MARTIN,Belgium,Opposite Spiker,Women,Serbia,2022-06-01,Pool,1,4,0,0,0,0,0,0,0,0,0,0,0,0,0,0,0,0,0,0,0,0,0,0,0,0,0
Stien GORIS,Belgium,Outside Hitter,Women,Serbia,2022-06-01,Pool,1,4,0,0,0,0,0,0,0,0,0,0,0,0,0,0,0,0,0,0,0,0,0,0,0,0,0
Charlotte KRENICKY,Belgium,Setter,Women,Serbia,2022-06-01,Pool,1,4,1,1,0,0,1,0,0,0,0,0,0,0,0,0,0,0,0,0,0,0,0,2,0,2,4
Marlies JANSSENS,Belgium,Middle Blocker,Women,Serbia,2022-06-01,Pool,1,4,17,10,0,14,24,6,1,3,10,1,1,11,13,0,0,1,1,1,1,1,3,0,0,3,3
Jutta VAN DE VYVER,Belgium,Setter,Women,Serbia,2022-06-01,Pool,1,4,0,0,0,1,1,0,1,4,5,0,1,12,13,0,0,0,0,5,2,2,9,27,1,106,134
Britt RAMPELBERG,Belgium,Libero,Women,Serbia,2022-06-01,Pool,1,4,0,0,0,0,0,0,0,0,0,0,0,0,0,3,0,11,14,7,1,0,8,0,0,3,3
Silke VAN AVERMAET,Belgium,Middle Blocker,Women,Serbia,2022-06-01,Pool,1,4,3,3,1,14,18,0,5,4,9,0,1,8,9,0,0,0,0,3,0,0,3,0,0,0,0
Manon STRAGIER,Belgium,Outside Hitter,Women,Serbia,2022-06-01,Pool,1,4,5,4,1,6,11,1,1,2,4,0,2,9,11,3,0,5,8,0,1,0,1,0,0,0,0
Anna KOULBERG,Belgium,Middle Blocker,Women,Serbia,2022-06-01,Pool,1,4,0,0,0,0,0,0,0,0,0,0,0,0,0,0,0,0,0,0,0,0,0,0,0,0,0
Britt HERBOTS,Belgium,Outside Hitter,Women,Bulgaria,2022-06-19,Pool,3,5,26,23,11,50,84,3,4,5,12,0,3,21,24,7,1,27,35,12,3,1,16,0,0,2,2
Nathalie LEMMENS,Belgium,Middle Blocker,Women,Bulgaria,2022-06-19,Pool,3,5,8,5,3,4,12,3,1,7,11,0,1,8,9,0,0,0,0,1,0,0,1,0,0,6,6
Jodie GUILLIAMS,Belgium,Outside Hitter,Women,Bulgaria,2022-06-19,Pool,3,5,6,5,8,10,23,0,2,2,4,1,1,13,15,7,0,29,36,10,4,3,17,1,0,3,4
Celine VAN GESTEL,Belgium,Outside Hitter,Women,Bulgaria,2022-06-19,Pool,3,5,0,0,0,3,3,0,1,2,3,0,0,4,4,2,0,6,8,7,4,0,11,0,0,0,0
Nel DEMEYER,Belgium,Libero,Women,Bulgaria,2022-06-19,Pool,3,5,0,0,0,0,0,0,0,0,0,0,0,0,0,0,0,2,2,12,3,4,19,0,0,6,6
Pauline MARTIN,Belgium,Opposite Spiker,Women,Bulgaria,2022-06-19,Pool,3,5,5,4,3,2,9,0,0,2,2,1,0,4,5,0,0,0,0,5,1,0,6,0,0,2,2
Stien GORIS,Belgium,Outside Hitter,Women,Bulgaria,2022-06-19,Pool,3,5,0,0,0,0,0,0,0,0,0,0,0,0,0,0,0,0,0,0,0,0,0,0,0,0,0
Charlotte KRENICKY,Belgium,Setter,Women,Bulgaria,2022-06-19,Pool,3,5,3,1,0,1,2,1,1,6,8,1,2,6,9,0,0,0,0,6,2,2,10,10,1,47,58
Marlies JANSSENS,Belgium,Middle Blocker,Women,Bulgaria,2022-06-19,Pool,3,5,10,8,0,8,16,1,2,5,8,1,5,10,16,0,0,0,0,5,0,0,5,0,0,0,0
Jutta VAN DE VYVER,Belgium,Setter,Women,Bulgaria,2022-06-19,Pool,3,5,4,2,0,0,2,0,0,2,2,2,1,10,13,0,0,0,0,11,1,0,12,19,1,70,90
Britt RAMPELBERG,Belgium,Libero,Women,Bulgaria,2022-06-19,Pool,3,5,0,0,0,0,0,0,0,0,0,0,0,0,0,3,0,14,17,7,1,1,9,0,1,6,7
Silke VAN AVERMAET,Belgium,Middle Blocker,Women,Bulgaria,2022-06-19,Pool,3,5,13,9,3,14,26,3,8,8,19,1,1,6,8,0,0,0,0,9,1,2,12,0,0,1,1
Manon STRAGIER,Belgium,Outside Hitter,Women,Bulgaria,2022-06-19,Pool,3,5,1,0,0,1,1,0,0,0,0,1,1,2,4,0,0,0,0,2,0,0,2,0,0,0,0
Anna KOULBERG,Belgium,Middle Blocker,Women,Bulgaria,2022-06-19,Pool,3,5,0,0,0,0,0,0,0,0,0,0,0,0,0,0,0,0,0,0,0,0,0,0,0,0,0
Britt HERBOTS,Belgium,Outside Hitter,Women,Poland,2022-06-18,Pool,3,5,33,33,8,43,84,0,0,6,6,0,2,14,16,4,1,9,14,7,0,1,8,1,0,2,3
Nathalie LEMMENS,Belgium,Middle Blocker,Women,Poland,2022-06-18,Pool,3,5,8,6,0,5,11,2,4,4,10,0,1,15,16,0,0,1,1,3,1,0,4,0,0,2,2
Jodie GUILLIAMS,Belgium,Outside Hitter,Women,Poland,2022-06-18,Pool,3,5,3,3,5,4,12,0,4,0,4,0,1,12,13,4,2,17,23,15,4,0,19,0,0,3,3
Celine VAN GESTEL,Belgium,Outside Hitter,Women,Poland,2022-06-18,Pool,3,5,7,5,3,17,25,1,5,4,10,1,0,19,20,2,0,14,16,11,0,0,11,0,0,6,6
Nel DEMEYER,Belgium,Libero,Women,Poland,2022-06-18,Pool,3,5,0,0,0,0,0,0,0,0,0,0,0,0,0,0,0,0,0,13,3,0,16,0,1,4,5
Pauline MARTIN,Belgium,Opposite Spiker,Women,Poland,2022-06-18,Pool,3,5,0,0,0,0,0,0,0,0,0,0,0,0,0,0,0,0,0,0,0,0,0,0,0,0,0
Stien GORIS,Belgium,Outside Hitter,Women,Poland,2022-06-18,Pool,3,5,0,0,0,0,0,0,0,0,0,0,0,0,0,0,0,0,0,0,0,0,0,0,0,0,0
Charlotte KRENICKY,Belgium,Setter,Women,Poland,2022-06-18,Pool,3,5,1,1,0,0,1,0,4,3,7,0,0,9,9,0,0,0,0,9,2,1,12,13,0,66,79
Marlies JANSSENS,Belgium,Middle Blocker,Women,Poland,2022-06-18,Pool,3,5,12,6,4,7,17,5,6,7,18,1,2,10,13,0,0,0,0,7,3,0,10,1,0,0,1
Jutta VAN DE VYVER,Belgium,Setter,Women,Poland,2022-06-18,Pool,3,5,0,0,0,2,2,0,1,0,1,0,0,4,4,0,0,0,0,5,3,0,8,8,0,47,55
Britt RAMPELBERG,Belgium,Libero,Women,Poland,2022-06-18,Pool,3,5,0,0,0,0,0,0,0,0,0,0,0,0,0,5,3,29,37,13,3,1,17,0,0,11,11
Silke VAN AVERMAET,Belgium,Middle Blocker,Women,Poland,2022-06-18,Pool,3,5,5,4,0,3,7,0,3,5,8,1,1,2,4,0,0,0,0,1,0,0,1,0,0,0,0
Manon STRAGIER,Belgium,Outside Hitter,Women,Poland,2022-06-18,Pool,3,5,2,0,0,0,0,0,0,0,0,2,0,5,7,0,0,0,0,0,1,0,1,0,0,0,0
Anna KOULBERG,Belgium,Middle Blocker,Women,Poland,2022-06-18,Pool,3,5,0,0,0,0,0,0,0,0,0,0,0,0,0,0,0,0,0,0,0,0,0,0,0,0,0
Britt HERBOTS,Belgium,Outside Hitter,Women,Canada,2022-06-16,Pool,1,4,29,24,4,31,59,4,1,2,7,1,0,11,12,1,0,7,8,7,5,0,12,0,0,1,1
Nathalie LEMMENS,Belgium,Middle Blocker,Women,Canada,2022-06-16,Pool,1,4,2,1,1,4,6,0,3,5,8,1,0,18,19,0,0,0,0,3,0,0,3,0,0,2,2
Jodie GUILLIAMS,Belgium,Outside Hitter,Women,Canada,2022-06-16,Pool,1,4,7,5,2,10,17,1,3,4,8,1,1,9,11,4,1,13,18,6,3,0,9,0,0,1,1
Celine VAN GESTEL,Belgium,Outside Hitter,Women,Canada,2022-06-16,Pool,1,4,16,12,2,8,22,2,4,1,7,2,1,16,19,4,1,24,29,11,7,0,18,0,0,3,3
Pauline MARTIN,Belgium,Opposite Spiker,Women,Canada,2022-06-16,Pool,1,4,4,2,3,0,5,2,1,1,4,0,1,0,1,1,0,0,1,1,0,0,1,0,0,0,0
Stien GORIS,Belgium,Outside Hitter,Women,Canada,2022-06-16,Pool,1,4,0,0,0,0,0,0,0,0,0,0,0,0,0,0,0,0,0,0,0,0,0,0,0,0,0
Charlotte KRENICKY,Belgium,Setter,Women,Canada,2022-06-16,Pool,1,4,1,1,0,0,1,0,1,1,2,0,0,4,4,0,0,0,0,1,1,0,2,2,0,26,28
Marlies JANSSENS,Belgium,Middle Blocker,Women,Canada,2022-06-16,Pool,1,4,8,5,3,4,12,3,3,1,7,0,2,9,11,0,0,0,0,1,0,1,2,2,0,6,8
Jutta VAN DE VYVER,Belgium,Setter,Women,Canada,2022-06-16,Pool,1,4,1,0,0,1,1,1,0,0,1,0,2,12,14,0,0,0,0,9,3,3,15,4,2,57,63
Britt RAMPELBERG,Belgium,Libero,Women,Canada,2022-06-16,Pool,1,4,0,0,0,0,0,0,0,0,0,0,0,0,0,6,2,19,27,7,9,1,17,0,0,12,12
Anna KOULBERG,Belgium,Middle Blocker,Women,Canada,2022-06-16,Pool,1,4,0,0,0,0,0,0,0,1,1,0,0,0,0,0,0,0,0,0,0,0,0,0,0,0,0
Britt HERBOTS,Belgium,Outside Hitter,Women,China,2022-06-15,Pool,0,3,6,5,4,2,11,0,0,0,0,1,0,4,5,0,0,0,0,0,1,0,1,0,0,1,1
Nathalie LEMMENS,Belgium,Middle Blocker,Women,China,2022-06-15,Pool,0,3,0,0,0,0,0,0,0,0,0,0,0,0,0,0,0,0,0,0,0,0,0,0,0,0,0
Jodie GUILLIAMS,Belgium,Outside Hitter,Women,China,2022-06-15,Pool,0,3,7,7,3,9,19,0,1,2,3,0,1,11,12,5,1,10,16,4,3,1,8,0,0,2,2
Celine VAN GESTEL,Belgium,Outside Hitter,Women,China,2022-06-15,Pool,0,3,11,10,5,13,28,0,0,1,1,1,2,5,8,7,1,36,44,8,0,0,8,0,0,1,1
Pauline MARTIN,Belgium,Opposite Spiker,Women,China,2022-06-15,Pool,0,3,11,11,4,8,23,0,0,1,1,0,1,5,6,0,0,0,0,5,2,0,7,0,0,2,2
Stien GORIS,Belgium,Outside Hitter,Women,China,2022-06-15,Pool,0,3,4,4,1,5,10,0,3,4,7,0,1,6,7,0,0,0,0,3,4,0,7,0,0,1,1
Charlotte KRENICKY,Belgium,Setter,Women,China,2022-06-15,Pool,0,3,1,1,0,0,1,0,0,0,0,0,0,6,6,0,0,0,0,10,0,1,11,11,2,45,58
Marlies JANSSENS,Belgium,Middle Blocker,Women,China,2022-06-15,Pool,0,3,0,0,0,0,0,0,0,0,0,0,0,0,0,0,0,0,0,0,0,0,0,0,0,0,0
Jutta VAN DE VYVER,Belgium,Setter,Women,China,2022-06-15,Pool,0,3,0,0,0,0,0,0,2,0,2,0,0,3,3,0,0,0,0,0,2,1,3,6,1,21,28
Britt RAMPELBERG,Belgium,Libero,Women,China,2022-06-15,Pool,0,3,0,0,0,0,0,0,0,0,0,0,0,0,0,4,0,5,9,13,6,1,20,0,0,10,10
Anna KOULBERG,Belgium,Middle Blocker,Women,China,2022-06-15,Pool,0,3,6,6,2,3,11,0,1,2,3,0,1,8,9,0,0,1,1,1,2,0,3,0,0,0,0
Diana DUARTE ALECRIM,Brazil,Middle Blocker,Women,Serbia,2022-06-19,Pool,3,3,5,2,1,4,7,3,2,6,11,0,0,9,9,0,0,0,0,2,0,0,2,0,0,0,0
Julia GAMBATTO KUDIESS,Brazil,Middle Blocker,Women,Serbia,2022-06-19,Pool,3,3,0,0,0,0,0,0,0,0,0,0,0,0,0,0,0,0,0,0,0,0,0,0,0,0,0
Ana Carolina DA SILVA,Brazil,Middle Blocker,Women,Serbia,2022-06-19,Pool,3,3,13,6,0,2,8,6,4,5,15,1,1,11,13,0,0,0,0,1,2,2,5,0,0,2,2
Priscila ZALEWSKI DAROIT MOREIRA,Brazil,Outside Hitter,Women,Serbia,2022-06-19,Pool,3,3,14,9,3,14,26,5,3,7,15,0,0,7,7,13,0,13,26,8,1,1,10,0,0,0,0
Nyeme Victoria ALEXANDRE COSTA NUNES,Brazil,Libero,Women,Serbia,2022-06-19,Pool,3,3,0,0,0,0,0,0,0,0,0,0,0,0,0,10,0,4,14,15,1,1,17,0,0,7,7
Rosamaria MONTIBELLER,Brazil,Outside Hitter,Women,Serbia,2022-06-19,Pool,3,3,0,0,0,4,4,0,0,1,1,0,0,0,0,0,0,0,0,0,0,0,0,0,0,0,0
Macris Fernanda SILVA CARNEIRO,Brazil,Setter,Women,Serbia,2022-06-19,Pool,3,3,0,0,0,1,1,0,3,5,8,0,2,9,11,0,0,0,0,2,2,0,4,20,0,65,85
Roberta Silva RATZKE,Brazil,Setter,Women,Serbia,2022-06-19,Pool,3,3,0,0,0,0,0,0,0,0,0,0,0,2,2,0,0,0,0,0,0,0,0,2,0,4,6
Gabriela BRAGA GUIMARAES,Brazil,Outside Hitter,Women,Serbia,2022-06-19,Pool,3,3,14,14,7,14,35,0,0,3,3,0,1,23,24,4,0,2,6,7,1,1,9,0,0,1,1
Ana Cristina MENEZES OLIVEIRA DE SOUZA,Brazil,Outside Hitter,Women,Serbia,2022-06-19,Pool,3,3,0,0,0,0,0,0,0,0,0,0,0,0,0,0,0,0,0,0,0,0,0,0,0,0,0
Natália ARAUJO,Brazil,Libero,Women,Serbia,2022-06-19,Pool,3,3,0,0,0,0,0,0,0,0,0,0,0,0,0,0,0,0,0,0,0,0,0,0,0,0,0
Lorena Giovana VIEZEL,Brazil,Middle Blocker,Women,Serbia,2022-06-19,Pool,3,3,0,0,0,0,0,0,0,0,0,0,0,0,0,0,0,0,0,0,0,0,0,0,0,0,0
Kisy NASCIMENTO,Brazil,Opposite Spiker,Women,Serbia,2022-06-19,Pool,3,3,14,9,4,11,24,5,2,6,13,0,0,7,7,1,0,1,2,10,0,1,11,0,0,1,1
Julia Isabelle BERGMANN,Brazil,Outside Hitter,Women,Serbia,2022-06-19,Pool,3,3,0,0,0,0,0,0,0,0,0,0,0,0,0,0,0,0,0,0,0,0,0,0,0,0,0
Diana DUARTE ALECRIM,Brazil,Middle Blocker,Women,Italy,2022-06-18,Pool,1,4,5,1,2,3,6,2,3,0,5,2,2,10,14,1,0,0,1,2,0,0,2,0,0,0,0
Julia GAMBATTO KUDIESS,Brazil,Middle Blocker,Women,Italy,2022-06-18,Pool,1,4,0,0,0,0,0,0,0,0,0,0,0,0,0,0,0,0,0,0,0,0,0,0,0,0,0
Ana Carolina DA SILVA,Brazil,Middle Blocker,Women,Italy,2022-06-18,Pool,1,4,9,6,3,2,11,2,6,4,12,1,1,11,13,1,0,1,2,2,0,0,2,0,0,1,1
Priscila ZALEWSKI DAROIT MOREIRA,Brazil,Outside Hitter,Women,Italy,2022-06-18,Pool,1,4,4,2,3,2,7,0,0,0,0,2,0,2,4,1,0,2,3,1,0,0,1,0,0,0,0
Nyeme Victoria ALEXANDRE COSTA NUNES,Brazil,Libero,Women,Italy,2022-06-18,Pool,1,4,0,0,0,0,0,0,0,0,0,0,0,0,0,11,0,16,27,6,5,1,12,0,0,5,5
Rosamaria MONTIBELLER,Brazil,Outside Hitter,Women,Italy,2022-06-18,Pool,1,4,1,1,1,3,5,0,0,0,0,0,0,2,2,0,0,0,0,1,0,0,1,0,0,0,0
Macris Fernanda SILVA CARNEIRO,Brazil,Setter,Women,Italy,2022-06-18,Pool,1,4,1,0,1,0,1,1,2,1,4,0,1,6,7,0,0,1,1,1,2,0,3,26,1,54,81
Roberta Silva RATZKE,Brazil,Setter,Women,Italy,2022-06-18,Pool,1,4,0,0,0,0,0,0,0,0,0,0,0,1,1,0,0,0,0,1,1,0,2,5,0,9,14
Gabriela BRAGA GUIMARAES,Brazil,Outside Hitter,Women,Italy,2022-06-18,Pool,1,4,8,8,6,10,24,0,2,2,4,0,2,8,10,10,1,10,21,4,0,1,5,0,0,1,1
Ana Cristina MENEZES OLIVEIRA DE SOUZA,Brazil,Outside Hitter,Women,Italy,2022-06-18,Pool,1,4,2,2,2,0,4,0,0,0,0,0,0,1,1,0,0,0,0,0,0,1,1,0,1,1,2
Natália ARAUJO,Brazil,Libero,Women,Italy,2022-06-18,Pool,1,4,0,0,0,0,0,0,0,0,0,0,0,0,0,0,0,0,0,0,0,0,0,0,0,0,0
Lorena Giovana VIEZEL,Brazil,Middle Blocker,Women,Italy,2022-06-18,Pool,1,4,0,0,1,1,2,0,1,1,2,0,0,4,4,0,0,0,0,0,0,0,0,0,0,0,0
Kisy NASCIMENTO,Brazil,Opposite Spiker,Women,Italy,2022-06-18,Pool,1,4,12,12,4,6,22,0,3,0,3,0,2,5,7,0,0,0,0,3,0,0,3,0,0,0,0
Julia Isabelle BERGMANN,Brazil,Outside Hitter,Women,Italy,2022-06-18,Pool,1,4,8,8,3,4,15,0,1,1,2,0,3,6,9,9,0,12,21,2,0,2,4,0,0,0,0
Diana DUARTE ALECRIM,Brazil,Middle Blocker,Women,Netherlands,2022-06-17,Pool,3,3,5,2,2,2,6,3,1,5,9,0,0,7,7,0,0,0,0,1,0,0,1,0,0,2,2
Julia GAMBATTO KUDIESS,Brazil,Middle Blocker,Women,Netherlands,2022-06-17,Pool,3,3,0,0,0,0,0,0,1,2,3,0,1,0,1,0,0,0,0,0,0,0,0,0,0,1,1
Ana Carolina DA SILVA,Brazil,Middle Blocker,Women,Netherlands,2022-06-17,Pool,3,3,7,4,2,1,7,2,1,6,9,1,0,7,8,0,0,0,0,0,0,0,0,0,0,3,3
Priscila ZALEWSKI DAROIT MOREIRA,Brazil,Outside Hitter,Women,Netherlands,2022-06-17,Pool,3,3,13,12,3,10,25,1,0,1,2,0,1,12,13,9,0,10,19,4,4,3,11,0,0,1,1
Nyeme Victoria ALEXANDRE COSTA NUNES,Brazil,Libero,Women,Netherlands,2022-06-17,Pool,3,3,0,0,0,0,0,0,0,0,0,0,0,0,0,2,2,12,16,13,1,2,16,0,0,5,5
Rosamaria MONTIBELLER,Brazil,Outside Hitter,Women,Netherlands,2022-06-17,Pool,3,3,0,0,0,0,0,0,0,0,0,0,0,2,2,0,0,0,0,0,0,0,0,0,0,0,0
Macris Fernanda SILVA CARNEIRO,Brazil,Setter,Women,Netherlands,2022-06-17,Pool,3,3,0,0,0,1,1,0,2,1,3,0,0,14,14,0,0,0,0,3,2,1,6,17,0,47,64
Roberta Silva RATZKE,Brazil,Setter,Women,Netherlands,2022-06-17,Pool,3,3,0,0,0,0,0,0,0,0,0,0,0,0,0,0,0,0,0,2,0,0,2,4,0,10,14
Gabriela BRAGA GUIMARAES,Brazil,Outside Hitter,Women,Netherlands,2022-06-17,Pool,3,3,13,13,4,12,29,0,1,1,2,0,1,11,12,10,1,2,13,10,2,0,12,0,0,1,1
Ana Cristina MENEZES OLIVEIRA DE SOUZA,Brazil,Outside Hitter,Women,Netherlands,2022-06-17,Pool,3,3,1,1,1,2,4,0,0,0,0,0,0,2,2,0,0,0,0,0,0,0,0,0,0,0,0
Natália ARAUJO,Brazil,Libero,Women,Netherlands,2022-06-17,Pool,3,3,0,0,0,0,0,0,0,0,0,0,0,0,0,0,0,0,0,0,0,0,0,0,0,0,0
Lorena Giovana VIEZEL,Brazil,Middle Blocker,Women,Netherlands,2022-06-17,Pool,3,3,0,0,1,0,1,0,0,0,0,0,0,0,0,0,0,0,0,0,0,0,0,0,0,0,0
Kisy NASCIMENTO,Brazil,Opposite Spiker,Women,Netherlands,2022-06-17,Pool,3,3,13,8,2,9,19,4,1,0,5,1,4,9,14,0,0,0,0,5,0,0,5,0,0,0,0
Julia Isabelle BERGMANN,Brazil,Outside Hitter,Women,Netherlands,2022-06-17,Pool,3,3,0,0,0,0,0,0,0,0,0,0,0,0,0,0,0,0,0,0,0,0,0,0,0,0,0
Diana DUARTE ALECRIM,Brazil,Middle Blocker,Women,Türkiye,2022-06-16,Pool,3,4,9,4,0,5,9,2,0,0,2,3,1,13,17,0,0,0,0,1,1,1,3,0,0,3,3
Julia GAMBATTO KUDIESS,Brazil,Middle Blocker,Women,Türkiye,2022-06-16,Pool,3,4,0,0,0,0,0,0,0,0,0,0,0,0,0,0,0,0,0,0,0,0,0,0,0,0,0
Ana Carolina DA SILVA,Brazil,Middle Blocker,Women,Türkiye,2022-06-16,Pool,3,4,14,8,1,3,12,6,5,4,15,0,1,11,12,0,0,0,0,0,1,1,2,0,1,2,3
Priscila ZALEWSKI DAROIT MOREIRA,Brazil,Outside Hitter,Women,Türkiye,2022-06-16,Pool,3,4,8,6,2,5,13,1,0,0,1,1,1,3,5,4,1,16,21,1,0,1,2,0,0,0,0
Nyeme Victoria ALEXANDRE COSTA NUNES,Brazil,Libero,Women,Türkiye,2022-06-16,Pool,3,4,0,0,0,0,0,0,0,0,0,0,0,0,0,9,1,8,18,12,7,0,19,0,0,12,12
Rosamaria MONTIBELLER,Brazil,Outside Hitter,Women,Türkiye,2022-06-16,Pool,3,4,0,0,0,0,0,0,0,0,0,0,0,2,2,0,0,0,0,0,0,0,0,0,0,0,0
Macris Fernanda SILVA CARNEIRO,Brazil,Setter,Women,Türkiye,2022-06-16,Pool,3,4,1,0,0,1,1,1,2,1,4,0,1,20,21,0,0,0,0,4,1,1,6,35,0,64,99
Roberta Silva RATZKE,Brazil,Setter,Women,Türkiye,2022-06-16,Pool,3,4,0,0,0,0,0,0,0,0,0,0,0,1,1,0,0,0,0,2,1,0,3,6,0,7,13
Gabriela BRAGA GUIMARAES,Brazil,Outside Hitter,Women,Türkiye,2022-06-16,Pool,3,4,20,16,11,9,36,2,1,4,7,2,1,17,20,8,0,7,15,7,1,0,8,0,0,1,1
Ana Cristina MENEZES OLIVEIRA DE SOUZA,Brazil,Outside Hitter,Women,Türkiye,2022-06-16,Pool,3,4,1,1,2,9,12,0,0,2,2,0,1,2,3,0,0,0,0,0,0,0,0,0,0,0,0
Natália ARAUJO,Brazil,Libero,Women,Türkiye,2022-06-16,Pool,3,4,0,0,0,0,0,0,0,0,0,0,0,0,0,0,0,0,0,0,0,0,0,0,0,0,0
Lorena Giovana VIEZEL,Brazil,Middle Blocker,Women,Türkiye,2022-06-16,Pool,3,4,0,0,0,0,0,0,0,0,0,0,0,0,0,0,0,0,0,0,0,0,0,0,0,0,0
Kisy NASCIMENTO,Brazil,Opposite Spiker,Women,Türkiye,2022-06-16,Pool,3,4,18,13,4,15,32,5,2,4,11,0,0,6,6,0,0,0,0,4,2,0,6,0,1,1,2
Julia Isabelle BERGMANN,Brazil,Outside Hitter,Women,Türkiye,2022-06-16,Pool,3,4,8,8,4,7,19,0,1,1,2,0,2,4,6,14,1,19,34,4,1,0,5,0,0,1,1
Diana DUARTE ALECRIM,Brazil,Middle Blocker,Women,United States,2022-06-05,Pool,0,3,0,0,0,0,0,0,0,0,0,0,0,0,0,0,0,0,0,0,0,0,0,0,0,0,0
Ana Carolina DA SILVA,Brazil,Middle Blocker,Women,United States,2022-06-05,Pool,0,3,8,3,1,4,8,5,5,5,15,0,1,8,9,0,0,0,0,3,0,0,3,0,0,2,2
Priscila ZALEWSKI DAROIT MOREIRA,Brazil,Outside Hitter,Women,United States,2022-06-05,Pool,0,3,7,6,1,13,20,1,3,2,6,0,1,10,11,10,0,5,15,3,3,1,7,0,0,0,0
Nyeme Victoria ALEXANDRE COSTA NUNES,Brazil,Libero,Women,United States,2022-06-05,Pool,0,3,0,0,0,0,0,0,0,0,0,0,0,0,0,4,0,4,8,5,0,1,6,0,0,3,3
Macris Fernanda SILVA CARNEIRO,Brazil,Setter,Women,United States,2022-06-05,Pool,0,3,1,1,1,1,3,0,1,1,2,0,1,11,12,0,0,0,0,8,1,1,10,13,0,49,62
Roberta Silva RATZKE,Brazil,Setter,Women,United States,2022-06-05,Pool,0,3,1,0,0,0,0,0,0,0,0,1,0,3,4,0,0,0,0,0,0,0,0,2,0,9,11
Karina BARBOSA DE SOUZA,Brazil,Outside Hitter,Women,United States,2022-06-05,Pool,0,3,1,1,1,0,2,0,0,0,0,0,0,3,3,2,2,3,7,0,0,1,1,0,0,0,0
Ana Cristina MENEZES OLIVEIRA DE SOUZA,Brazil,Outside Hitter,Women,United States,2022-06-05,Pool,0,3,7,7,3,4,14,0,0,1,1,0,0,4,4,0,0,0,0,1,0,0,1,0,0,0,0
Natália ARAUJO,Brazil,Libero,Women,United States,2022-06-05,Pool,0,3,0,0,0,0,0,0,0,0,0,0,0,0,0,7,1,2,10,4,1,0,5,0,0,7,7
Lorena Giovana VIEZEL,Brazil,Middle Blocker,Women,United States,2022-06-05,Pool,0,3,3,1,1,3,5,1,3,4,8,1,0,4,5,0,0,0,0,0,1,0,1,0,0,0,0
Kisy NASCIMENTO,Brazil,Opposite Spiker,Women,United States,2022-06-05,Pool,0,3,5,5,5,10,20,0,2,0,2,0,0,3,3,0,0,0,0,4,1,0,5,0,0,1,1
Julia Isabelle BERGMANN,Brazil,Outside Hitter,Women,United States,2022-06-05,Pool,0,3,7,6,5,5,16,1,4,1,6,0,0,5,5,17,3,9,29,7,1,0,8,0,0,0,0
Mayany Cristina ARAUJO DE SOUZA,Brazil,Middle Blocker,Women,United States,2022-06-05,Pool,0,3,1,1,0,3,4,0,3,3,6,0,1,2,3,0,0,0,0,0,0,0,0,0,0,2,2
Lorenne GERALDO TEIXEIRA,Brazil,Opposite Spiker,Women,United States,2022-06-05,Pool,0,3,1,1,2,1,4,0,1,0,1,0,0,1,1,0,0,0,0,0,1,0,1,0,0,0,0
Diana DUARTE ALECRIM,Brazil,Middle Blocker,Women,Dominican Republic,2022-06-03,Pool,3,4,0,0,0,0,0,0,0,0,0,0,0,0,0,0,0,0,0,0,0,0,0,0,0,0,0
Ana Carolina DA SILVA,Brazil,Middle Blocker,Women,Dominican Republic,2022-06-03,Pool,3,4,11,5,3,7,15,6,7,8,21,0,1,11,12,0,0,0,0,3,0,0,3,0,0,1,1
Priscila ZALEWSKI DAROIT MOREIRA,Brazil,Outside Hitter,Women,Dominican Republic,2022-06-03,Pool,3,4,8,8,0,10,18,0,0,1,1,0,0,14,14,7,3,1,11,5,2,0,7,0,0,0,0
Nyeme Victoria ALEXANDRE COSTA NUNES,Brazil,Libero,Women,Dominican Republic,2022-06-03,Pool,3,4,0,0,0,0,0,0,0,0,0,0,0,0,0,17,1,1,19,21,5,1,27,0,0,7,7
Macris Fernanda SILVA CARNEIRO,Brazil,Setter,Women,Dominican Republic,2022-06-03,Pool,3,4,1,0,0,2,2,0,3,1,4,1,1,8,10,0,0,0,0,8,1,0,9,26,1,61,88
Roberta Silva RATZKE,Brazil,Setter,Women,Dominican Republic,2022-06-03,Pool,3,4,0,0,0,0,0,0,0,0,0,0,0,3,3,0,0,0,0,0,0,0,0,2,0,7,9
Karina BARBOSA DE SOUZA,Brazil,Outside Hitter,Women,Dominican Republic,2022-06-03,Pool,3,4,0,0,0,0,0,0,0,0,0,0,0,7,7,0,0,0,0,2,0,0,2,0,0,0,0
Ana Cristina MENEZES OLIVEIRA DE SOUZA,Brazil,Outside Hitter,Women,Dominican Republic,2022-06-03,Pool,3,4,4,3,4,2,9,0,0,0,0,1,0,6,7,3,1,2,6,2,1,0,3,0,0,0,0
Natália ARAUJO,Brazil,Libero,Women,Dominican Republic,2022-06-03,Pool,3,4,0,0,0,0,0,0,0,0,0,0,0,0,0,0,0,0,0,0,0,0,0,0,0,0,0
Lorena Giovana VIEZEL,Brazil,Middle Blocker,Women,Dominican Republic,2022-06-03,Pool,3,4,7,4,0,5,9,2,4,3,9,1,0,6,7,0,0,0,0,1,0,0,1,0,0,0,0
Kisy NASCIMENTO,Brazil,Opposite Spiker,Women,Dominican Republic,2022-06-03,Pool,3,4,20,18,5,12,35,1,1,2,4,1,1,11,13,0,0,0,0,9,2,0,11,0,0,4,4
Julia Isabelle BERGMANN,Brazil,Outside Hitter,Women,Dominican Republic,2022-06-03,Pool,3,4,13,10,4,15,29,1,3,0,4,2,1,13,16,18,0,5,23,14,4,0,18,0,0,1,1
Mayany Cristina ARAUJO DE SOUZA,Brazil,Middle Blocker,Women,Dominican Republic,2022-06-03,Pool,3,4,0,0,0,0,0,0,0,0,0,0,0,0,0,0,0,0,0,0,0,0,0,0,0,0,0
Lorenne GERALDO TEIXEIRA,Brazil,Opposite Spiker,Women,Dominican Republic,2022-06-03,Pool,3,4,0,0,0,3,3,0,0,0,0,0,0,1,1,0,0,0,0,0,0,1,1,0,0,0,0
Diana DUARTE ALECRIM,Brazil,Middle Blocker,Women,Poland,2022-06-02,Pool,3,3,8,6,1,2,9,2,2,2,6,0,1,8,9,0,0,0,0,4,0,0,4,0,0,1,1
Ana Carolina DA SILVA,Brazil,Middle Blocker,Women,Poland,2022-06-02,Pool,3,3,15,5,1,2,8,7,8,4,19,3,2,7,12,0,0,0,0,2,1,0,3,0,0,2,2
Priscila ZALEWSKI DAROIT MOREIRA,Brazil,Outside Hitter,Women,Poland,2022-06-02,Pool,3,3,5,5,4,10,19,0,1,3,4,0,0,12,12,11,1,16,28,7,2,0,9,0,0,0,0
Nyeme Victoria ALEXANDRE COSTA NUNES,Brazil,Libero,Women,Poland,2022-06-02,Pool,3,3,0,0,0,0,0,0,0,0,0,0,0,0,0,12,0,5,17,9,4,0,13,0,0,10,10
Macris Fernanda SILVA CARNEIRO,Brazil,Setter,Women,Poland,2022-06-02,Pool,3,3,1,0,1,0,1,0,1,0,1,1,1,13,15,0,0,0,0,7,1,0,8,12,0,52,64
Roberta Silva RATZKE,Brazil,Setter,Women,Poland,2022-06-02,Pool,3,3,0,0,0,0,0,0,0,0,0,0,0,0,0,0,0,0,0,0,0,0,0,0,0,3,3
Karina BARBOSA DE SOUZA,Brazil,Outside Hitter,Women,Poland,2022-06-02,Pool,3,3,2,1,0,0,1,0,0,0,0,1,0,9,10,0,0,0,0,1,0,0,1,0,0,2,2
Ana Cristina MENEZES OLIVEIRA DE SOUZA,Brazil,Outside Hitter,Women,Poland,2022-06-02,Pool,3,3,0,0,0,0,0,0,0,0,0,0,0,0,0,0,0,0,0,0,0,0,0,0,0,0,0
Natália ARAUJO,Brazil,Libero,Women,Poland,2022-06-02,Pool,3,3,0,0,0,0,0,0,0,0,0,0,0,0,0,0,0,0,0,0,0,0,0,0,0,0,0
Lorena Giovana VIEZEL,Brazil,Middle Blocker,Women,Poland,2022-06-02,Pool,3,3,0,0,0,0,0,0,0,0,0,0,0,0,0,0,0,0,0,0,0,0,0,0,0,0,0
Kisy NASCIMENTO,Brazil,Opposite Spiker,Women,Poland,2022-06-02,Pool,3,3,1,1,1,0,2,0,0,0,0,0,0,0,0,0,0,0,0,0,0,0,0,0,0,0,0
Julia Isabelle BERGMANN,Brazil,Outside Hitter,Women,Poland,2022-06-02,Pool,3,3,8,8,1,13,22,0,1,2,3,0,0,8,8,5,1,4,10,3,0,2,5,0,0,2,2
Mayany Cristina ARAUJO DE SOUZA,Brazil,Middle Blocker,Women,Poland,2022-06-02,Pool,3,3,0,0,0,0,0,0,0,0,0,0,0,0,0,0,0,0,0,0,0,0,0,0,0,0,0
Lorenne GERALDO TEIXEIRA,Brazil,Opposite Spiker,Women,Poland,2022-06-02,Pool,3,3,9,6,1,17,24,3,0,1,4,0,1,7,8,0,0,0,0,5,3,0,8,0,0,0,0
Diana DUARTE ALECRIM,Brazil,Middle Blocker,Women,Germany,2022-05-31,Pool,3,4,11,7,1,2,10,4,4,5,13,0,0,8,8,0,0,0,0,7,1,0,8,0,0,2,2
Ana Carolina DA SILVA,Brazil,Middle Blocker,Women,Germany,2022-05-31,Pool,3,4,16,9,3,4,16,6,3,6,15,1,1,21,23,0,0,0,0,5,0,1,6,0,0,4,4
Priscila ZALEWSKI DAROIT MOREIRA,Brazil,Outside Hitter,Women,Germany,2022-05-31,Pool,3,4,13,11,3,16,30,1,4,3,8,1,2,20,23,6,1,3,10,9,5,0,14,0,0,2,2
Nyeme Victoria ALEXANDRE COSTA NUNES,Brazil,Libero,Women,Germany,2022-05-31,Pool,3,4,0,0,0,0,0,0,0,0,0,0,0,0,0,10,2,5,17,25,4,2,31,0,0,18,18
Macris Fernanda SILVA CARNEIRO,Brazil,Setter,Women,Germany,2022-05-31,Pool,3,4,1,1,0,0,1,0,0,0,0,0,1,13,14,0,0,1,1,17,1,0,18,23,0,95,118
Roberta Silva RATZKE,Brazil,Setter,Women,Germany,2022-05-31,Pool,3,4,0,0,0,1,1,0,0,0,0,0,0,1,1,0,0,0,0,0,0,0,0,1,0,9,10
Karina BARBOSA DE SOUZA,Brazil,Outside Hitter,Women,Germany,2022-05-31,Pool,3,4,0,0,0,0,0,0,0,0,0,0,0,4,4,0,0,0,0,0,1,0,1,0,0,0,0
Ana Cristina MENEZES OLIVEIRA DE SOUZA,Brazil,Outside Hitter,Women,Germany,2022-05-31,Pool,3,4,2,2,0,2,4,0,0,0,0,0,1,0,1,0,0,0,0,0,0,0,0,0,0,0,0
Natália ARAUJO,Brazil,Libero,Women,Germany,2022-05-31,Pool,3,4,0,0,0,0,0,0,0,0,0,0,0,0,0,0,0,0,0,0,0,0,0,0,0,0,0
Lorena Giovana VIEZEL,Brazil,Middle Blocker,Women,Germany,2022-05-31,Pool,3,4,0,0,0,0,0,0,0,0,0,0,0,0,0,0,0,0,0,0,0,0,0,0,0,0,0
Kisy NASCIMENTO,Brazil,Opposite Spiker,Women,Germany,2022-05-31,Pool,3,4,10,9,1,13,23,1,0,0,1,0,1,4,5,0,0,0,0,4,0,0,4,0,0,2,2
Julia Isabelle BERGMANN,Brazil,Outside Hitter,Women,Germany,2022-05-31,Pool,3,4,19,18,8,22,48,1,4,2,7,0,1,11,12,37,2,21,60,10,3,0,13,0,0,0,0
Mayany Cristina ARAUJO DE SOUZA,Brazil,Middle Blocker,Women,Germany,2022-05-31,Pool,3,4,0,0,0,0,0,0,0,0,0,0,0,0,0,0,0,0,0,0,0,0,0,0,0,0,0
Lorenne GERALDO TEIXEIRA,Brazil,Opposite Spiker,Women,Germany,2022-05-31,Pool,3,4,8,7,4,15,26,0,1,0,1,1,0,10,11,0,0,0,0,2,3,0,5,0,0,1,1
Julia GAMBATTO KUDIESS,Brazil,Middle Blocker,Women,Italy,2022-07-17,Finals (Gold),0,3,1,1,0,4,5,0,2,3,5,0,0,6,6,0,0,0,0,0,0,0,0,0,0,1,1
Ana Carolina DA SILVA,Brazil,Middle Blocker,Women,Italy,2022-07-17,Finals (Gold),0,3,8,6,0,2,8,1,6,4,11,1,1,10,12,0,0,0,0,0,1,1,2,0,0,1,1
Priscila ZALEWSKI DAROIT MOREIRA,Brazil,Outside Hitter,Women,Italy,2022-07-17,Finals (Gold),0,3,1,1,1,1,3,0,0,0,0,0,0,5,5,4,1,7,12,1,1,1,3,0,0,0,0
Nyeme Victoria ALEXANDRE COSTA NUNES,Brazil,Libero,Women,Italy,2022-07-17,Finals (Gold),0,3,0,0,0,0,0,0,0,0,0,0,0,0,0,13,1,18,32,10,3,6,19,0,0,2,2
Rosamaria MONTIBELLER,Brazil,Outside Hitter,Women,Italy,2022-07-17,Finals (Gold),0,3,0,0,0,0,0,0,0,0,0,0,0,2,2,0,0,0,0,0,1,0,1,0,0,0,0
Macris Fernanda SILVA CARNEIRO,Brazil,Setter,Women,Italy,2022-07-17,Finals (Gold),0,3,2,1,0,0,1,1,0,1,2,0,0,7,7,0,0,0,0,1,2,1,4,13,0,55,68
Roberta Silva RATZKE,Brazil,Setter,Women,Italy,2022-07-17,Finals (Gold),0,3,0,0,0,0,0,0,0,0,0,0,1,4,5,0,0,0,0,2,0,0,2,2,0,19,21
Gabriela BRAGA GUIMARAES,Brazil,Outside Hitter,Women,Italy,2022-07-17,Finals (Gold),0,3,11,9,7,10,26,1,0,2,3,1,0,11,12,3,0,3,6,9,2,1,12,0,0,2,2
Ana Cristina MENEZES OLIVEIRA DE SOUZA,Brazil,Outside Hitter,Women,Italy,2022-07-17,Finals (Gold),0,3,6,6,1,4,11,0,1,1,2,0,0,1,1,0,0,0,0,1,0,0,1,0,0,1,1
Natália ARAUJO,Brazil,Libero,Women,Italy,2022-07-17,Finals (Gold),0,3,0,0,0,0,0,0,0,0,0,0,0,0,0,0,0,0,0,1,0,0,1,0,0,0,0
Lorena Giovana VIEZEL,Brazil,Middle Blocker,Women,Italy,2022-07-17,Finals (Gold),0,3,1,1,0,0,1,0,0,0,0,0,0,2,2,0,0,1,1,0,0,0,0,0,0,0,0
Kisy NASCIMENTO,Brazil,Opposite Spiker,Women,Italy,2022-07-17,Finals (Gold),0,3,14,12,4,11,27,1,6,1,8,1,0,7,8,0,0,0,0,2,5,0,7,0,0,0,0
Julia Isabelle BERGMANN,Brazil,Outside Hitter,Women,Italy,2022-07-17,Finals (Gold),0,3,3,3,4,6,13,0,1,1,2,0,1,7,8,8,0,5,13,5,3,0,8,0,0,0,0
Lorenne GERALDO TEIXEIRA,Brazil,Opposite Spiker,Women,Italy,2022-07-17,Finals (Gold),0,3,1,1,1,3,5,0,1,1,2,0,0,0,0,0,0,0,0,0,0,0,0,0,0,0,0
Julia GAMBATTO KUDIESS,Brazil,Middle Blocker,Women,Serbia,2022-07-16,Semifinals,3,4,6,3,1,2,6,3,3,2,8,0,1,6,7,1,0,1,2,1,0,0,1,0,0,2,2
Ana Carolina DA SILVA,Brazil,Middle Blocker,Women,Serbia,2022-07-16,Semifinals,3,4,13,7,2,2,11,6,10,10,26,0,1,17,18,0,0,0,0,2,1,1,4,0,0,3,3
Priscila ZALEWSKI DAROIT MOREIRA,Brazil,Outside Hitter,Women,Serbia,2022-07-16,Semifinals,3,4,0,0,0,0,0,0,0,0,0,0,0,0,0,0,0,0,0,0,0,0,0,0,0,0,0
Nyeme Victoria ALEXANDRE COSTA NUNES,Brazil,Libero,Women,Serbia,2022-07-16,Semifinals,3,4,0,0,0,0,0,0,0,0,0,0,0,0,0,4,1,6,11,5,1,4,10,0,0,6,6
Rosamaria MONTIBELLER,Brazil,Outside Hitter,Women,Serbia,2022-07-16,Semifinals,3,4,0,0,0,0,0,0,0,0,0,0,2,0,2,0,0,0,0,0,0,0,0,0,0,0,0
Macris Fernanda SILVA CARNEIRO,Brazil,Setter,Women,Serbia,2022-07-16,Semifinals,3,4,1,1,0,2,3,0,4,3,7,0,0,12,12,0,0,0,0,7,4,4,15,24,0,69,93
Roberta Silva RATZKE,Brazil,Setter,Women,Serbia,2022-07-16,Semifinals,3,4,0,0,0,0,0,0,0,0,0,0,0,5,5,0,0,0,0,1,1,0,2,3,0,10,13
Gabriela BRAGA GUIMARAES,Brazil,Outside Hitter,Women,Serbia,2022-07-16,Semifinals,3,4,15,15,5,10,30,0,1,6,7,0,0,17,17,4,0,8,12,7,6,3,16,0,0,3,3
Ana Cristina MENEZES OLIVEIRA DE SOUZA,Brazil,Outside Hitter,Women,Serbia,2022-07-16,Semifinals,3,4,0,0,0,0,0,0,0,0,0,0,0,0,0,0,0,0,0,0,0,0,0,0,0,0,0
Natália ARAUJO,Brazil,Libero,Women,Serbia,2022-07-16,Semifinals,3,4,0,0,0,0,0,0,0,0,0,0,0,0,0,3,2,6,11,4,7,2,13,0,0,7,7
Lorena Giovana VIEZEL,Brazil,Middle Blocker,Women,Serbia,2022-07-16,Semifinals,3,4,0,0,0,0,0,0,0,0,0,0,0,0,0,0,0,0,0,0,0,0,0,0,0,0,0
Kisy NASCIMENTO,Brazil,Opposite Spiker,Women,Serbia,2022-07-16,Semifinals,3,4,19,17,5,16,38,1,0,2,3,1,0,11,12,0,0,0,0,9,1,2,12,0,0,1,1
Julia Isabelle BERGMANN,Brazil,Outside Hitter,Women,Serbia,2022-07-16,Semifinals,3,4,16,15,6,15,36,0,4,1,5,1,1,13,15,18,2,25,45,7,4,1,12,0,0,2,2
Lorenne GERALDO TEIXEIRA,Brazil,Opposite Spiker,Women,Serbia,2022-07-16,Semifinals,3,4,1,1,3,2,6,0,1,0,1,0,0,1,1,0,0,0,0,1,1,0,2,0,0,0,0
Julia GAMBATTO KUDIESS,Brazil,Middle Blocker,Women,Japan,2022-07-13,Quarterfinals,3,4,5,1,1,4,6,3,3,5,11,1,2,11,14,0,0,0,0,2,0,2,4,0,0,1,1
Ana Carolina DA SILVA,Brazil,Middle Blocker,Women,Japan,2022-07-13,Quarterfinals,3,4,10,6,1,9,16,4,6,13,23,0,1,13,14,0,0,0,0,3,0,2,5,0,0,4,4
Priscila ZALEWSKI DAROIT MOREIRA,Brazil,Outside Hitter,Women,Japan,2022-07-13,Quarterfinals,3,4,0,0,0,0,0,0,0,0,0,0,0,0,0,0,0,0,0,0,0,0,0,0,0,0,0
Nyeme Victoria ALEXANDRE COSTA NUNES,Brazil,Libero,Women,Japan,2022-07-13,Quarterfinals,3,4,0,0,0,0,0,0,0,0,0,0,0,0,0,0,0,0,0,0,0,0,0,0,0,0,0
Rosamaria MONTIBELLER,Brazil,Outside Hitter,Women,Japan,2022-07-13,Quarterfinals,3,4,1,0,0,0,0,0,0,0,0,1,0,10,11,0,0,0,0,1,0,0,1,0,0,1,1
Macris Fernanda SILVA CARNEIRO,Brazil,Setter,Women,Japan,2022-07-13,Quarterfinals,3,4,4,2,0,1,3,2,4,5,11,0,0,13,13,0,0,0,0,8,3,1,12,31,3,68,102
Roberta Silva RATZKE,Brazil,Setter,Women,Japan,2022-07-13,Quarterfinals,3,4,0,0,0,1,1,0,0,0,0,0,0,5,5,0,0,0,0,0,1,0,1,5,0,9,14
Gabriela BRAGA GUIMARAES,Brazil,Outside Hitter,Women,Japan,2022-07-13,Quarterfinals,3,4,23,22,5,20,47,1,2,3,6,0,1,18,19,11,1,23,35,12,2,2,16,0,0,4,4
Ana Cristina MENEZES OLIVEIRA DE SOUZA,Brazil,Outside Hitter,Women,Japan,2022-07-13,Quarterfinals,3,4,0,0,0,0,0,0,0,0,0,0,0,0,0,0,0,0,0,0,0,0,0,0,0,0,0
Natália ARAUJO,Brazil,Libero,Women,Japan,2022-07-13,Quarterfinals,3,4,0,0,0,0,0,0,0,0,0,0,0,0,0,4,1,12,17,17,7,3,27,0,0,8,8
Lorena Giovana VIEZEL,Brazil,Middle Blocker,Women,Japan,2022-07-13,Quarterfinals,3,4,0,0,0,0,0,0,0,0,0,0,0,0,0,0,0,0,0,0,0,0,0,0,0,0,0
Kisy NASCIMENTO,Brazil,Opposite Spiker,Women,Japan,2022-07-13,Quarterfinals,3,4,20,16,4,16,36,4,3,1,8,0,3,5,8,0,0,1,1,4,4,2,10,0,0,1,1
Julia Isabelle BERGMANN,Brazil,Outside Hitter,Women,Japan,2022-07-13,Quarterfinals,3,4,17,14,4,12,30,2,1,1,4,1,2,13,16,5,3,22,30,12,3,1,16,0,0,0,0
Lorenne GERALDO TEIXEIRA,Brazil,Opposite Spiker,Women,Japan,2022-07-13,Quarterfinals,3,4,3,3,0,4,7,0,2,0,2,0,0,1,1,0,0,0,0,0,0,0,0,0,1,0,1
Julia GAMBATTO KUDIESS,Brazil,Middle Blocker,Women,Thailand,2022-07-02,Pool,3,4,12,10,1,6,17,2,4,2,8,0,0,12,12,0,0,0,0,3,2,1,6,0,0,0,0
Ana Carolina DA SILVA,Brazil,Middle Blocker,Women,Thailand,2022-07-02,Pool,3,4,16,12,2,5,19,4,8,2,14,0,1,15,16,0,0,0,0,1,0,0,1,0,0,0,0
Priscila ZALEWSKI DAROIT MOREIRA,Brazil,Outside Hitter,Women,Thailand,2022-07-02,Pool,3,4,0,0,0,0,0,0,0,0,0,0,0,0,0,0,0,0,0,0,0,0,0,0,0,0,0
Nyeme Victoria ALEXANDRE COSTA NUNES,Brazil,Libero,Women,Thailand,2022-07-02,Pool,3,4,0,0,0,0,0,0,0,0,0,0,0,0,0,0,0,0,0,0,0,0,0,0,0,0,0
Rosamaria MONTIBELLER,Brazil,Outside Hitter,Women,Thailand,2022-07-02,Pool,3,4,0,0,0,0,0,0,0,0,0,0,0,1,1,0,0,0,0,0,0,0,0,0,0,0,0
Macris Fernanda SILVA CARNEIRO,Brazil,Setter,Women,Thailand,2022-07-02,Pool,3,4,0,0,0,0,0,0,0,1,1,0,0,8,8,0,0,0,0,2,0,0,2,5,2,73,80
Roberta Silva RATZKE,Brazil,Setter,Women,Thailand,2022-07-02,Pool,3,4,0,0,0,0,0,0,1,3,4,0,1,7,8,0,0,0,0,2,0,1,3,5,0,45,50
Gabriela BRAGA GUIMARAES,Brazil,Outside Hitter,Women,Thailand,2022-07-02,Pool,3,4,14,14,4,16,34,0,7,1,8,0,1,21,22,13,0,23,36,8,6,4,18,0,0,1,1
Natália ARAUJO,Brazil,Libero,Women,Thailand,2022-07-02,Pool,3,4,0,0,0,0,0,0,0,0,0,0,0,0,0,7,3,9,19,13,3,1,17,0,0,4,4
Lorena Giovana VIEZEL,Brazil,Middle Blocker,Women,Thailand,2022-07-02,Pool,3,4,0,0,0,0,0,0,0,0,0,0,0,0,0,0,0,0,0,0,0,0,0,0,0,0,0
Kisy NASCIMENTO,Brazil,Opposite Spiker,Women,Thailand,2022-07-02,Pool,3,4,11,9,4,14,27,2,5,1,8,0,1,12,13,0,0,0,0,9,1,0,10,0,0,0,0
Julia Isabelle BERGMANN,Brazil,Outside Hitter,Women,Thailand,2022-07-02,Pool,3,4,17,15,6,19,40,1,1,1,3,1,0,17,18,4,1,20,25,11,2,2,15,0,0,0,0
Mayany Cristina ARAUJO DE SOUZA,Brazil,Middle Blocker,Women,Thailand,2022-07-02,Pool,3,4,0,0,0,0,0,0,0,0,0,0,0,0,0,0,0,0,0,0,0,0,0,0,0,0,0
Lorrayna DA SILVA,Brazil,Opposite Spiker,Women,Thailand,2022-07-02,Pool,3,4,0,0,0,0,0,0,0,0,0,0,0,0,0,0,0,0,0,0,0,0,0,0,0,0,0
Julia GAMBATTO KUDIESS,Brazil,Middle Blocker,Women,Bulgaria,2022-07-01,Pool,3,3,11,8,1,0,9,3,2,1,6,0,1,9,10,0,0,0,0,3,0,0,3,0,0,2,2
Ana Carolina DA SILVA,Brazil,Middle Blocker,Women,Bulgaria,2022-07-01,Pool,3,3,8,5,0,4,9,2,4,4,10,1,1,16,18,0,0,0,0,1,0,1,2,0,0,2,2
Priscila ZALEWSKI DAROIT MOREIRA,Brazil,Outside Hitter,Women,Bulgaria,2022-07-01,Pool,3,3,7,5,5,7,17,2,3,2,7,0,3,3,6,4,1,21,26,7,2,0,9,0,0,1,1
Nyeme Victoria ALEXANDRE COSTA NUNES,Brazil,Libero,Women,Bulgaria,2022-07-01,Pool,3,3,0,0,0,0,0,0,0,0,0,0,0,0,0,0,0,0,0,0,0,1,1,0,0,0,0
Rosamaria MONTIBELLER,Brazil,Outside Hitter,Women,Bulgaria,2022-07-01,Pool,3,3,0,0,0,0,0,0,0,0,0,0,0,0,0,0,0,0,0,0,0,0,0,0,0,0,0
Macris Fernanda SILVA CARNEIRO,Brazil,Setter,Women,Bulgaria,2022-07-01,Pool,3,3,4,2,0,0,2,2,3,2,7,0,1,11,12,0,1,0,1,4,0,1,5,4,0,65,69
Roberta Silva RATZKE,Brazil,Setter,Women,Bulgaria,2022-07-01,Pool,3,3,0,0,0,0,0,0,0,0,0,0,0,3,3,0,0,0,0,1,0,0,1,1,0,4,5
Gabriela BRAGA GUIMARAES,Brazil,Outside Hitter,Women,Bulgaria,2022-07-01,Pool,3,3,12,12,4,11,27,0,2,1,3,0,1,8,9,3,2,12,17,6,1,0,7,0,0,0,0
Natália ARAUJO,Brazil,Libero,Women,Bulgaria,2022-07-01,Pool,3,3,0,0,0,0,0,0,0,0,0,0,0,0,0,1,0,6,7,8,1,0,9,0,0,3,3
Lorena Giovana VIEZEL,Brazil,Middle Blocker,Women,Bulgaria,2022-07-01,Pool,3,3,0,0,0,0,0,0,0,0,0,0,0,0,0,0,0,0,0,0,0,0,0,0,0,0,0
Kisy NASCIMENTO,Brazil,Opposite Spiker,Women,Bulgaria,2022-07-01,Pool,3,3,8,5,3,9,17,2,2,4,8,1,1,7,9,0,0,0,0,3,2,1,6,1,0,1,2
Julia Isabelle BERGMANN,Brazil,Outside Hitter,Women,Bulgaria,2022-07-01,Pool,3,3,4,3,1,1,5,0,0,0,0,1,1,3,5,0,0,3,3,1,0,0,1,0,0,0,0
Mayany Cristina ARAUJO DE SOUZA,Brazil,Middle Blocker,Women,Bulgaria,2022-07-01,Pool,3,3,0,0,0,0,0,0,0,0,0,0,0,0,0,0,0,0,0,0,0,0,0,0,0,0,0
Lorrayna DA SILVA,Brazil,Opposite Spiker,Women,Bulgaria,2022-07-01,Pool,3,3,0,0,0,1,1,0,0,0,0,0,1,0,1,0,0,0,0,0,0,0,0,0,0,0,0
Julia GAMBATTO KUDIESS,Brazil,Middle Blocker,Women,Korea,2022-06-30,Pool,3,3,10,7,0,3,10,2,4,4,10,1,0,8,9,0,0,0,0,5,0,0,5,2,0,0,2
Ana Carolina DA SILVA,Brazil,Middle Blocker,Women,Korea,2022-06-30,Pool,3,3,6,1,0,3,4,2,1,0,3,3,0,12,15,0,0,0,0,0,0,0,0,1,0,0,1
Priscila ZALEWSKI DAROIT MOREIRA,Brazil,Outside Hitter,Women,Korea,2022-06-30,Pool,3,3,8,7,1,4,12,1,1,2,4,0,0,3,3,2,1,3,6,3,1,0,4,1,0,0,1
Nyeme Victoria ALEXANDRE COSTA NUNES,Brazil,Libero,Women,Korea,2022-06-30,Pool,3,3,0,0,0,0,0,0,0,0,0,0,0,0,0,1,0,3,4,1,0,0,1,1,0,0,1
Rosamaria MONTIBELLER,Brazil,Outside Hitter,Women,Korea,2022-06-30,Pool,3,3,2,2,0,3,5,0,0,0,0,0,0,6,6,1,0,3,4,2,1,1,4,0,0,0,0
Macris Fernanda SILVA CARNEIRO,Brazil,Setter,Women,Korea,2022-06-30,Pool,3,3,1,0,1,0,1,1,0,0,1,0,0,4,4,0,0,0,0,2,0,1,3,31,0,0,31
Roberta Silva RATZKE,Brazil,Setter,Women,Korea,2022-06-30,Pool,3,3,0,0,0,0,0,0,0,2,2,0,0,6,6,0,0,0,0,0,1,0,1,35,1,0,36
Gabriela BRAGA GUIMARAES,Brazil,Outside Hitter,Women,Korea,2022-06-30,Pool,3,3,0,0,1,1,2,0,4,3,7,0,0,3,3,3,0,4,7,3,1,2,6,2,0,0,2
Natália ARAUJO,Brazil,Libero,Women,Korea,2022-06-30,Pool,3,3,0,0,0,0,0,0,0,0,0,0,0,0,0,1,1,6,8,7,3,0,10,3,1,0,4
Lorena Giovana VIEZEL,Brazil,Middle Blocker,Women,Korea,2022-06-30,Pool,3,3,4,3,0,2,5,1,1,1,3,0,1,2,3,0,0,0,0,1,1,0,2,0,0,0,0
Kisy NASCIMENTO,Brazil,Opposite Spiker,Women,Korea,2022-06-30,Pool,3,3,0,0,0,0,0,0,0,0,0,0,0,0,0,0,0,0,0,0,0,0,0,0,0,0,0
Julia Isabelle BERGMANN,Brazil,Outside Hitter,Women,Korea,2022-06-30,Pool,3,3,16,11,3,8,22,5,1,0,6,0,0,7,7,1,1,12,14,1,0,1,2,0,0,0,0
Mayany Cristina ARAUJO DE SOUZA,Brazil,Middle Blocker,Women,Korea,2022-06-30,Pool,3,3,3,1,1,1,3,2,3,0,5,0,0,1,1,0,0,0,0,0,0,0,0,0,0,0,0
Lorrayna DA SILVA,Brazil,Opposite Spiker,Women,Korea,2022-06-30,Pool,3,3,7,7,5,11,23,0,1,2,3,0,2,14,16,0,0,0,0,10,2,3,15,0,0,0,0
Julia GAMBATTO KUDIESS,Brazil,Middle Blocker,Women,China,2022-06-28,Pool,3,5,6,5,2,3,10,1,6,5,12,0,1,7,8,0,0,0,0,3,0,1,4,1,0,1,2
Ana Carolina DA SILVA,Brazil,Middle Blocker,Women,China,2022-06-28,Pool,3,5,14,9,3,3,15,4,4,2,10,1,2,13,16,0,0,0,0,0,0,3,3,0,1,1,2
Priscila ZALEWSKI DAROIT MOREIRA,Brazil,Outside Hitter,Women,China,2022-06-28,Pool,3,5,9,8,6,5,19,1,1,1,3,0,0,11,11,4,1,19,24,7,2,5,14,0,0,5,5
Nyeme Victoria ALEXANDRE COSTA NUNES,Brazil,Libero,Women,China,2022-06-28,Pool,3,5,0,0,0,0,0,0,0,0,0,0,0,0,0,0,0,0,0,0,0,0,0,0,0,0,0
Rosamaria MONTIBELLER,Brazil,Outside Hitter,Women,China,2022-06-28,Pool,3,5,0,0,0,0,0,0,0,0,0,0,0,3,3,0,0,0,0,0,1,0,1,0,0,0,0
Macris Fernanda SILVA CARNEIRO,Brazil,Setter,Women,China,2022-06-28,Pool,3,5,1,1,0,4,5,0,1,1,2,0,3,17,20,0,0,0,0,4,2,2,8,36,1,76,113
Roberta Silva RATZKE,Brazil,Setter,Women,China,2022-06-28,Pool,3,5,0,0,0,0,0,0,0,1,1,0,0,5,5,0,0,0,0,2,0,0,2,5,0,12,17
Gabriela BRAGA GUIMARAES,Brazil,Outside Hitter,Women,China,2022-06-28,Pool,3,5,28,25,9,21,55,2,3,2,7,1,0,21,22,13,1,32,46,9,2,3,14,0,0,2,2
Natália ARAUJO,Brazil,Libero,Women,China,2022-06-28,Pool,3,5,0,0,0,0,0,0,0,0,0,0,0,0,0,4,0,12,16,17,2,2,21,2,0,11,13
Lorena Giovana VIEZEL,Brazil,Middle Blocker,Women,China,2022-06-28,Pool,3,5,0,0,0,0,0,0,0,0,0,0,0,0,0,0,0,0,0,0,0,0,0,0,0,0,0
Kisy NASCIMENTO,Brazil,Opposite Spiker,Women,China,2022-06-28,Pool,3,5,25,22,5,24,51,3,4,4,11,0,4,8,12,0,0,0,0,8,3,6,17,0,0,4,4
Julia Isabelle BERGMANN,Brazil,Outside Hitter,Women,China,2022-06-28,Pool,3,5,3,2,1,1,4,0,0,1,1,1,2,3,6,1,1,11,13,3,0,3,6,0,0,1,1
Mayany Cristina ARAUJO DE SOUZA,Brazil,Middle Blocker,Women,China,2022-06-28,Pool,3,5,0,0,0,0,0,0,0,0,0,0,0,0,0,0,0,0,0,0,0,0,0,0,0,0,0
Lorrayna DA SILVA,Brazil,Opposite Spiker,Women,China,2022-06-28,Pool,3,5,0,0,0,2,2,0,0,0,0,0,0,0,0,0,0,0,0,0,0,0,0,0,0,0,0
Gergana DIMITROVA,Bulgaria,Outside Hitter,Women,Türkiye,2022-06-04,Pool,0,3,8,8,7,13,28,0,2,1,3,0,0,10,10,3,0,15,18,5,0,0,5,0,0,1,1
Nasya DIMITROVA,Bulgaria,Middle Blocker,Women,Türkiye,2022-06-04,Pool,0,3,4,2,2,0,4,2,1,2,5,0,0,1,1,0,0,0,0,1,0,0,1,0,0,1,1
Miroslava PASKOVA,Bulgaria,Outside Hitter,Women,Türkiye,2022-06-04,Pool,0,3,7,7,2,11,20,0,2,2,4,0,0,9,9,4,1,15,20,4,1,1,6,1,0,0,1
Lora KITIPOVA,Bulgaria,Setter,Women,Türkiye,2022-06-04,Pool,0,3,3,1,0,1,2,1,1,1,3,1,1,14,16,0,0,1,1,7,3,5,15,33,3,37,73
Petya BARAKOVA,Bulgaria,Setter,Women,Türkiye,2022-06-04,Pool,0,3,0,0,0,0,0,0,0,0,0,0,0,0,0,0,0,0,0,0,0,0,0,0,0,0,0
Borislava SAYKOVA,Bulgaria,Middle Blocker,Women,Türkiye,2022-06-04,Pool,0,3,1,0,0,0,0,1,0,0,1,0,0,2,2,0,0,0,0,0,0,0,0,0,0,0,0
Mira TODOROVA,Bulgaria,Middle Blocker,Women,Türkiye,2022-06-04,Pool,0,3,3,3,1,1,5,0,3,1,4,0,2,2,4,0,0,0,0,0,0,0,0,0,0,0,0
Hristina Hristova VUCHKOVA,Bulgaria,Middle Blocker,Women,Türkiye,2022-06-04,Pool,0,3,8,5,1,3,9,3,3,5,11,0,1,6,7,0,0,0,0,1,0,1,2,0,0,0,0
Zhana TODOROVA,Bulgaria,Libero,Women,Türkiye,2022-06-04,Pool,0,3,0,0,0,0,0,0,0,0,0,0,0,0,0,4,2,5,11,6,1,1,8,1,0,8,9
Radostina MARINOVA,Bulgaria,Opposite Spiker,Women,Türkiye,2022-06-04,Pool,0,3,1,1,0,1,2,0,0,0,0,0,1,0,1,0,0,0,0,0,2,0,2,0,0,0,0
Silvana CHAUSHEVA,Bulgaria,Outside Hitter,Women,Türkiye,2022-06-04,Pool,0,3,2,2,5,7,14,0,0,4,4,0,0,4,4,0,0,0,0,4,0,0,4,0,0,0,0
Aleksandra MILANOVA,Bulgaria,Outside Hitter,Women,Türkiye,2022-06-04,Pool,0,3,3,2,0,6,8,1,0,0,1,0,1,2,3,1,0,13,14,3,0,0,3,0,0,0,0
Mirela SHAHPAZOVA,Bulgaria,Outside Hitter,Women,Türkiye,2022-06-04,Pool,0,3,0,0,0,0,0,0,0,0,0,0,0,0,0,0,0,0,0,1,1,0,2,4,0,5,9
Ralitsa VASILEVA,Bulgaria,Opposite Spiker,Women,Türkiye,2022-06-04,Pool,0,3,0,0,2,0,2,0,0,0,0,0,0,0,0,1,0,2,3,1,0,1,2,0,0,0,0
Gergana DIMITROVA,Bulgaria,Outside Hitter,Women,Serbia,2022-06-03,Pool,0,3,9,7,8,12,27,1,2,1,4,1,0,10,11,2,1,13,16,6,3,0,9,0,0,1,1
Nasya DIMITROVA,Bulgaria,Middle Blocker,Women,Serbia,2022-06-03,Pool,0,3,7,6,2,6,14,0,5,3,8,1,0,6,7,1,1,2,4,2,1,3,6,0,0,0,0
Miroslava PASKOVA,Bulgaria,Outside Hitter,Women,Serbia,2022-06-03,Pool,0,3,8,8,1,10,19,0,3,5,8,0,3,5,8,4,1,29,34,6,3,4,13,0,0,1,1
Lora KITIPOVA,Bulgaria,Setter,Women,Serbia,2022-06-03,Pool,0,3,2,1,0,4,5,0,6,3,9,1,1,10,12,0,0,0,0,2,1,1,4,12,0,68,80
Petya BARAKOVA,Bulgaria,Setter,Women,Serbia,2022-06-03,Pool,0,3,0,0,0,0,0,0,0,0,0,0,0,2,2,0,0,0,0,1,0,1,2,5,0,11,16
Borislava SAYKOVA,Bulgaria,Middle Blocker,Women,Serbia,2022-06-03,Pool,0,3,0,0,0,0,0,0,0,1,1,0,0,2,2,0,0,0,0,0,0,0,0,0,0,0,0
Mira TODOROVA,Bulgaria,Middle Blocker,Women,Serbia,2022-06-03,Pool,0,3,0,0,0,0,0,0,0,0,0,0,0,0,0,0,0,0,0,0,0,0,0,0,0,0,0
Hristina Hristova VUCHKOVA,Bulgaria,Middle Blocker,Women,Serbia,2022-06-03,Pool,0,3,7,5,0,3,8,2,5,3,10,0,0,9,9,0,0,0,0,0,1,2,3,0,0,2,2
Zhana TODOROVA,Bulgaria,Libero,Women,Serbia,2022-06-03,Pool,0,3,0,0,0,0,0,0,0,0,0,0,0,0,0,3,1,7,11,10,4,7,21,0,3,7,10
Radostina MARINOVA,Bulgaria,Opposite Spiker,Women,Serbia,2022-06-03,Pool,0,3,2,2,0,7,9,0,1,1,2,0,1,1,2,0,0,0,0,0,0,0,0,0,0,0,0
Silvana CHAUSHEVA,Bulgaria,Outside Hitter,Women,Serbia,2022-06-03,Pool,0,3,9,8,4,15,27,1,3,1,5,0,0,10,10,1,0,0,1,7,2,0,9,0,0,0,0
Aleksandra MILANOVA,Bulgaria,Outside Hitter,Women,Serbia,2022-06-03,Pool,0,3,2,2,0,0,2,0,1,1,2,0,0,1,1,0,0,2,2,0,1,0,1,0,0,0,0
Mirela SHAHPAZOVA,Bulgaria,Outside Hitter,Women,Serbia,2022-06-03,Pool,0,3,0,0,0,0,0,0,0,0,0,0,0,0,0,0,0,0,0,0,0,0,0,0,0,0,0
Ralitsa VASILEVA,Bulgaria,Opposite Spiker,Women,Serbia,2022-06-03,Pool,0,3,0,0,0,1,1,0,0,0,0,0,0,0,0,1,0,1,2,0,0,0,0,0,0,0,0
Gergana DIMITROVA,Bulgaria,Outside Hitter,Women,Netherlands,2022-06-02,Pool,3,5,20,17,1,27,45,2,1,3,6,1,1,16,18,9,2,28,39,19,5,1,25,0,0,2,2
Nasya DIMITROVA,Bulgaria,Middle Blocker,Women,Netherlands,2022-06-02,Pool,3,5,14,10,4,5,19,4,6,12,22,0,1,10,11,0,0,1,1,4,1,1,6,0,0,2,2
Miroslava PASKOVA,Bulgaria,Outside Hitter,Women,Netherlands,2022-06-02,Pool,3,5,19,16,3,21,40,2,6,3,11,1,3,10,14,4,0,19,23,10,6,2,18,1,0,5,6
Lora KITIPOVA,Bulgaria,Setter,Women,Netherlands,2022-06-02,Pool,3,5,1,0,0,1,1,1,3,2,6,0,2,8,10,0,0,0,0,3,4,6,13,27,0,88,115
Petya BARAKOVA,Bulgaria,Setter,Women,Netherlands,2022-06-02,Pool,3,5,0,0,0,1,1,0,0,1,1,0,0,2,2,0,0,0,0,1,0,0,1,4,1,16,21
Borislava SAYKOVA,Bulgaria,Middle Blocker,Women,Netherlands,2022-06-02,Pool,3,5,0,0,0,0,0,0,0,0,0,0,1,0,1,0,0,0,0,0,0,0,0,0,0,0,0
Mira TODOROVA,Bulgaria,Middle Blocker,Women,Netherlands,2022-06-02,Pool,3,5,3,2,0,2,4,1,0,1,2,0,1,0,1,0,0,0,0,0,0,0,0,0,0,0,0
Hristina Hristova VUCHKOVA,Bulgaria,Middle Blocker,Women,Netherlands,2022-06-02,Pool,3,5,11,8,3,7,18,1,6,5,12,2,0,17,19,0,0,0,0,2,1,2,5,0,0,1,1
Zhana TODOROVA,Bulgaria,Libero,Women,Netherlands,2022-06-02,Pool,3,5,0,0,0,0,0,0,0,0,0,0,0,0,0,8,0,6,14,14,3,12,29,0,0,7,7
Radostina MARINOVA,Bulgaria,Opposite Spiker,Women,Netherlands,2022-06-02,Pool,3,5,0,0,0,0,0,0,0,0,0,0,0,0,0,0,0,0,0,0,0,0,0,0,0,0,0
Silvana CHAUSHEVA,Bulgaria,Outside Hitter,Women,Netherlands,2022-06-02,Pool,3,5,12,10,5,12,27,0,4,2,6,2,0,15,17,0,0,0,0,8,2,2,12,0,0,4,4
Aleksandra MILANOVA,Bulgaria,Outside Hitter,Women,Netherlands,2022-06-02,Pool,3,5,1,1,2,2,5,0,0,0,0,0,1,1,2,2,0,2,4,2,1,1,4,0,0,0,0
Mirela SHAHPAZOVA,Bulgaria,Outside Hitter,Women,Netherlands,2022-06-02,Pool,3,5,0,0,0,0,0,0,0,0,0,0,0,0,0,0,0,0,0,0,0,0,0,0,0,0,0
Ralitsa VASILEVA,Bulgaria,Opposite Spiker,Women,Netherlands,2022-06-02,Pool,3,5,1,1,1,1,3,0,2,2,4,0,0,1,1,0,0,0,0,1,0,0,1,0,0,3,3
Gergana DIMITROVA,Bulgaria,Outside Hitter,Women,Thailand,2022-05-31,Pool,0,3,13,12,1,8,21,1,1,3,5,0,0,6,6,5,0,18,23,7,4,2,13,0,0,2,2
Nasya DIMITROVA,Bulgaria,Middle Blocker,Women,Thailand,2022-05-31,Pool,0,3,10,9,2,4,15,1,5,3,9,0,1,10,11,0,0,0,0,1,3,0,4,0,0,1,1
Miroslava PASKOVA,Bulgaria,Outside Hitter,Women,Thailand,2022-05-31,Pool,0,3,4,3,5,11,19,1,6,4,11,0,2,11,13,1,1,11,13,5,4,1,10,0,0,2,2
Lora KITIPOVA,Bulgaria,Setter,Women,Thailand,2022-05-31,Pool,0,3,1,1,0,2,3,0,3,1,4,0,1,8,9,0,0,0,0,1,2,2,5,24,0,50,74
Petya BARAKOVA,Bulgaria,Setter,Women,Thailand,2022-05-31,Pool,0,3,0,0,0,0,0,0,1,0,1,0,1,1,2,0,0,0,0,0,0,0,0,2,0,2,4
Borislava SAYKOVA,Bulgaria,Middle Blocker,Women,Thailand,2022-05-31,Pool,0,3,0,0,0,0,0,0,0,0,0,0,2,2,4,0,0,0,0,0,1,0,1,0,0,0,0
Mira TODOROVA,Bulgaria,Middle Blocker,Women,Thailand,2022-05-31,Pool,0,3,4,4,1,0,5,0,1,4,5,0,1,3,4,0,0,0,0,1,0,0,1,0,0,1,1
Hristina Hristova VUCHKOVA,Bulgaria,Middle Blocker,Women,Thailand,2022-05-31,Pool,0,3,3,3,0,2,5,0,1,1,2,0,0,3,3,0,0,0,0,0,0,0,0,0,0,0,0
Zhana TODOROVA,Bulgaria,Libero,Women,Thailand,2022-05-31,Pool,0,3,0,0,0,0,0,0,0,0,0,0,0,0,0,5,1,12,18,7,4,9,20,0,0,1,1
Radostina MARINOVA,Bulgaria,Opposite Spiker,Women,Thailand,2022-05-31,Pool,0,3,0,0,0,0,0,0,0,0,0,0,0,0,0,0,0,0,0,0,0,0,0,0,0,0,0
Silvana CHAUSHEVA,Bulgaria,Outside Hitter,Women,Thailand,2022-05-31,Pool,0,3,8,8,3,6,17,0,0,1,1,0,0,7,7,0,0,0,0,4,1,0,5,0,0,1,1
Aleksandra MILANOVA,Bulgaria,Outside Hitter,Women,Thailand,2022-05-31,Pool,0,3,5,4,0,0,4,0,0,0,0,1,3,1,5,2,3,6,11,1,0,1,2,0,0,0,0
Mirela SHAHPAZOVA,Bulgaria,Outside Hitter,Women,Thailand,2022-05-31,Pool,0,3,0,0,0,0,0,0,0,0,0,0,0,0,0,0,0,0,0,0,0,0,0,0,0,0,0
Ralitsa VASILEVA,Bulgaria,Opposite Spiker,Women,Thailand,2022-05-31,Pool,0,3,0,0,0,0,0,0,0,0,0,0,0,0,0,0,0,0,0,0,0,0,0,0,0,0,0
Nasya DIMITROVA,Bulgaria,Middle Blocker,Women,Poland,2022-07-03,Pool,3,4,15,10,1,7,18,4,4,1,9,1,1,16,18,0,0,0,0,1,1,0,2,0,0,4,4
Polina NEYKOVA,Bulgaria,Libero,Women,Poland,2022-07-03,Pool,3,4,0,0,0,0,0,0,0,0,0,0,0,0,0,0,0,0,0,0,0,0,0,0,0,0,0
Maria YORDANOVA,Bulgaria,Opposite Spiker,Women,Poland,2022-07-03,Pool,3,4,22,20,8,14,42,2,1,1,4,0,1,10,11,3,1,24,28,8,2,0,10,0,0,2,2
Miroslava PASKOVA,Bulgaria,Outside Hitter,Women,Poland,2022-07-03,Pool,3,4,8,7,3,12,22,0,3,0,3,1,2,19,22,1,0,20,21,11,0,0,11,0,0,2,2
Lora KITIPOVA,Bulgaria,Setter,Women,Poland,2022-07-03,Pool,3,4,4,4,0,2,6,0,2,1,3,0,2,14,16,0,0,0,0,10,1,3,14,10,0,95,105
Petya BARAKOVA,Bulgaria,Setter,Women,Poland,2022-07-03,Pool,3,4,0,0,0,0,0,0,0,0,0,0,0,0,0,0,0,0,0,0,0,0,0,0,0,0,0
Borislava SAYKOVA,Bulgaria,Middle Blocker,Women,Poland,2022-07-03,Pool,3,4,0,0,0,0,0,0,0,0,0,0,0,0,0,0,0,0,0,0,0,0,0,0,0,0,0
Mira TODOROVA,Bulgaria,Middle Blocker,Women,Poland,2022-07-03,Pool,3,4,9,8,1,3,12,1,7,3,11,0,3,7,10,0,0,0,0,3,1,0,4,0,0,0,0
Zhana TODOROVA,Bulgaria,Libero,Women,Poland,2022-07-03,Pool,3,4,0,0,0,0,0,0,0,0,0,0,0,0,0,4,1,13,18,7,4,3,14,0,0,6,6
Radostina MARINOVA,Bulgaria,Opposite Spiker,Women,Poland,2022-07-03,Pool,3,4,0,0,0,0,0,0,0,0,0,0,0,0,0,0,0,0,0,0,0,0,0,0,0,0,0
Silvana CHAUSHEVA,Bulgaria,Outside Hitter,Women,Poland,2022-07-03,Pool,3,4,11,10,3,17,30,1,4,3,8,0,1,18,19,0,0,1,1,5,1,0,6,0,0,4,4
Aleksandra MILANOVA,Bulgaria,Outside Hitter,Women,Poland,2022-07-03,Pool,3,4,0,0,0,0,0,0,0,0,0,0,0,0,0,0,0,0,0,0,0,0,0,0,0,0,0
Mariya KRIVOSHIYSKA,Bulgaria,Middle Blocker,Women,Poland,2022-07-03,Pool,3,4,0,0,0,0,0,0,0,0,0,0,0,0,0,0,0,0,0,0,0,0,0,0,0,0,0
Ralitsa VASILEVA,Bulgaria,Opposite Spiker,Women,Poland,2022-07-03,Pool,3,4,0,0,0,0,0,0,0,0,0,0,0,0,0,0,0,0,0,0,0,0,0,0,0,0,0
Nasya DIMITROVA,Bulgaria,Middle Blocker,Women,Italy,2022-07-02,Pool,0,3,8,5,1,5,11,0,6,0,6,3,0,13,16,0,0,0,0,2,2,1,5,0,0,1,1
Polina NEYKOVA,Bulgaria,Libero,Women,Italy,2022-07-02,Pool,0,3,0,0,0,0,0,0,0,0,0,0,0,0,0,0,0,0,0,0,0,0,0,0,0,0,0
Maria YORDANOVA,Bulgaria,Opposite Spiker,Women,Italy,2022-07-02,Pool,0,3,9,9,6,7,22,0,3,1,4,0,0,6,6,2,2,24,28,1,2,1,4,0,1,0,1
Miroslava PASKOVA,Bulgaria,Outside Hitter,Women,Italy,2022-07-02,Pool,0,3,7,7,2,11,20,0,3,1,4,0,2,7,9,1,1,20,22,9,1,3,13,0,0,0,0
Lora KITIPOVA,Bulgaria,Setter,Women,Italy,2022-07-02,Pool,0,3,0,0,0,1,1,0,0,0,0,0,2,1,3,0,0,0,0,1,1,0,2,3,1,34,38
Petya BARAKOVA,Bulgaria,Setter,Women,Italy,2022-07-02,Pool,0,3,0,0,0,2,2,0,1,3,4,0,1,3,4,0,0,0,0,1,3,1,5,4,0,42,46
Borislava SAYKOVA,Bulgaria,Middle Blocker,Women,Italy,2022-07-02,Pool,0,3,2,1,0,0,1,0,2,0,2,1,0,4,5,0,0,0,0,0,0,0,0,0,0,0,0
Mira TODOROVA,Bulgaria,Middle Blocker,Women,Italy,2022-07-02,Pool,0,3,2,2,0,3,5,0,5,0,5,0,0,3,3,0,0,0,0,0,0,0,0,0,0,0,0
Zhana TODOROVA,Bulgaria,Libero,Women,Italy,2022-07-02,Pool,0,3,0,0,0,0,0,0,0,0,0,0,0,0,0,2,0,7,9,4,1,1,6,0,0,6,6
Radostina MARINOVA,Bulgaria,Opposite Spiker,Women,Italy,2022-07-02,Pool,0,3,3,2,0,14,16,1,1,0,2,0,0,5,5,0,0,0,0,1,0,4,5,0,0,0,0
Silvana CHAUSHEVA,Bulgaria,Outside Hitter,Women,Italy,2022-07-02,Pool,0,3,7,7,1,7,15,0,0,0,0,0,1,1,2,0,0,0,0,0,1,0,1,0,0,1,1
Aleksandra MILANOVA,Bulgaria,Outside Hitter,Women,Italy,2022-07-02,Pool,0,3,1,1,0,2,3,0,1,0,1,0,0,0,0,1,0,2,3,0,0,0,0,0,0,1,1
Mariya KRIVOSHIYSKA,Bulgaria,Middle Blocker,Women,Italy,2022-07-02,Pool,0,3,0,0,0,0,0,0,0,0,0,0,0,0,0,0,0,0,0,0,0,0,0,0,0,0,0
Ralitsa VASILEVA,Bulgaria,Opposite Spiker,Women,Italy,2022-07-02,Pool,0,3,1,1,1,0,2,0,0,0,0,0,0,0,0,0,1,3,4,0,0,0,0,0,0,0,0
Nasya DIMITROVA,Bulgaria,Middle Blocker,Women,Brazil,2022-07-01,Pool,0,3,9,7,0,3,10,1,5,0,6,1,0,10,11,0,0,1,1,3,1,2,6,0,1,0,1
Polina NEYKOVA,Bulgaria,Libero,Women,Brazil,2022-07-01,Pool,0,3,0,0,0,0,0,0,0,0,0,0,0,0,0,0,0,0,0,0,0,0,0,0,0,0,0
Maria YORDANOVA,Bulgaria,Opposite Spiker,Women,Brazil,2022-07-01,Pool,0,3,6,5,6,5,16,1,2,0,3,0,1,4,5,4,1,19,24,3,1,1,5,0,0,0,0
Miroslava PASKOVA,Bulgaria,Outside Hitter,Women,Brazil,2022-07-01,Pool,0,3,7,6,2,9,17,0,0,0,0,1,0,8,9,5,0,12,17,3,2,0,5,0,0,0,0
Lora KITIPOVA,Bulgaria,Setter,Women,Brazil,2022-07-01,Pool,0,3,1,0,0,2,2,0,4,1,5,1,1,10,12,0,0,0,0,3,1,0,4,11,1,67,79
Petya BARAKOVA,Bulgaria,Setter,Women,Brazil,2022-07-01,Pool,0,3,0,0,0,0,0,0,0,0,0,0,0,1,1,0,0,0,0,0,0,0,0,1,1,14,16
Borislava SAYKOVA,Bulgaria,Middle Blocker,Women,Brazil,2022-07-01,Pool,0,3,0,0,0,0,0,0,0,0,0,0,1,1,2,0,0,0,0,0,0,0,0,0,0,0,0
Mira TODOROVA,Bulgaria,Middle Blocker,Women,Brazil,2022-07-01,Pool,0,3,6,5,1,4,10,1,1,2,4,0,2,6,8,0,0,1,1,4,1,0,5,0,0,0,0
Zhana TODOROVA,Bulgaria,Libero,Women,Brazil,2022-07-01,Pool,0,3,0,0,0,0,0,0,0,0,0,0,0,0,0,1,2,7,10,7,2,3,12,0,0,1,1
Radostina MARINOVA,Bulgaria,Opposite Spiker,Women,Brazil,2022-07-01,Pool,0,3,4,4,3,6,13,0,1,0,1,0,0,2,2,0,0,0,0,0,0,0,0,0,0,0,0
Silvana CHAUSHEVA,Bulgaria,Outside Hitter,Women,Brazil,2022-07-01,Pool,0,3,4,2,5,7,14,2,2,0,4,0,1,3,4,0,0,0,0,3,0,0,3,0,0,0,0
Aleksandra MILANOVA,Bulgaria,Outside Hitter,Women,Brazil,2022-07-01,Pool,0,3,3,2,4,4,10,0,1,0,1,1,1,5,7,3,0,7,10,4,1,1,6,0,0,0,0
Mariya KRIVOSHIYSKA,Bulgaria,Middle Blocker,Women,Brazil,2022-07-01,Pool,0,3,0,0,0,0,0,0,0,0,0,0,0,0,0,0,0,0,0,0,0,0,0,0,0,0,0
Ralitsa VASILEVA,Bulgaria,Opposite Spiker,Women,Brazil,2022-07-01,Pool,0,3,0,0,0,0,0,0,0,0,0,0,0,0,0,0,0,0,0,0,0,0,0,0,0,0,0
Nasya DIMITROVA,Bulgaria,Middle Blocker,Women,Dominican Republic,2022-06-28,Pool,3,3,10,6,0,2,8,4,3,0,7,0,2,9,11,0,0,0,0,1,0,1,2,2,0,0,2
Polina NEYKOVA,Bulgaria,Libero,Women,Dominican Republic,2022-06-28,Pool,3,3,0,0,0,0,0,0,0,0,0,0,0,0,0,0,0,1,1,0,0,0,0,0,0,0,0
Maria YORDANOVA,Bulgaria,Opposite Spiker,Women,Dominican Republic,2022-06-28,Pool,3,3,22,19,5,17,41,2,0,0,2,1,1,9,11,2,0,12,14,5,1,1,7,0,0,0,0
Miroslava PASKOVA,Bulgaria,Outside Hitter,Women,Dominican Republic,2022-06-28,Pool,3,3,10,10,4,11,25,0,0,1,1,0,0,12,12,4,0,16,20,4,0,0,4,0,0,0,0
Lora KITIPOVA,Bulgaria,Setter,Women,Dominican Republic,2022-06-28,Pool,3,3,0,0,0,0,0,0,0,1,1,0,1,11,12,0,0,0,0,4,2,0,6,51,2,3,56
Petya BARAKOVA,Bulgaria,Setter,Women,Dominican Republic,2022-06-28,Pool,3,3,0,0,0,0,0,0,0,0,0,0,0,0,0,0,0,0,0,0,0,0,0,0,0,0,0
Borislava SAYKOVA,Bulgaria,Middle Blocker,Women,Dominican Republic,2022-06-28,Pool,3,3,0,0,0,0,0,0,0,0,0,0,0,0,0,0,0,0,0,0,0,0,0,0,0,0,0
Mira TODOROVA,Bulgaria,Middle Blocker,Women,Dominican Republic,2022-06-28,Pool,3,3,8,4,0,6,10,3,3,1,7,1,1,5,7,0,0,1,1,3,0,0,3,0,0,0,0
Zhana TODOROVA,Bulgaria,Libero,Women,Dominican Republic,2022-06-28,Pool,3,3,0,0,0,0,0,0,0,0,0,0,0,0,0,2,0,7,9,3,3,1,7,5,0,0,5
Radostina MARINOVA,Bulgaria,Opposite Spiker,Women,Dominican Republic,2022-06-28,Pool,3,3,7,4,3,4,11,0,0,0,0,3,1,16,20,0,0,0,0,1,0,0,1,1,0,0,1
Silvana CHAUSHEVA,Bulgaria,Outside Hitter,Women,Dominican Republic,2022-06-28,Pool,3,3,0,0,0,0,0,0,0,0,0,0,0,0,0,0,0,0,0,0,0,0,0,0,0,0,0
Aleksandra MILANOVA,Bulgaria,Outside Hitter,Women,Dominican Republic,2022-06-28,Pool,3,3,0,0,0,0,0,0,0,0,0,0,0,0,0,0,0,0,0,0,0,0,0,0,0,0,0
Mariya KRIVOSHIYSKA,Bulgaria,Middle Blocker,Women,Dominican Republic,2022-06-28,Pool,3,3,0,0,0,0,0,0,0,0,0,0,0,0,0,0,0,0,0,0,0,0,0,0,0,0,0
Ralitsa VASILEVA,Bulgaria,Opposite Spiker,Women,Dominican Republic,2022-06-28,Pool,3,3,0,0,0,0,0,0,0,0,0,0,0,0,0,0,0,0,0,0,0,0,0,0,0,0,0
Nasya DIMITROVA,Bulgaria,Middle Blocker,Women,Belgium,2022-06-19,Pool,2,5,14,5,2,13,20,9,6,6,21,0,1,14,15,0,0,0,0,8,1,1,10,0,0,7,7
Maria YORDANOVA,Bulgaria,Opposite Spiker,Women,Belgium,2022-06-19,Pool,2,5,19,17,7,18,42,2,5,4,11,0,3,15,18,5,5,43,53,14,3,2,19,0,1,5,6
Miroslava PASKOVA,Bulgaria,Outside Hitter,Women,Belgium,2022-06-19,Pool,2,5,13,13,11,27,51,0,3,3,6,0,1,19,20,2,2,17,21,12,3,1,16,0,0,5,5
Lora KITIPOVA,Bulgaria,Setter,Women,Belgium,2022-06-19,Pool,2,5,7,5,0,1,6,2,5,4,11,0,4,20,24,0,0,0,0,19,3,2,24,36,0,87,123
Petya BARAKOVA,Bulgaria,Setter,Women,Belgium,2022-06-19,Pool,2,5,0,0,0,0,0,0,0,0,0,0,0,0,0,0,0,0,0,0,0,0,0,0,0,2,2
Borislava SAYKOVA,Bulgaria,Middle Blocker,Women,Belgium,2022-06-19,Pool,2,5,0,0,0,0,0,0,0,0,0,0,1,0,1,0,0,0,0,0,0,0,0,0,0,0,0
Mira TODOROVA,Bulgaria,Middle Blocker,Women,Belgium,2022-06-19,Pool,2,5,11,9,1,4,14,2,0,2,4,0,0,15,15,0,0,0,0,12,0,0,12,0,0,1,1
Zhana TODOROVA,Bulgaria,Libero,Women,Belgium,2022-06-19,Pool,2,5,0,0,0,0,0,0,0,0,0,0,0,0,0,8,1,9,18,29,1,1,31,1,0,26,27
Radostina MARINOVA,Bulgaria,Opposite Spiker,Women,Belgium,2022-06-19,Pool,2,5,0,0,0,0,0,0,0,0,0,0,0,0,0,0,0,0,0,0,0,0,0,0,0,0,0
Silvana CHAUSHEVA,Bulgaria,Outside Hitter,Women,Belgium,2022-06-19,Pool,2,5,14,12,7,29,48,1,4,10,15,1,2,14,17,0,0,0,0,11,2,0,13,0,0,2,2
Aleksandra MILANOVA,Bulgaria,Outside Hitter,Women,Belgium,2022-06-19,Pool,2,5,0,0,0,0,0,0,0,0,0,0,0,0,0,0,0,0,0,0,0,0,0,0,0,0,0
Mirela SHAHPAZOVA,Bulgaria,Outside Hitter,Women,Belgium,2022-06-19,Pool,2,5,0,0,0,0,0,0,0,0,0,0,0,0,0,0,0,0,0,0,0,0,0,0,0,0,0
Mariya KRIVOSHIYSKA,Bulgaria,Middle Blocker,Women,Belgium,2022-06-19,Pool,2,5,0,0,0,0,0,0,0,0,0,0,0,0,0,0,0,0,0,0,0,0,0,0,0,0,0
Ralitsa VASILEVA,Bulgaria,Opposite Spiker,Women,Belgium,2022-06-19,Pool,2,5,0,0,0,0,0,0,0,0,0,0,0,0,0,0,0,0,0,0,0,0,0,0,0,0,0
Nasya DIMITROVA,Bulgaria,Middle Blocker,Women,Canada,2022-06-18,Pool,3,3,11,8,0,2,10,3,4,13,20,0,1,11,12,0,1,0,1,3,0,0,3,0,0,1,1
Maria YORDANOVA,Bulgaria,Opposite Spiker,Women,Canada,2022-06-18,Pool,3,3,15,13,4,8,25,1,1,0,2,1,0,9,10,3,2,13,18,9,1,0,10,1,0,4,5
Miroslava PASKOVA,Bulgaria,Outside Hitter,Women,Canada,2022-06-18,Pool,3,3,14,12,2,10,24,1,3,3,7,1,2,11,14,8,2,16,26,8,2,1,11,0,0,0,0
Lora KITIPOVA,Bulgaria,Setter,Women,Canada,2022-06-18,Pool,3,3,3,3,0,2,5,0,5,1,6,0,1,16,17,0,0,0,0,8,1,1,10,8,0,70,78
Petya BARAKOVA,Bulgaria,Setter,Women,Canada,2022-06-18,Pool,3,3,0,0,0,0,0,0,0,0,0,0,0,0,0,0,0,0,0,0,0,0,0,0,0,0,0
Borislava SAYKOVA,Bulgaria,Middle Blocker,Women,Canada,2022-06-18,Pool,3,3,0,0,0,0,0,0,0,0,0,0,0,0,0,0,0,0,0,0,0,0,0,0,0,0,0
Mira TODOROVA,Bulgaria,Middle Blocker,Women,Canada,2022-06-18,Pool,3,3,5,4,0,2,6,1,6,5,12,0,1,10,11,0,0,0,0,3,0,0,3,1,0,2,3
Zhana TODOROVA,Bulgaria,Libero,Women,Canada,2022-06-18,Pool,3,3,0,0,0,0,0,0,0,0,0,0,0,0,0,6,2,9,17,15,3,1,19,0,0,11,11
Radostina MARINOVA,Bulgaria,Opposite Spiker,Women,Canada,2022-06-18,Pool,3,3,0,0,0,0,0,0,0,0,0,0,0,0,0,0,0,0,0,0,0,0,0,0,0,0,0
Silvana CHAUSHEVA,Bulgaria,Outside Hitter,Women,Canada,2022-06-18,Pool,3,3,12,10,3,19,32,1,3,3,7,1,1,9,11,0,0,1,1,3,1,0,4,0,0,1,1
Aleksandra MILANOVA,Bulgaria,Outside Hitter,Women,Canada,2022-06-18,Pool,3,3,0,0,0,0,0,0,0,0,0,0,0,0,0,0,0,0,0,0,0,0,0,0,0,0,0
Mirela SHAHPAZOVA,Bulgaria,Outside Hitter,Women,Canada,2022-06-18,Pool,3,3,0,0,0,0,0,0,0,0,0,0,0,0,0,0,0,0,0,0,0,0,0,0,0,0,0
Mariya KRIVOSHIYSKA,Bulgaria,Middle Blocker,Women,Canada,2022-06-18,Pool,3,3,0,0,0,0,0,0,0,0,0,0,0,0,0,0,0,0,0,0,0,0,0,0,0,0,0
Ralitsa VASILEVA,Bulgaria,Opposite Spiker,Women,Canada,2022-06-18,Pool,3,3,0,0,0,0,0,0,0,0,0,0,0,0,0,0,0,0,0,0,0,0,0,0,0,0,0
Nasya DIMITROVA,Bulgaria,Middle Blocker,Women,Japan,2022-06-16,Pool,0,3,2,1,1,2,4,1,2,0,3,0,0,1,1,0,0,1,1,1,0,0,1,1,0,1,2
Maria YORDANOVA,Bulgaria,Opposite Spiker,Women,Japan,2022-06-16,Pool,0,3,10,10,5,11,26,0,1,5,6,0,2,7,9,9,3,16,28,9,1,1,11,0,0,0,0
Miroslava PASKOVA,Bulgaria,Outside Hitter,Women,Japan,2022-06-16,Pool,0,3,4,4,4,14,22,0,2,2,4,0,0,14,14,2,1,15,18,9,4,0,13,0,0,4,4
Lora KITIPOVA,Bulgaria,Setter,Women,Japan,2022-06-16,Pool,0,3,1,1,0,0,1,0,5,1,6,0,0,7,7,0,0,0,0,3,0,0,3,18,0,48,66
Petya BARAKOVA,Bulgaria,Setter,Women,Japan,2022-06-16,Pool,0,3,1,1,0,0,1,0,0,1,1,0,0,3,3,0,0,0,0,3,0,0,3,8,0,16,24
Borislava SAYKOVA,Bulgaria,Middle Blocker,Women,Japan,2022-06-16,Pool,0,3,0,0,0,4,4,0,1,6,7,0,2,6,8,0,0,2,2,1,0,0,1,1,0,1,2
Mira TODOROVA,Bulgaria,Middle Blocker,Women,Japan,2022-06-16,Pool,0,3,6,5,0,4,9,1,4,3,8,0,1,8,9,0,0,2,2,3,0,0,3,0,0,0,0
Zhana TODOROVA,Bulgaria,Libero,Women,Japan,2022-06-16,Pool,0,3,0,0,0,0,0,0,0,0,0,0,0,0,0,4,0,6,10,11,3,0,14,0,1,4,5
Radostina MARINOVA,Bulgaria,Opposite Spiker,Women,Japan,2022-06-16,Pool,0,3,2,2,0,3,5,0,0,1,1,0,0,2,2,0,0,0,0,1,1,0,2,0,0,0,0
Silvana CHAUSHEVA,Bulgaria,Outside Hitter,Women,Japan,2022-06-16,Pool,0,3,13,13,4,10,27,0,4,3,7,0,0,7,7,0,0,0,0,2,2,1,5,0,0,5,5
Aleksandra MILANOVA,Bulgaria,Outside Hitter,Women,Japan,2022-06-16,Pool,0,3,3,3,1,2,6,0,0,0,0,0,0,1,1,0,0,0,0,0,1,0,1,0,0,0,0
Mirela SHAHPAZOVA,Bulgaria,Outside Hitter,Women,Japan,2022-06-16,Pool,0,3,0,0,0,0,0,0,0,0,0,0,0,0,0,0,0,0,0,0,0,0,0,0,0,0,0
Mariya KRIVOSHIYSKA,Bulgaria,Middle Blocker,Women,Japan,2022-06-16,Pool,0,3,0,0,0,0,0,0,0,0,0,0,0,0,0,0,0,0,0,0,0,0,0,0,0,0,0
Ralitsa VASILEVA,Bulgaria,Opposite Spiker,Women,Japan,2022-06-16,Pool,0,3,1,1,2,2,5,0,0,2,2,0,0,0,0,0,0,4,4,0,0,0,0,0,0,0,0
Nasya DIMITROVA,Bulgaria,Middle Blocker,Women,United States,2022-06-15,Pool,0,3,5,3,0,7,10,1,3,0,4,1,1,7,9,0,2,0,2,1,0,0,1,0,0,0,0
Maria YORDANOVA,Bulgaria,Opposite Spiker,Women,United States,2022-06-15,Pool,0,3,8,6,3,7,16,1,0,2,3,1,4,2,7,7,3,20,30,5,2,0,7,0,0,1,1
Miroslava PASKOVA,Bulgaria,Outside Hitter,Women,United States,2022-06-15,Pool,0,3,14,11,5,14,30,2,4,0,6,1,1,9,11,1,1,6,8,6,2,0,8,0,0,3,3
Lora KITIPOVA,Bulgaria,Setter,Women,United States,2022-06-15,Pool,0,3,5,3,0,1,4,0,0,0,0,2,0,8,10,0,0,1,1,2,2,0,4,5,1,68,74
Petya BARAKOVA,Bulgaria,Setter,Women,United States,2022-06-15,Pool,0,3,0,0,0,0,0,0,0,0,0,0,0,1,1,0,0,0,0,0,0,0,0,1,0,3,4
Borislava SAYKOVA,Bulgaria,Middle Blocker,Women,United States,2022-06-15,Pool,0,3,0,0,0,0,0,0,0,0,0,0,0,2,2,0,0,0,0,0,0,0,0,0,0,0,0
Mira TODOROVA,Bulgaria,Middle Blocker,Women,United States,2022-06-15,Pool,0,3,2,1,1,2,4,1,6,1,8,0,1,7,8,0,0,0,0,1,0,0,1,0,0,0,0
Zhana TODOROVA,Bulgaria,Libero,Women,United States,2022-06-15,Pool,0,3,0,0,0,0,0,0,0,0,0,0,0,0,0,3,0,8,11,8,4,2,14,0,0,10,10
Radostina MARINOVA,Bulgaria,Opposite Spiker,Women,United States,2022-06-15,Pool,0,3,0,0,0,0,0,0,0,0,0,0,0,0,0,0,0,0,0,0,0,0,0,0,0,0,0
Silvana CHAUSHEVA,Bulgaria,Outside Hitter,Women,United States,2022-06-15,Pool,0,3,9,8,3,11,22,0,2,1,3,1,0,12,13,0,0,0,0,6,2,2,10,0,0,1,1
Aleksandra MILANOVA,Bulgaria,Outside Hitter,Women,United States,2022-06-15,Pool,0,3,5,5,1,1,7,0,0,1,1,0,1,1,2,1,1,12,14,1,1,0,2,0,0,0,0
Mirela SHAHPAZOVA,Bulgaria,Outside Hitter,Women,United States,2022-06-15,Pool,0,3,0,0,0,0,0,0,0,0,0,0,0,0,0,0,0,0,0,0,0,0,0,0,0,0,0
Mariya KRIVOSHIYSKA,Bulgaria,Middle Blocker,Women,United States,2022-06-15,Pool,0,3,0,0,0,0,0,0,0,0,0,0,0,0,0,0,0,0,0,0,0,0,0,0,0,0,0
Ralitsa VASILEVA,Bulgaria,Opposite Spiker,Women,United States,2022-06-15,Pool,0,3,0,0,1,0,1,0,0,0,0,0,0,1,1,0,0,0,0,0,0,0,0,0,0,0,0
Allyssah Marie FITTERER,Canada,Middle Blocker,Women,Korea,2022-06-05,Pool,3,3,0,0,0,0,0,0,0,0,0,0,0,0,0,0,0,0,0,0,0,0,0,0,0,0,0
Kiera VAN RYK,Canada,Outside Hitter,Women,Korea,2022-06-05,Pool,3,3,14,11,3,10,24,3,4,6,13,0,4,5,9,0,0,0,0,3,0,0,3,0,0,2,2
Julia MURMANN,Canada,Libero,Women,Korea,2022-06-05,Pool,3,3,0,0,0,0,0,0,0,0,0,0,0,0,0,5,0,1,6,11,3,1,15,0,0,2,2
Jazmine Ruth WHITE,Canada,Middle Blocker,Women,Korea,2022-06-05,Pool,3,3,0,0,0,0,0,0,0,0,0,0,0,0,0,0,0,0,0,0,0,0,0,0,0,0,0
Alexa GRAY,Canada,Outside Hitter,Women,Korea,2022-06-05,Pool,3,3,11,11,5,9,25,0,1,2,3,0,1,15,16,20,3,6,29,7,1,0,8,0,0,0,0
Courtney BAKER,Canada,Setter,Women,Korea,2022-06-05,Pool,3,3,0,0,0,0,0,0,0,0,0,0,0,0,0,0,0,0,0,0,0,0,0,0,0,0,0
Andrea MITROVIC,Canada,Outside Hitter,Women,Korea,2022-06-05,Pool,3,3,0,0,0,0,0,0,0,0,0,0,0,0,0,0,0,0,0,0,0,0,0,0,0,0,0
Jennifer CROSS,Canada,Middle Blocker,Women,Korea,2022-06-05,Pool,3,3,13,8,0,1,9,3,1,5,9,2,0,13,15,0,0,0,0,4,0,0,4,0,0,1,1
Brie KING,Canada,Setter,Women,Korea,2022-06-05,Pool,3,3,5,1,0,2,3,3,1,2,6,1,1,8,10,0,0,0,0,5,1,1,7,20,0,48,68
Hilary HOWE,Canada,Outside Hitter,Women,Korea,2022-06-05,Pool,3,3,6,6,1,10,17,0,2,1,3,0,1,5,6,5,0,3,8,5,2,1,8,0,0,1,1
Caroline LIVINGSTON,Canada,Outside Hitter,Women,Korea,2022-06-05,Pool,3,3,0,0,0,0,0,0,0,0,0,0,1,1,2,0,1,0,1,1,0,0,1,0,0,0,0
Katerina GEORGIADIS,Canada,Libero,Women,Korea,2022-06-05,Pool,3,3,0,0,0,0,0,0,0,0,0,0,0,0,0,0,0,0,0,0,0,0,0,0,0,0,0
Emily MAGLIO,Canada,Middle Blocker,Women,Korea,2022-06-05,Pool,3,3,10,6,1,4,11,3,2,5,10,1,1,13,15,2,0,0,2,6,0,1,7,0,0,1,1
Sydney GRILLS,Canada,Opposite Spiker,Women,Korea,2022-06-05,Pool,3,3,0,0,0,0,0,0,0,0,0,0,0,0,0,0,0,0,0,0,0,0,0,0,0,0,0
Allyssah Marie FITTERER,Canada,Middle Blocker,Women,United States,2022-06-04,Pool,0,3,0,0,0,0,0,0,0,0,0,0,0,0,0,0,0,0,0,0,0,0,0,0,0,0,0
Kiera VAN RYK,Canada,Outside Hitter,Women,United States,2022-06-04,Pool,0,3,8,8,6,7,21,0,2,4,6,0,3,3,6,0,0,0,0,5,1,0,6,0,0,2,2
Julia MURMANN,Canada,Libero,Women,United States,2022-06-04,Pool,0,3,0,0,0,0,0,0,0,0,0,0,0,0,0,0,0,0,0,0,0,0,0,0,0,0,0
Jazmine Ruth WHITE,Canada,Middle Blocker,Women,United States,2022-06-04,Pool,0,3,3,2,0,1,3,1,1,1,3,0,0,4,4,1,0,1,2,0,0,0,0,0,0,1,1
Alexa GRAY,Canada,Outside Hitter,Women,United States,2022-06-04,Pool,0,3,10,10,6,11,27,0,2,1,3,0,0,9,9,20,1,17,38,5,2,0,7,0,0,1,1
Courtney BAKER,Canada,Setter,Women,United States,2022-06-04,Pool,0,3,0,0,0,0,0,0,0,0,0,0,1,0,1,0,0,0,0,1,1,0,2,4,0,7,11
Andrea MITROVIC,Canada,Outside Hitter,Women,United States,2022-06-04,Pool,0,3,7,6,2,11,19,1,0,1,2,0,0,6,6,5,0,5,10,5,0,0,5,0,0,2,2
Jennifer CROSS,Canada,Middle Blocker,Women,United States,2022-06-04,Pool,0,3,0,0,2,2,4,0,2,2,4,0,1,4,5,0,0,0,0,0,0,0,0,0,0,0,0
Brie KING,Canada,Setter,Women,United States,2022-06-04,Pool,0,3,5,3,0,1,4,2,0,0,2,0,0,11,11,1,0,0,1,13,3,0,16,9,0,56,65
Hilary HOWE,Canada,Outside Hitter,Women,United States,2022-06-04,Pool,0,3,1,0,0,2,2,1,0,0,1,0,1,0,1,1,0,3,4,1,1,0,2,0,0,1,1
Caroline LIVINGSTON,Canada,Outside Hitter,Women,United States,2022-06-04,Pool,0,3,2,2,0,1,3,0,0,0,0,0,1,1,2,2,1,1,4,2,0,0,2,0,0,0,0
Katerina GEORGIADIS,Canada,Libero,Women,United States,2022-06-04,Pool,0,3,0,0,0,0,0,0,0,0,0,0,0,0,0,4,0,2,6,9,2,0,11,0,0,13,13
Emily MAGLIO,Canada,Middle Blocker,Women,United States,2022-06-04,Pool,0,3,6,5,1,7,13,1,3,3,7,0,1,6,7,0,0,0,0,1,0,0,1,0,0,1,1
Sydney GRILLS,Canada,Opposite Spiker,Women,United States,2022-06-04,Pool,0,3,1,0,2,3,5,0,1,0,1,1,2,2,5,0,0,0,0,1,1,0,2,0,0,0,0
Allyssah Marie FITTERER,Canada,Middle Blocker,Women,Dominican Republic,2022-06-03,Pool,3,3,0,0,0,0,0,0,0,0,0,0,0,0,0,0,0,0,0,0,0,0,0,0,0,0,0
Kiera VAN RYK,Canada,Outside Hitter,Women,Dominican Republic,2022-06-03,Pool,3,3,18,13,5,12,30,2,0,2,4,3,4,3,10,0,0,0,0,8,0,0,8,0,0,2,2
Julia MURMANN,Canada,Libero,Women,Dominican Republic,2022-06-03,Pool,3,3,0,0,0,0,0,0,0,0,0,0,0,0,0,8,2,7,17,13,1,1,15,0,0,5,5
Jazmine Ruth WHITE,Canada,Middle Blocker,Women,Dominican Republic,2022-06-03,Pool,3,3,0,0,0,0,0,0,0,0,0,0,0,0,0,0,0,0,0,0,0,0,0,0,0,0,0
Alexa GRAY,Canada,Outside Hitter,Women,Dominican Republic,2022-06-03,Pool,3,3,19,18,4,5,27,1,2,3,6,0,0,13,13,9,0,6,15,9,1,0,10,0,0,1,1
Courtney BAKER,Canada,Setter,Women,Dominican Republic,2022-06-03,Pool,3,3,0,0,0,0,0,0,0,0,0,0,0,0,0,0,0,0,0,0,0,0,0,0,0,0,0
Andrea MITROVIC,Canada,Outside Hitter,Women,Dominican Republic,2022-06-03,Pool,3,3,0,0,0,0,0,0,0,0,0,0,0,0,0,0,0,0,0,0,0,0,0,0,0,0,0
Jennifer CROSS,Canada,Middle Blocker,Women,Dominican Republic,2022-06-03,Pool,3,3,5,3,0,1,4,1,2,6,9,1,0,11,12,0,0,0,0,2,0,0,2,0,0,2,2
Brie KING,Canada,Setter,Women,Dominican Republic,2022-06-03,Pool,3,3,3,2,0,1,3,0,1,0,1,1,0,15,16,0,1,0,1,9,1,1,11,15,0,51,66
Hilary HOWE,Canada,Outside Hitter,Women,Dominican Republic,2022-06-03,Pool,3,3,9,4,2,10,16,3,2,1,6,2,2,8,12,4,2,4,10,8,2,0,10,0,0,5,5
Caroline LIVINGSTON,Canada,Outside Hitter,Women,Dominican Republic,2022-06-03,Pool,3,3,0,0,0,0,0,0,0,0,0,0,0,0,0,0,0,0,0,0,0,0,0,0,0,0,0
Katerina GEORGIADIS,Canada,Libero,Women,Dominican Republic,2022-06-03,Pool,3,3,0,0,0,0,0,0,0,0,0,0,0,0,0,0,0,0,0,0,0,0,0,0,0,0,0
Emily MAGLIO,Canada,Middle Blocker,Women,Dominican Republic,2022-06-03,Pool,3,3,6,3,1,2,6,2,1,2,5,1,0,9,10,0,0,1,1,4,1,0,5,0,0,1,1
Sydney GRILLS,Canada,Opposite Spiker,Women,Dominican Republic,2022-06-03,Pool,3,3,0,0,0,0,0,0,0,0,0,0,0,0,0,0,0,0,0,0,0,0,0,0,0,0,0
Allyssah Marie FITTERER,Canada,Middle Blocker,Women,Poland,2022-06-01,Pool,1,4,0,0,0,0,0,0,0,0,0,0,0,0,0,0,0,0,0,0,0,0,0,0,0,0,0
Kiera VAN RYK,Canada,Outside Hitter,Women,Poland,2022-06-01,Pool,1,4,14,12,11,16,39,1,1,4,6,1,7,9,17,0,0,0,0,5,3,1,9,0,0,4,4
Julia MURMANN,Canada,Libero,Women,Poland,2022-06-01,Pool,1,4,0,0,0,0,0,0,0,0,0,0,0,0,0,6,1,5,12,9,5,0,14,0,0,12,12
Jazmine Ruth WHITE,Canada,Middle Blocker,Women,Poland,2022-06-01,Pool,1,4,0,0,0,0,0,0,0,0,0,0,0,0,0,0,0,0,0,0,0,0,0,0,0,0,0
Alexa GRAY,Canada,Outside Hitter,Women,Poland,2022-06-01,Pool,1,4,19,19,6,17,42,0,1,5,6,0,0,14,14,33,3,19,55,10,1,0,11,0,0,3,3
Courtney BAKER,Canada,Setter,Women,Poland,2022-06-01,Pool,1,4,1,0,0,0,0,1,0,0,1,0,1,0,1,0,0,0,0,0,0,0,0,1,0,4,5
Andrea MITROVIC,Canada,Outside Hitter,Women,Poland,2022-06-01,Pool,1,4,0,0,0,0,0,0,0,0,0,0,1,1,2,3,0,0,3,2,0,0,2,0,0,0,0
Jennifer CROSS,Canada,Middle Blocker,Women,Poland,2022-06-01,Pool,1,4,5,2,0,2,4,3,5,3,11,0,1,11,12,0,0,0,0,4,3,0,7,0,0,1,1
Brie KING,Canada,Setter,Women,Poland,2022-06-01,Pool,1,4,2,0,0,4,4,1,1,2,4,1,1,12,14,0,0,0,0,14,3,1,18,12,1,75,88
Hilary HOWE,Canada,Outside Hitter,Women,Poland,2022-06-01,Pool,1,4,9,8,4,11,23,1,2,1,4,0,4,8,12,3,2,2,7,10,1,0,11,0,0,3,3
Caroline LIVINGSTON,Canada,Outside Hitter,Women,Poland,2022-06-01,Pool,1,4,0,0,0,0,0,0,0,0,0,0,1,0,1,0,0,0,0,1,1,1,3,0,0,0,0
Katerina GEORGIADIS,Canada,Libero,Women,Poland,2022-06-01,Pool,1,4,0,0,0,0,0,0,0,0,0,0,0,0,0,0,0,0,0,0,0,0,0,0,0,0,0
Emily MAGLIO,Canada,Middle Blocker,Women,Poland,2022-06-01,Pool,1,4,7,7,1,3,11,0,4,2,6,0,3,11,14,3,0,1,4,3,1,0,4,0,0,1,1
Sydney GRILLS,Canada,Opposite Spiker,Women,Poland,2022-06-01,Pool,1,4,2,1,0,0,1,0,0,0,0,1,1,2,4,0,0,0,0,1,0,0,1,0,0,0,0
Kiera VAN RYK,Canada,Outside Hitter,Women,Netherlands,2022-07-03,Pool,1,4,22,18,12,18,48,1,3,2,6,3,5,13,21,0,0,0,0,21,2,0,23,0,0,7,7
Julia MURMANN,Canada,Libero,Women,Netherlands,2022-07-03,Pool,1,4,0,0,0,0,0,0,0,0,0,0,0,0,0,0,0,0,0,0,0,0,0,0,0,0,0
Jazmine Ruth WHITE,Canada,Middle Blocker,Women,Netherlands,2022-07-03,Pool,1,4,0,0,0,0,0,0,0,0,0,0,0,0,0,0,0,0,0,0,0,0,0,0,0,0,0
Alicia OGOMS,Canada,Middle Blocker,Women,Netherlands,2022-07-03,Pool,1,4,0,0,0,0,0,0,0,0,0,0,0,0,0,0,0,0,0,0,0,0,0,0,0,0,0
Alexa GRAY,Canada,Outside Hitter,Women,Netherlands,2022-07-03,Pool,1,4,22,21,4,20,45,1,3,0,4,0,0,21,21,15,3,28,46,12,2,0,14,0,0,9,9
Courtney BAKER,Canada,Setter,Women,Netherlands,2022-07-03,Pool,1,4,0,0,0,0,0,0,0,0,0,0,0,0,0,0,0,0,0,0,0,0,0,0,0,0,0
Andrea MITROVIC,Canada,Outside Hitter,Women,Netherlands,2022-07-03,Pool,1,4,4,4,1,3,8,0,1,1,2,0,0,2,2,1,0,1,2,3,0,0,3,0,0,0,0
Jennifer CROSS,Canada,Middle Blocker,Women,Netherlands,2022-07-03,Pool,1,4,9,4,0,5,9,3,4,4,11,2,0,19,21,0,0,0,0,4,0,0,4,0,0,3,3
Brie KING,Canada,Setter,Women,Netherlands,2022-07-03,Pool,1,4,3,1,1,1,3,2,1,1,4,0,0,12,12,0,0,0,0,15,3,0,18,0,2,128,130
Hilary HOWE,Canada,Outside Hitter,Women,Netherlands,2022-07-03,Pool,1,4,7,6,6,15,27,1,3,3,7,0,3,7,10,8,3,15,26,6,0,0,6,0,0,3,3
Caroline LIVINGSTON,Canada,Outside Hitter,Women,Netherlands,2022-07-03,Pool,1,4,0,0,0,0,0,0,0,0,0,0,1,5,6,0,0,0,0,0,0,0,0,0,0,0,0
Emily MAGLIO,Canada,Middle Blocker,Women,Netherlands,2022-07-03,Pool,1,4,12,8,2,7,17,4,7,4,15,0,2,3,5,1,1,0,2,5,1,0,6,0,0,3,3
Arielle PALERMO,Canada,Libero,Women,Netherlands,2022-07-03,Pool,1,4,0,0,0,0,0,0,0,0,0,0,0,0,0,7,0,10,17,14,3,0,17,0,0,14,14
Sydney GRILLS,Canada,Opposite Spiker,Women,Netherlands,2022-07-03,Pool,1,4,0,0,0,0,0,0,0,0,0,0,0,0,0,0,0,0,0,0,0,0,0,0,0,0,0
Kiera VAN RYK,Canada,Outside Hitter,Women,Germany,2022-07-03,Pool,1,4,22,18,8,11,37,1,2,3,6,3,8,3,14,0,0,0,0,9,2,0,11,0,0,7,7
Julia MURMANN,Canada,Libero,Women,Germany,2022-07-03,Pool,1,4,0,0,0,0,0,0,0,0,0,0,0,0,0,1,1,7,9,5,2,0,7,0,0,3,3
Jazmine Ruth WHITE,Canada,Middle Blocker,Women,Germany,2022-07-03,Pool,1,4,0,0,0,0,0,0,0,0,0,0,0,0,0,0,0,0,0,0,0,0,0,0,0,0,0
Alicia OGOMS,Canada,Middle Blocker,Women,Germany,2022-07-03,Pool,1,4,0,0,0,0,0,0,0,0,0,0,0,0,0,0,0,0,0,0,0,0,0,0,0,0,0
Alexa GRAY,Canada,Outside Hitter,Women,Germany,2022-07-03,Pool,1,4,26,26,8,20,54,0,0,0,0,0,1,15,16,6,2,10,18,12,3,0,15,0,0,1,1
Courtney BAKER,Canada,Setter,Women,Germany,2022-07-03,Pool,1,4,0,0,0,0,0,0,0,0,0,0,0,0,0,0,0,0,0,0,0,0,0,0,0,0,0
Andrea MITROVIC,Canada,Outside Hitter,Women,Germany,2022-07-03,Pool,1,4,0,0,0,1,1,0,0,0,0,0,1,3,4,0,0,2,2,1,0,0,1,0,0,0,0
Jennifer CROSS,Canada,Middle Blocker,Women,Germany,2022-07-03,Pool,1,4,12,9,0,2,11,3,4,3,10,0,1,15,16,0,0,0,0,1,1,0,2,0,0,3,3
Brie KING,Canada,Setter,Women,Germany,2022-07-03,Pool,1,4,3,0,0,3,3,3,1,1,5,0,1,15,16,0,0,0,0,5,1,0,6,5,0,116,121
Hilary HOWE,Canada,Outside Hitter,Women,Germany,2022-07-03,Pool,1,4,6,6,2,11,19,0,2,0,2,0,3,10,13,16,1,16,33,17,2,0,19,0,0,2,2
Caroline LIVINGSTON,Canada,Outside Hitter,Women,Germany,2022-07-03,Pool,1,4,0,0,0,0,0,0,0,0,0,0,0,5,5,0,0,0,0,1,1,0,2,0,0,0,0
Emily MAGLIO,Canada,Middle Blocker,Women,Germany,2022-07-03,Pool,1,4,9,5,0,9,14,4,5,4,13,0,2,7,9,1,0,2,3,1,0,0,1,0,0,0,0
Arielle PALERMO,Canada,Libero,Women,Germany,2022-07-03,Pool,1,4,0,0,0,0,0,0,0,0,0,0,0,0,0,9,0,10,19,8,1,0,9,0,0,5,5
Sydney GRILLS,Canada,Opposite Spiker,Women,Germany,2022-07-03,Pool,1,4,0,0,0,0,0,0,0,0,0,0,0,0,0,0,0,0,0,0,0,0,0,0,0,0,0
Kiera VAN RYK,Canada,Outside Hitter,Women,Serbia,2022-07-02,Pool,1,4,18,16,11,20,47,2,2,2,6,0,1,8,9,0,0,0,0,3,0,0,3,0,0,2,2
Julia MURMANN,Canada,Libero,Women,Serbia,2022-07-02,Pool,1,4,0,0,0,0,0,0,0,0,0,0,0,0,0,1,0,4,5,0,0,0,0,0,0,2,2
Jazmine Ruth WHITE,Canada,Middle Blocker,Women,Serbia,2022-07-02,Pool,1,4,0,0,0,0,0,0,0,0,0,0,0,0,0,0,0,0,0,0,0,0,0,0,0,0,0
Alicia OGOMS,Canada,Middle Blocker,Women,Serbia,2022-07-02,Pool,1,4,6,4,0,2,6,2,4,2,8,0,2,8,10,0,0,0,0,0,0,0,0,0,0,0,0
Alexa GRAY,Canada,Outside Hitter,Women,Serbia,2022-07-02,Pool,1,4,4,4,3,10,17,0,0,0,0,0,1,2,3,2,0,4,6,1,0,0,1,0,1,0,1
Courtney BAKER,Canada,Setter,Women,Serbia,2022-07-02,Pool,1,4,0,0,0,0,0,0,0,0,0,0,0,0,0,0,0,0,0,0,0,0,0,0,0,3,3
Andrea MITROVIC,Canada,Outside Hitter,Women,Serbia,2022-07-02,Pool,1,4,6,4,3,6,13,1,1,2,4,1,0,11,12,7,1,10,18,3,0,0,3,0,0,0,0
Jennifer CROSS,Canada,Middle Blocker,Women,Serbia,2022-07-02,Pool,1,4,2,2,0,2,4,0,1,0,1,0,0,8,8,0,0,0,0,0,0,0,0,0,0,0,0
Brie KING,Canada,Setter,Women,Serbia,2022-07-02,Pool,1,4,3,2,1,1,4,1,0,0,1,0,0,13,13,0,0,1,1,0,0,1,1,7,1,69,77
Hilary HOWE,Canada,Outside Hitter,Women,Serbia,2022-07-02,Pool,1,4,11,8,5,20,33,3,1,4,8,0,3,12,15,7,2,35,44,1,0,0,1,0,0,3,3
Caroline LIVINGSTON,Canada,Outside Hitter,Women,Serbia,2022-07-02,Pool,1,4,2,2,0,1,3,0,0,0,0,0,0,2,2,0,0,0,0,0,0,0,0,0,0,0,0
Emily MAGLIO,Canada,Middle Blocker,Women,Serbia,2022-07-02,Pool,1,4,11,7,2,5,14,4,2,3,9,0,0,10,10,1,0,1,2,2,0,0,2,0,0,0,0
Arielle PALERMO,Canada,Libero,Women,Serbia,2022-07-02,Pool,1,4,0,0,0,0,0,0,0,0,0,0,0,0,0,1,0,5,6,1,1,0,2,0,0,3,3
Sydney GRILLS,Canada,Opposite Spiker,Women,Serbia,2022-07-02,Pool,1,4,0,0,0,0,0,0,0,0,0,0,0,0,0,0,0,0,0,0,0,0,0,0,0,0,0
Kiera VAN RYK,Canada,Outside Hitter,Women,Türkiye,2022-06-29,Pool,3,4,21,19,8,14,41,0,4,0,4,2,5,6,13,0,0,0,0,3,1,0,4,0,0,2,2
Julia MURMANN,Canada,Libero,Women,Türkiye,2022-06-29,Pool,3,4,0,0,0,1,1,0,0,0,0,0,0,0,0,7,4,13,24,7,4,1,12,0,0,6,6
Jazmine Ruth WHITE,Canada,Middle Blocker,Women,Türkiye,2022-06-29,Pool,3,4,0,0,0,0,0,0,0,0,0,0,0,0,0,0,0,0,0,0,0,0,0,0,0,0,0
Alicia OGOMS,Canada,Middle Blocker,Women,Türkiye,2022-06-29,Pool,3,4,0,0,0,0,0,0,0,0,0,0,0,0,0,0,0,0,0,0,0,0,0,0,0,0,0
Alexa GRAY,Canada,Outside Hitter,Women,Türkiye,2022-06-29,Pool,3,4,23,19,4,14,37,4,0,2,6,0,1,15,16,7,0,21,28,4,0,0,4,0,0,2,2
Courtney BAKER,Canada,Setter,Women,Türkiye,2022-06-29,Pool,3,4,0,0,0,0,0,0,0,0,0,0,0,0,0,0,0,0,0,0,0,0,0,0,0,0,0
Andrea MITROVIC,Canada,Outside Hitter,Women,Türkiye,2022-06-29,Pool,3,4,0,0,0,0,0,0,0,0,0,0,0,0,0,0,0,0,0,0,0,0,0,0,0,0,0
Jennifer CROSS,Canada,Middle Blocker,Women,Türkiye,2022-06-29,Pool,3,4,5,3,1,4,8,2,4,1,7,0,1,15,16,0,0,0,0,3,1,0,4,0,0,0,0
Brie KING,Canada,Setter,Women,Türkiye,2022-06-29,Pool,3,4,5,1,0,3,4,3,2,0,5,1,0,13,14,0,0,0,0,3,0,0,3,0,3,92,95
Hilary HOWE,Canada,Outside Hitter,Women,Türkiye,2022-06-29,Pool,3,4,14,8,5,5,18,4,1,1,6,2,4,10,16,11,1,21,33,5,0,0,5,0,0,3,3
Caroline LIVINGSTON,Canada,Outside Hitter,Women,Türkiye,2022-06-29,Pool,3,4,1,0,0,0,0,0,0,0,0,1,0,6,7,0,0,0,0,3,0,0,3,0,0,0,0
Emily MAGLIO,Canada,Middle Blocker,Women,Türkiye,2022-06-29,Pool,3,4,7,6,0,7,13,1,3,0,4,0,1,12,13,0,0,0,0,0,0,0,0,0,0,2,2
Arielle PALERMO,Canada,Libero,Women,Türkiye,2022-06-29,Pool,3,4,0,0,0,0,0,0,0,0,0,0,0,0,0,0,0,0,0,0,0,0,0,0,0,0,0
Sydney GRILLS,Canada,Opposite Spiker,Women,Türkiye,2022-06-29,Pool,3,4,0,0,0,0,0,0,0,0,0,0,0,0,0,0,0,0,0,0,0,0,0,0,0,0,0
Kiera VAN RYK,Canada,Outside Hitter,Women,Bulgaria,2022-06-18,Pool,0,3,20,17,6,13,36,0,4,4,8,3,2,8,13,0,0,0,0,8,2,1,11,0,0,2,2
Julia MURMANN,Canada,Libero,Women,Bulgaria,2022-06-18,Pool,0,3,0,0,0,0,0,0,0,0,0,0,0,0,0,4,0,9,13,8,3,0,11,0,0,12,12
Jazmine Ruth WHITE,Canada,Middle Blocker,Women,Bulgaria,2022-06-18,Pool,0,3,0,0,0,0,0,0,0,0,0,0,0,0,0,0,0,0,0,0,0,0,0,0,0,0,0
Alicia OGOMS,Canada,Middle Blocker,Women,Bulgaria,2022-06-18,Pool,0,3,0,0,0,0,0,0,0,0,0,0,0,0,0,0,0,0,0,0,0,0,0,0,0,0,0
Alexa GRAY,Canada,Outside Hitter,Women,Bulgaria,2022-06-18,Pool,0,3,10,8,5,20,33,1,0,5,6,1,0,8,9,6,1,33,40,8,3,0,11,0,1,1,2
Andrea MITROVIC,Canada,Outside Hitter,Women,Bulgaria,2022-06-18,Pool,0,3,0,0,0,0,0,0,0,0,0,0,0,0,0,0,0,0,0,0,0,0,0,0,0,0,0
Jennifer CROSS,Canada,Middle Blocker,Women,Bulgaria,2022-06-18,Pool,0,3,6,5,0,3,8,1,5,3,9,0,0,12,12,0,0,0,0,3,2,0,5,1,0,1,2
Brie KING,Canada,Setter,Women,Bulgaria,2022-06-18,Pool,0,3,2,1,0,4,5,1,8,4,13,0,0,11,11,0,0,0,0,7,3,1,11,14,0,70,84
Hilary HOWE,Canada,Outside Hitter,Women,Bulgaria,2022-06-18,Pool,0,3,7,5,4,3,12,0,0,3,3,2,0,10,12,1,2,9,12,8,1,0,9,0,0,1,1
Caroline LIVINGSTON,Canada,Outside Hitter,Women,Bulgaria,2022-06-18,Pool,0,3,0,0,0,0,0,0,1,0,1,0,2,1,3,2,0,2,4,1,0,0,1,0,0,0,0
Kim ROBITAILLE,Canada,Setter,Women,Bulgaria,2022-06-18,Pool,0,3,0,0,0,0,0,0,0,0,0,0,0,0,0,0,0,0,0,0,0,0,0,0,0,0,0
Emily MAGLIO,Canada,Middle Blocker,Women,Bulgaria,2022-06-18,Pool,0,3,13,9,0,5,14,3,8,2,13,1,1,6,8,0,0,0,0,4,1,0,5,0,0,0,0
Arielle PALERMO,Canada,Libero,Women,Bulgaria,2022-06-18,Pool,0,3,0,0,0,0,0,0,0,0,0,0,0,0,0,0,0,0,0,0,0,0,0,0,0,0,0
Sydney GRILLS,Canada,Opposite Spiker,Women,Bulgaria,2022-06-18,Pool,0,3,0,0,0,0,0,0,0,0,0,0,0,0,0,0,0,0,0,0,0,0,0,0,0,0,0
Kiera VAN RYK,Canada,Outside Hitter,Women,China,2022-06-17,Pool,1,4,14,13,8,14,35,0,0,2,2,1,4,5,10,0,0,2,2,6,1,1,8,1,0,5,6
Julia MURMANN,Canada,Libero,Women,China,2022-06-17,Pool,1,4,0,0,0,0,0,0,0,0,0,0,0,0,0,0,0,0,0,0,0,0,0,0,0,0,0
Jazmine Ruth WHITE,Canada,Middle Blocker,Women,China,2022-06-17,Pool,1,4,1,1,0,0,1,0,0,0,0,0,0,4,4,0,0,0,0,2,0,0,2,1,0,0,1
Alicia OGOMS,Canada,Middle Blocker,Women,China,2022-06-17,Pool,1,4,3,2,1,3,6,1,3,13,17,0,0,10,10,0,0,0,0,1,1,0,2,0,0,3,3
Alexa GRAY,Canada,Outside Hitter,Women,China,2022-06-17,Pool,1,4,0,0,0,0,0,0,0,0,0,0,0,0,0,0,0,0,0,0,0,0,0,0,0,0,0
Andrea MITROVIC,Canada,Outside Hitter,Women,China,2022-06-17,Pool,1,4,4,4,2,4,10,0,0,1,1,0,1,1,2,2,1,3,6,1,1,0,2,0,0,2,2
Jennifer CROSS,Canada,Middle Blocker,Women,China,2022-06-17,Pool,1,4,2,0,2,0,2,1,2,1,4,1,0,3,4,0,0,1,1,1,0,0,1,0,0,0,0
Brie KING,Canada,Setter,Women,China,2022-06-17,Pool,1,4,3,2,1,3,6,0,1,0,1,1,1,9,11,0,0,0,0,8,4,2,14,17,0,55,72
Hilary HOWE,Canada,Outside Hitter,Women,China,2022-06-17,Pool,1,4,11,11,5,14,30,0,1,5,6,0,3,6,9,3,6,26,35,5,1,2,8,0,0,6,6
Caroline LIVINGSTON,Canada,Outside Hitter,Women,China,2022-06-17,Pool,1,4,7,6,3,10,19,0,0,1,1,1,0,9,10,6,1,19,26,9,1,0,10,0,0,2,2
Kim ROBITAILLE,Canada,Setter,Women,China,2022-06-17,Pool,1,4,0,0,0,0,0,0,0,1,1,0,0,1,1,0,0,0,0,1,0,2,3,3,0,16,19
Emily MAGLIO,Canada,Middle Blocker,Women,China,2022-06-17,Pool,1,4,9,7,0,3,10,1,4,0,5,1,2,7,10,0,0,0,0,2,1,0,3,0,0,1,1
Arielle PALERMO,Canada,Libero,Women,China,2022-06-17,Pool,1,4,0,0,0,0,0,0,0,0,0,0,0,0,0,3,1,13,17,14,4,1,19,2,0,6,8
Sydney GRILLS,Canada,Opposite Spiker,Women,China,2022-06-17,Pool,1,4,0,0,0,2,2,0,0,0,0,0,1,0,1,0,0,0,0,0,2,0,2,0,0,0,0
Kiera VAN RYK,Canada,Outside Hitter,Women,Belgium,2022-06-16,Pool,3,4,22,20,9,12,41,0,6,8,14,2,4,8,14,0,0,0,0,11,4,1,16,0,1,16,17
Julia MURMANN,Canada,Libero,Women,Belgium,2022-06-16,Pool,3,4,0,0,0,0,0,0,0,0,0,0,0,0,0,3,0,10,13,7,2,2,11,0,0,8,8
Jazmine Ruth WHITE,Canada,Middle Blocker,Women,Belgium,2022-06-16,Pool,3,4,0,0,0,0,0,0,0,0,0,0,0,0,0,0,0,0,0,0,0,0,0,0,0,0,0
Alicia OGOMS,Canada,Middle Blocker,Women,Belgium,2022-06-16,Pool,3,4,0,0,0,0,0,0,0,0,0,0,0,0,0,0,0,0,0,0,0,0,0,0,0,0,0
Alexa GRAY,Canada,Outside Hitter,Women,Belgium,2022-06-16,Pool,3,4,24,23,4,16,43,1,1,2,4,0,1,14,15,6,0,28,34,10,4,0,14,0,0,2,2
Andrea MITROVIC,Canada,Outside Hitter,Women,Belgium,2022-06-16,Pool,3,4,0,0,0,0,0,0,0,0,0,0,0,1,1,0,2,2,4,0,0,0,0,0,0,0,0
Jennifer CROSS,Canada,Middle Blocker,Women,Belgium,2022-06-16,Pool,3,4,9,3,0,2,5,5,3,7,15,1,1,11,13,0,0,0,0,1,2,0,3,0,0,1,1
Brie KING,Canada,Setter,Women,Belgium,2022-06-16,Pool,3,4,6,4,1,1,6,1,7,3,11,1,0,18,19,0,1,0,1,10,3,1,14,26,0,68,94
Hilary HOWE,Canada,Outside Hitter,Women,Belgium,2022-06-16,Pool,3,4,14,12,5,8,25,2,2,2,6,0,4,6,10,1,2,26,29,9,0,1,10,0,0,0,0
Caroline LIVINGSTON,Canada,Outside Hitter,Women,Belgium,2022-06-16,Pool,3,4,0,0,0,0,0,0,0,0,0,0,0,9,9,0,0,0,0,1,0,0,1,0,0,0,0
Kim ROBITAILLE,Canada,Setter,Women,Belgium,2022-06-16,Pool,3,4,0,0,0,0,0,0,0,0,0,0,0,0,0,0,0,0,0,0,0,0,0,0,0,0,0
Emily MAGLIO,Canada,Middle Blocker,Women,Belgium,2022-06-16,Pool,3,4,9,7,2,3,12,2,1,1,4,0,3,12,15,0,0,3,3,4,0,0,4,0,0,1,1
Arielle PALERMO,Canada,Libero,Women,Belgium,2022-06-16,Pool,3,4,0,0,0,0,0,0,0,0,0,0,0,0,0,0,0,0,0,0,0,0,0,0,0,0,0
Sydney GRILLS,Canada,Opposite Spiker,Women,Belgium,2022-06-16,Pool,3,4,0,0,0,0,0,0,0,0,0,0,0,0,0,0,0,0,0,0,0,0,0,0,0,0,0
Kiera VAN RYK,Canada,Outside Hitter,Women,Thailand,2022-06-14,Pool,0,3,20,17,7,13,37,1,1,3,5,2,3,7,12,0,0,0,0,5,0,2,7,1,0,1,2
Julia MURMANN,Canada,Libero,Women,Thailand,2022-06-14,Pool,0,3,0,0,0,0,0,0,0,0,0,0,0,0,0,2,0,11,13,3,2,1,6,0,0,3,3
Jazmine Ruth WHITE,Canada,Middle Blocker,Women,Thailand,2022-06-14,Pool,0,3,0,0,0,0,0,0,0,0,0,0,0,0,0,0,0,0,0,0,0,0,0,0,0,0,0
Alicia OGOMS,Canada,Middle Blocker,Women,Thailand,2022-06-14,Pool,0,3,0,0,0,0,0,0,1,1,2,0,0,2,2,0,0,0,0,0,0,0,0,0,0,0,0
Alexa GRAY,Canada,Outside Hitter,Women,Thailand,2022-06-14,Pool,0,3,13,12,4,18,34,1,6,2,9,0,0,7,7,5,3,29,37,3,3,0,6,0,0,0,0
Andrea MITROVIC,Canada,Outside Hitter,Women,Thailand,2022-06-14,Pool,0,3,5,4,2,5,11,0,3,0,3,1,3,6,10,3,0,9,12,3,2,0,5,0,0,1,1
Jennifer CROSS,Canada,Middle Blocker,Women,Thailand,2022-06-14,Pool,0,3,5,3,0,4,7,1,1,4,6,1,0,5,6,0,0,0,0,0,0,0,0,0,0,0,0
Brie KING,Canada,Setter,Women,Thailand,2022-06-14,Pool,0,3,1,0,0,1,1,0,3,0,3,1,1,10,12,0,0,0,0,4,6,0,10,27,3,68,98
Hilary HOWE,Canada,Outside Hitter,Women,Thailand,2022-06-14,Pool,0,3,2,0,2,4,6,1,0,0,1,1,0,3,4,1,0,3,4,1,0,0,1,0,0,0,0
Caroline LIVINGSTON,Canada,Outside Hitter,Women,Thailand,2022-06-14,Pool,0,3,0,0,0,0,0,0,0,0,0,0,0,2,2,2,0,2,4,0,0,0,0,0,0,0,0
Kim ROBITAILLE,Canada,Setter,Women,Thailand,2022-06-14,Pool,0,3,0,0,0,0,0,0,0,0,0,0,0,0,0,0,0,0,0,0,0,0,0,0,0,0,0
Emily MAGLIO,Canada,Middle Blocker,Women,Thailand,2022-06-14,Pool,0,3,8,7,0,5,12,1,3,3,7,0,4,6,10,0,0,0,0,0,0,0,0,0,0,0,0
Arielle PALERMO,Canada,Libero,Women,Thailand,2022-06-14,Pool,0,3,0,0,0,0,0,0,0,0,0,0,0,0,0,0,0,0,0,0,0,0,0,0,0,0,0
Sydney GRILLS,Canada,Opposite Spiker,Women,Thailand,2022-06-14,Pool,0,3,0,0,0,0,0,0,0,0,0,0,0,0,0,0,0,0,0,0,0,0,0,0,0,0,0
Xinyue YUAN,China,Middle Blocker,Women,Italy,2022-07-14,Quarterfinals,1,4,9,7,1,7,15,2,3,5,10,0,0,16,16,0,1,2,3,1,0,0,1,0,0,1,1
Linyu DIAO,China,Setter,Women,Italy,2022-07-14,Quarterfinals,1,4,0,0,0,1,1,0,3,5,8,0,0,17,17,0,0,0,0,10,2,2,14,30,0,70,100
Hanyu YANG,China,Middle Blocker,Women,Italy,2022-07-14,Quarterfinals,1,4,0,0,0,0,0,0,0,0,0,0,0,0,0,0,0,0,0,0,0,0,0,0,0,0,0
Yi GAO,China,Middle Blocker,Women,Italy,2022-07-14,Quarterfinals,1,4,0,0,0,0,0,0,0,0,0,0,0,0,0,0,0,0,0,0,0,0,0,0,0,0,0
Xiangyu GONG,China,Opposite Spiker,Women,Italy,2022-07-14,Quarterfinals,1,4,20,18,3,13,34,2,4,3,9,0,0,12,12,4,2,6,12,12,2,1,15,0,0,5,5
Yuanyuan WANG,China,Middle Blocker,Women,Italy,2022-07-14,Quarterfinals,1,4,12,6,0,2,8,5,4,5,14,1,1,10,12,1,0,0,1,4,0,1,5,0,0,5,5
Ye JIN,China,Outside Hitter,Women,Italy,2022-07-14,Quarterfinals,1,4,0,0,0,0,0,0,0,0,0,0,0,1,1,0,0,0,0,0,1,0,1,0,0,0,0
Yunlu WANG,China,Outside Hitter,Women,Italy,2022-07-14,Quarterfinals,1,4,10,9,3,19,31,0,4,1,5,1,3,18,22,10,1,9,20,6,3,0,9,0,0,5,5
Yizhu WANG,China,Outside Hitter,Women,Italy,2022-07-14,Quarterfinals,1,4,0,0,0,0,0,0,0,0,0,0,0,0,0,0,0,0,0,0,0,0,0,0,0,0,0
Yingying LI,China,Outside Hitter,Women,Italy,2022-07-14,Quarterfinals,1,4,16,14,8,13,35,2,8,4,14,0,2,8,10,13,1,11,25,14,2,0,16,0,0,8,8
Weiyi WANG,China,Libero,Women,Italy,2022-07-14,Quarterfinals,1,4,0,0,0,0,0,0,0,0,0,0,0,0,0,2,3,23,28,14,2,2,18,0,0,7,7
Xia DING,China,Setter,Women,Italy,2022-07-14,Quarterfinals,1,4,0,0,0,0,0,0,0,0,0,0,0,0,0,0,0,0,0,0,0,0,0,0,0,3,3
Feifan NI,China,Libero,Women,Italy,2022-07-14,Quarterfinals,1,4,0,0,0,0,0,0,0,0,0,0,0,0,0,0,0,0,0,0,0,0,0,0,0,0,0
Peiyan CHEN,China,Opposite Spiker,Women,Italy,2022-07-14,Quarterfinals,1,4,1,0,0,1,1,1,0,0,1,0,0,0,0,0,0,0,0,0,0,0,0,0,0,0,0
Xinyue YUAN,China,Middle Blocker,Women,Korea,2022-07-03,Pool,3,4,11,9,3,7,19,2,6,9,17,0,2,12,14,1,0,0,1,2,1,1,4,0,0,0,0
Linyu DIAO,China,Setter,Women,Korea,2022-07-03,Pool,3,4,0,0,0,1,1,0,2,4,6,0,0,15,15,0,0,0,0,5,2,2,9,8,0,86,94
Hanyu YANG,China,Middle Blocker,Women,Korea,2022-07-03,Pool,3,4,0,0,0,0,0,0,0,0,0,0,0,0,0,0,0,0,0,0,0,0,0,0,0,0,0
Yi GAO,China,Middle Blocker,Women,Korea,2022-07-03,Pool,3,4,0,0,0,0,0,0,0,0,0,0,0,0,0,0,0,0,0,0,0,0,0,0,0,0,0
Xiangyu GONG,China,Opposite Spiker,Women,Korea,2022-07-03,Pool,3,4,17,13,3,10,26,3,7,2,12,1,0,16,17,1,0,2,3,3,0,2,5,0,0,0,0
Yuanyuan WANG,China,Middle Blocker,Women,Korea,2022-07-03,Pool,3,4,10,8,0,6,14,2,6,3,11,0,2,18,20,0,0,0,0,0,0,2,2,0,0,3,3
Ye JIN,China,Outside Hitter,Women,Korea,2022-07-03,Pool,3,4,6,4,4,4,12,1,2,1,4,1,1,9,11,4,1,9,14,6,0,0,6,0,0,3,3
Yunlu WANG,China,Outside Hitter,Women,Korea,2022-07-03,Pool,3,4,4,3,2,4,9,1,1,0,2,0,2,3,5,4,0,7,11,1,2,1,4,1,0,0,1
Yingying LI,China,Outside Hitter,Women,Korea,2022-07-03,Pool,3,4,23,18,3,16,37,3,4,2,9,2,2,7,11,9,1,17,27,11,3,4,18,0,1,1,2
Yaqian CAI,China,Setter,Women,Korea,2022-07-03,Pool,3,4,0,0,0,0,0,0,0,0,0,0,0,0,0,0,0,0,0,0,0,0,0,0,0,0,0
Weiyi WANG,China,Libero,Women,Korea,2022-07-03,Pool,3,4,0,0,0,0,0,0,0,0,0,0,0,0,0,2,2,9,13,4,2,3,9,0,0,1,1
Xia DING,China,Setter,Women,Korea,2022-07-03,Pool,3,4,0,0,0,0,0,0,0,0,0,0,0,1,1,0,0,0,0,0,1,0,1,1,0,10,11
Feifan NI,China,Libero,Women,Korea,2022-07-03,Pool,3,4,0,0,0,0,0,0,0,0,0,0,0,0,0,1,0,4,5,12,0,5,17,0,1,1,2
Peiyan CHEN,China,Opposite Spiker,Women,Korea,2022-07-03,Pool,3,4,0,0,0,0,0,0,0,0,0,0,0,0,0,0,0,0,0,0,0,0,0,0,0,0,0
Xinyue YUAN,China,Middle Blocker,Women,Dominican Republic,2022-07-01,Pool,3,3,10,7,0,7,14,1,10,4,15,2,0,17,19,0,0,0,0,1,0,3,4,1,0,0,1
Linyu DIAO,China,Setter,Women,Dominican Republic,2022-07-01,Pool,3,3,5,2,0,0,2,3,5,6,14,0,1,7,8,0,0,0,0,5,0,2,7,64,0,0,64
Hanyu YANG,China,Middle Blocker,Women,Dominican Republic,2022-07-01,Pool,3,3,0,0,0,0,0,0,0,0,0,0,0,0,0,0,0,0,0,0,0,0,0,0,0,0,0
Yi GAO,China,Middle Blocker,Women,Dominican Republic,2022-07-01,Pool,3,3,0,0,0,0,0,0,0,0,0,0,0,0,0,0,0,0,0,0,0,0,0,0,0,0,0
Xiangyu GONG,China,Opposite Spiker,Women,Dominican Republic,2022-07-01,Pool,3,3,10,9,2,8,19,0,4,0,4,1,0,10,11,2,2,1,5,6,1,0,7,2,1,0,3
Yuanyuan WANG,China,Middle Blocker,Women,Dominican Republic,2022-07-01,Pool,3,3,7,6,1,3,10,1,4,4,9,0,0,10,10,1,0,2,3,1,0,1,2,4,0,0,4
Ye JIN,China,Outside Hitter,Women,Dominican Republic,2022-07-01,Pool,3,3,7,5,2,7,14,2,0,1,3,0,0,10,10,1,0,8,9,5,1,0,6,0,0,0,0
Yunlu WANG,China,Outside Hitter,Women,Dominican Republic,2022-07-01,Pool,3,3,0,0,0,0,0,0,0,0,0,0,0,0,0,0,0,0,0,0,0,0,0,0,0,0,0
Yingying LI,China,Outside Hitter,Women,Dominican Republic,2022-07-01,Pool,3,3,15,12,5,7,24,1,1,0,2,2,0,14,16,8,0,6,14,3,1,0,4,0,0,0,0
Yaqian CAI,China,Setter,Women,Dominican Republic,2022-07-01,Pool,3,3,0,0,0,0,0,0,0,0,0,0,0,0,0,0,0,0,0,0,0,0,0,0,0,0,0
Weiyi WANG,China,Libero,Women,Dominican Republic,2022-07-01,Pool,3,3,0,0,0,0,0,0,0,0,0,0,0,0,0,2,1,10,13,4,2,2,8,2,0,0,2
Xia DING,China,Setter,Women,Dominican Republic,2022-07-01,Pool,3,3,0,0,0,0,0,0,0,0,0,0,0,0,0,0,0,0,0,0,0,0,0,0,0,0,0
Feifan NI,China,Libero,Women,Dominican Republic,2022-07-01,Pool,3,3,0,0,0,0,0,0,0,0,0,0,0,0,0,0,0,0,0,5,1,0,6,1,0,0,1
Peiyan CHEN,China,Opposite Spiker,Women,Dominican Republic,2022-07-01,Pool,3,3,0,0,0,0,0,0,0,0,0,0,0,0,0,0,0,0,0,0,0,0,0,0,0,0,0
Xinyue YUAN,China,Middle Blocker,Women,Poland,2022-06-30,Pool,3,3,8,5,1,7,13,2,4,2,8,1,0,11,12,0,0,0,0,0,0,0,0,0,0,3,3
Linyu DIAO,China,Setter,Women,Poland,2022-06-30,Pool,3,3,2,1,0,0,1,1,1,1,3,0,2,8,10,0,0,0,0,8,2,3,13,0,2,60,62
Hanyu YANG,China,Middle Blocker,Women,Poland,2022-06-30,Pool,3,3,0,0,0,0,0,0,0,0,0,0,0,0,0,0,0,0,0,0,0,0,0,0,0,0,0
Yi GAO,China,Middle Blocker,Women,Poland,2022-06-30,Pool,3,3,0,0,0,0,0,0,0,0,0,0,0,0,0,0,0,0,0,0,0,0,0,0,0,0,0
Xiangyu GONG,China,Opposite Spiker,Women,Poland,2022-06-30,Pool,3,3,11,9,2,4,15,1,1,1,3,1,1,10,12,5,0,3,8,4,0,1,5,0,0,1,1
Yuanyuan WANG,China,Middle Blocker,Women,Poland,2022-06-30,Pool,3,3,9,6,0,2,8,3,1,2,6,0,1,6,7,0,0,0,0,1,0,1,2,0,0,0,0
Ye JIN,China,Outside Hitter,Women,Poland,2022-06-30,Pool,3,3,8,7,3,9,19,1,1,2,4,0,0,14,14,4,0,5,9,6,1,0,7,0,0,1,1
Yunlu WANG,China,Outside Hitter,Women,Poland,2022-06-30,Pool,3,3,0,0,0,0,0,0,0,0,0,0,0,0,0,0,0,0,0,0,0,0,0,0,0,0,0
Yingying LI,China,Outside Hitter,Women,Poland,2022-06-30,Pool,3,3,15,11,4,9,24,3,1,0,4,1,4,9,14,5,0,5,10,3,2,1,6,0,0,0,0
Yaqian CAI,China,Setter,Women,Poland,2022-06-30,Pool,3,3,0,0,0,0,0,0,0,0,0,0,0,2,2,0,0,0,0,0,0,0,0,0,0,0,0
Weiyi WANG,China,Libero,Women,Poland,2022-06-30,Pool,3,3,0,0,0,0,0,0,0,0,0,0,0,0,0,4,1,10,15,14,2,4,20,0,0,8,8
Xia DING,China,Setter,Women,Poland,2022-06-30,Pool,3,3,0,0,0,0,0,0,0,1,1,0,0,0,0,0,0,0,0,0,0,0,0,0,0,3,3
Feifan NI,China,Libero,Women,Poland,2022-06-30,Pool,3,3,0,0,0,0,0,0,0,0,0,0,0,0,0,0,0,0,0,0,0,0,0,0,0,0,0
Peiyan CHEN,China,Opposite Spiker,Women,Poland,2022-06-30,Pool,3,3,0,0,0,1,1,0,0,0,0,0,0,2,2,0,0,0,0,0,0,0,0,0,0,1,1
Xinyue YUAN,China,Middle Blocker,Women,Brazil,2022-06-28,Pool,2,5,12,10,1,8,19,2,8,1,11,0,1,16,17,0,0,0,0,2,1,0,3,0,0,1,1
Linyu DIAO,China,Setter,Women,Brazil,2022-06-28,Pool,2,5,3,1,0,1,2,1,5,6,12,1,0,20,21,0,0,0,0,7,0,3,10,32,1,69,102
Hanyu YANG,China,Middle Blocker,Women,Brazil,2022-06-28,Pool,2,5,0,0,0,0,0,0,0,0,0,0,0,0,0,0,0,0,0,0,0,0,0,0,0,0,0
Yi GAO,China,Middle Blocker,Women,Brazil,2022-06-28,Pool,2,5,0,0,0,0,0,0,0,0,0,0,0,0,0,0,0,0,0,0,0,0,0,0,0,0,0
Xiangyu GONG,China,Opposite Spiker,Women,Brazil,2022-06-28,Pool,2,5,17,14,6,13,33,2,7,2,11,1,0,14,15,4,0,15,19,9,3,2,14,2,0,11,13
Yuanyuan WANG,China,Middle Blocker,Women,Brazil,2022-06-28,Pool,2,5,15,9,1,1,11,5,3,3,11,1,1,13,15,0,0,1,1,2,0,0,2,1,0,2,3
Ye JIN,China,Outside Hitter,Women,Brazil,2022-06-28,Pool,2,5,2,2,1,7,10,0,2,2,4,0,0,12,12,2,3,12,17,6,1,0,7,0,0,1,1
Yunlu WANG,China,Outside Hitter,Women,Brazil,2022-06-28,Pool,2,5,3,3,2,8,13,0,1,0,1,0,2,5,7,5,0,3,8,5,0,0,5,0,0,3,3
Yingying LI,China,Outside Hitter,Women,Brazil,2022-06-28,Pool,2,5,21,20,11,20,51,1,4,4,9,0,1,13,14,7,0,22,29,7,1,4,12,0,0,3,3
Yaqian CAI,China,Setter,Women,Brazil,2022-06-28,Pool,2,5,0,0,0,0,0,0,0,0,0,0,0,3,3,0,0,0,0,0,1,0,1,0,0,0,0
Weiyi WANG,China,Libero,Women,Brazil,2022-06-28,Pool,2,5,0,0,0,0,0,0,0,0,0,0,0,0,0,4,0,13,17,13,0,1,14,0,0,4,4
Xia DING,China,Setter,Women,Brazil,2022-06-28,Pool,2,5,0,0,0,0,0,0,0,0,0,0,0,0,0,0,0,0,0,1,0,0,1,1,0,2,3
Feifan NI,China,Libero,Women,Brazil,2022-06-28,Pool,2,5,0,0,0,0,0,0,0,0,0,0,0,0,0,0,0,0,0,8,3,1,12,1,0,4,5
Peiyan CHEN,China,Opposite Spiker,Women,Brazil,2022-06-28,Pool,2,5,1,1,0,2,3,0,1,0,1,0,0,0,0,0,0,0,0,0,0,0,0,0,0,0,0
Xinyue YUAN,China,Middle Blocker,Women,Japan,2022-06-19,Pool,1,4,9,5,1,4,10,3,7,6,16,1,1,7,9,0,0,0,0,1,1,0,2,0,0,1,1
Hanyu YANG,China,Middle Blocker,Women,Japan,2022-06-19,Pool,1,4,0,0,0,0,0,0,0,0,0,0,0,0,0,0,0,0,0,0,0,0,0,0,0,0,0
Xiangyu GONG,China,Opposite Spiker,Women,Japan,2022-06-19,Pool,1,4,12,9,4,16,29,1,3,4,8,2,0,17,19,2,1,10,13,5,1,2,8,0,1,5,6
Yuanyuan WANG,China,Middle Blocker,Women,Japan,2022-06-19,Pool,1,4,4,1,3,4,8,3,0,5,8,0,0,8,8,0,0,1,1,2,0,0,2,0,0,1,1
Ye JIN,China,Outside Hitter,Women,Japan,2022-06-19,Pool,1,4,4,4,1,3,8,0,0,0,0,0,1,3,4,1,0,3,4,2,1,0,3,0,0,0,0
Yunlu WANG,China,Outside Hitter,Women,Japan,2022-06-19,Pool,1,4,5,3,3,7,13,1,2,1,4,1,0,7,8,6,4,15,25,3,2,1,6,1,0,3,4
Yingying LI,China,Outside Hitter,Women,Japan,2022-06-19,Pool,1,4,27,25,7,16,48,2,4,1,7,0,3,10,13,10,1,14,25,12,4,1,17,0,0,3,3
Yixin ZHENG,China,Middle Blocker,Women,Japan,2022-06-19,Pool,1,4,0,0,1,1,2,0,4,1,5,0,0,3,3,0,0,0,0,1,1,0,2,0,0,1,1
Weiyi WANG,China,Libero,Women,Japan,2022-06-19,Pool,1,4,0,0,0,0,0,0,0,0,0,0,0,0,0,4,0,3,7,7,1,0,8,0,0,5,5
Xia DING,China,Setter,Women,Japan,2022-06-19,Pool,1,4,2,0,3,1,4,2,2,4,8,0,0,13,13,0,0,0,0,7,0,1,8,32,3,60,95
Feifan NI,China,Libero,Women,Japan,2022-06-19,Pool,1,4,0,0,0,0,0,0,0,0,0,0,0,0,0,3,1,6,10,15,0,1,16,0,0,7,7
Peiyan CHEN,China,Opposite Spiker,Women,Japan,2022-06-19,Pool,1,4,0,0,0,0,0,0,0,0,0,0,0,0,0,0,0,0,0,0,0,0,0,0,0,0,0
Xinyue YUAN,China,Middle Blocker,Women,United States,2022-06-18,Pool,0,3,5,3,0,7,10,1,5,5,11,1,0,8,9,0,0,0,0,2,0,1,3,0,1,1,2
Hanyu YANG,China,Middle Blocker,Women,United States,2022-06-18,Pool,0,3,4,2,0,5,7,1,2,1,4,1,1,3,5,0,0,0,0,0,0,0,0,0,0,1,1
Xiangyu GONG,China,Opposite Spiker,Women,United States,2022-06-18,Pool,0,3,11,9,3,6,18,2,3,1,6,0,1,11,12,4,0,1,5,8,3,1,12,0,0,3,3
Yuanyuan WANG,China,Middle Blocker,Women,United States,2022-06-18,Pool,0,3,2,2,0,1,3,0,4,1,5,0,0,7,7,0,1,0,1,2,0,0,2,0,0,0,0
Ye JIN,China,Outside Hitter,Women,United States,2022-06-18,Pool,0,3,7,7,2,4,13,0,2,1,3,0,0,12,12,1,1,8,10,3,2,0,5,0,0,2,2
Yunlu WANG,China,Outside Hitter,Women,United States,2022-06-18,Pool,0,3,0,0,0,3,3,0,0,0,0,0,0,0,0,0,0,0,0,0,0,0,0,0,0,0,0
Yingying LI,China,Outside Hitter,Women,United States,2022-06-18,Pool,0,3,13,12,4,5,21,1,2,3,6,0,2,7,9,7,2,6,15,6,2,0,8,0,1,0,1
Yixin ZHENG,China,Middle Blocker,Women,United States,2022-06-18,Pool,0,3,0,0,0,0,0,0,0,0,0,0,0,0,0,0,0,0,0,0,0,0,0,0,0,0,0
Weiyi WANG,China,Libero,Women,United States,2022-06-18,Pool,0,3,0,0,0,0,0,0,0,0,0,0,0,0,0,5,4,22,31,6,2,0,8,0,0,1,1
Xia DING,China,Setter,Women,United States,2022-06-18,Pool,0,3,1,0,0,0,0,0,6,4,10,1,1,11,13,0,0,0,0,3,1,0,4,16,1,50,67
Feifan NI,China,Libero,Women,United States,2022-06-18,Pool,0,3,0,0,0,0,0,0,0,0,0,0,0,0,0,0,0,0,0,0,0,0,0,0,0,0,0
Peiyan CHEN,China,Opposite Spiker,Women,United States,2022-06-18,Pool,0,3,0,0,0,0,0,0,0,0,0,0,0,0,0,0,0,0,0,0,0,0,0,0,0,0,0
Xinyue YUAN,China,Middle Blocker,Women,Canada,2022-06-17,Pool,3,4,8,4,1,10,15,3,6,7,16,1,0,16,17,0,0,0,0,3,1,0,4,1,0,1,2
Hanyu YANG,China,Middle Blocker,Women,Canada,2022-06-17,Pool,3,4,2,2,0,0,2,0,0,2,2,0,0,1,1,0,0,0,0,0,0,0,0,0,0,2,2
Xiangyu GONG,China,Opposite Spiker,Women,Canada,2022-06-17,Pool,3,4,15,13,1,17,31,1,2,1,4,1,2,11,14,3,0,7,10,17,2,0,19,0,0,5,5
Yuanyuan WANG,China,Middle Blocker,Women,Canada,2022-06-17,Pool,3,4,12,7,2,4,13,4,3,6,13,1,1,12,14,1,0,1,2,4,0,0,4,0,0,0,0
Ye JIN,China,Outside Hitter,Women,Canada,2022-06-17,Pool,3,4,3,2,0,4,6,0,1,0,1,1,0,4,5,1,0,2,3,2,0,0,2,0,0,1,1
Yunlu WANG,China,Outside Hitter,Women,Canada,2022-06-17,Pool,3,4,7,4,1,16,21,1,0,0,1,2,2,12,16,2,1,8,11,6,0,0,6,0,0,4,4
Yingying LI,China,Outside Hitter,Women,Canada,2022-06-17,Pool,3,4,20,17,8,7,32,0,0,2,2,3,0,15,18,5,1,8,14,8,3,1,12,0,0,3,3
Yixin ZHENG,China,Middle Blocker,Women,Canada,2022-06-17,Pool,3,4,0,0,0,0,0,0,0,0,0,0,0,0,0,0,0,0,0,0,0,0,0,0,0,0,0
Weiyi WANG,China,Libero,Women,Canada,2022-06-17,Pool,3,4,0,0,0,0,0,0,0,0,0,0,0,0,0,2,2,6,10,4,1,0,5,0,0,4,4
Xia DING,China,Setter,Women,Canada,2022-06-17,Pool,3,4,2,1,0,1,2,1,2,2,5,0,0,7,7,0,0,1,1,8,2,2,12,23,0,70,93
Feifan NI,China,Libero,Women,Canada,2022-06-17,Pool,3,4,0,0,0,0,0,0,0,0,0,0,0,0,0,1,1,7,9,13,2,0,15,0,0,5,5
Peiyan CHEN,China,Opposite Spiker,Women,Canada,2022-06-17,Pool,3,4,0,0,0,0,0,0,0,0,0,0,0,0,0,0,0,0,0,0,0,0,0,0,0,0,0
Xinyue YUAN,China,Middle Blocker,Women,Belgium,2022-06-15,Pool,3,3,6,5,0,4,9,1,2,5,8,0,0,9,9,0,0,0,0,1,0,0,1,0,0,1,1
Linyu DIAO,China,Setter,Women,Belgium,2022-06-15,Pool,3,3,0,0,0,0,0,0,0,0,0,0,0,0,0,0,0,0,0,0,0,0,0,0,0,0,0
Hanyu YANG,China,Middle Blocker,Women,Belgium,2022-06-15,Pool,3,3,0,0,0,0,0,0,0,0,0,0,0,0,0,0,0,0,0,0,0,0,0,0,0,0,0
Xiangyu GONG,China,Opposite Spiker,Women,Belgium,2022-06-15,Pool,3,3,18,15,0,7,22,3,1,2,6,0,0,16,16,2,0,0,2,7,2,0,9,0,0,0,0
Yuanyuan WANG,China,Middle Blocker,Women,Belgium,2022-06-15,Pool,3,3,9,7,1,1,9,1,5,5,11,1,1,11,13,0,0,0,0,2,2,0,4,0,0,1,1
Ye JIN,China,Outside Hitter,Women,Belgium,2022-06-15,Pool,3,3,8,7,0,9,16,1,3,2,6,0,0,13,13,8,1,11,20,7,3,0,10,0,0,1,1
Yunlu WANG,China,Outside Hitter,Women,Belgium,2022-06-15,Pool,3,3,3,2,1,4,7,1,2,1,4,0,0,2,2,0,0,5,5,4,0,0,4,0,0,0,0
Yizhu WANG,China,Outside Hitter,Women,Belgium,2022-06-15,Pool,3,3,0,0,0,0,0,0,0,0,0,0,0,0,0,0,0,0,0,0,0,0,0,0,0,0,0
Yingying LI,China,Outside Hitter,Women,Belgium,2022-06-15,Pool,3,3,9,8,2,8,18,1,5,0,6,0,1,4,5,1,0,8,9,3,2,2,7,0,0,0,0
Yixin ZHENG,China,Middle Blocker,Women,Belgium,2022-06-15,Pool,3,3,0,0,0,0,0,0,0,0,0,0,0,0,0,0,0,0,0,0,0,0,0,0,0,0,0
Weiyi WANG,China,Libero,Women,Belgium,2022-06-15,Pool,3,3,0,0,0,0,0,0,0,0,0,0,0,0,0,1,1,12,14,4,1,1,6,0,0,5,5
Xia DING,China,Setter,Women,Belgium,2022-06-15,Pool,3,3,4,1,0,1,2,2,0,3,5,1,2,13,16,0,0,0,0,6,3,2,11,27,1,45,73
Feifan NI,China,Libero,Women,Belgium,2022-06-15,Pool,3,3,0,0,0,0,0,0,0,0,0,0,0,0,0,0,0,0,0,0,0,0,0,0,0,0,0
Peiyan CHEN,China,Opposite Spiker,Women,Belgium,2022-06-15,Pool,3,3,0,0,0,0,0,0,0,0,0,0,0,0,0,0,0,0,0,0,0,0,0,0,0,0,0
Xinyue YUAN,China,Middle Blocker,Women,Thailand,2022-06-05,Pool,2,5,11,6,1,10,17,2,9,9,20,3,1,14,18,0,0,0,0,4,0,3,7,1,0,2,3
Linyu DIAO,China,Setter,Women,Thailand,2022-06-05,Pool,2,5,1,1,2,0,3,0,1,1,2,0,0,6,6,0,0,0,0,5,0,1,6,26,0,22,48
Hanyu YANG,China,Middle Blocker,Women,Thailand,2022-06-05,Pool,2,5,0,0,0,0,0,0,0,0,0,0,0,0,0,0,0,0,0,0,0,0,0,0,0,0,0
Xiangyu GONG,China,Opposite Spiker,Women,Thailand,2022-06-05,Pool,2,5,20,18,3,17,38,1,1,5,7,1,0,18,19,7,1,8,16,12,1,1,14,1,0,4,5
Yuanyuan WANG,China,Middle Blocker,Women,Thailand,2022-06-05,Pool,2,5,10,9,2,6,17,1,6,6,13,0,0,18,18,0,0,0,0,4,4,3,11,0,0,2,2
Ye JIN,China,Outside Hitter,Women,Thailand,2022-06-05,Pool,2,5,1,1,2,1,4,0,1,0,1,0,0,3,3,0,0,5,5,4,0,0,4,0,0,0,0
Yunlu WANG,China,Outside Hitter,Women,Thailand,2022-06-05,Pool,2,5,11,7,3,7,17,2,4,2,8,2,1,12,15,9,1,20,30,9,3,0,12,1,0,2,3
Yizhu WANG,China,Outside Hitter,Women,Thailand,2022-06-05,Pool,2,5,0,0,0,0,0,0,0,0,0,0,0,2,2,0,0,0,0,1,0,0,1,0,0,0,0
Yingying LI,China,Outside Hitter,Women,Thailand,2022-06-05,Pool,2,5,27,26,6,22,54,0,6,3,9,1,1,16,18,4,0,6,10,14,3,3,20,1,0,2,3
Yixin ZHENG,China,Middle Blocker,Women,Thailand,2022-06-05,Pool,2,5,0,0,0,0,0,0,0,0,0,0,0,0,0,0,0,0,0,0,0,0,0,0,0,0,0
Weiyi WANG,China,Libero,Women,Thailand,2022-06-05,Pool,2,5,0,0,0,0,0,0,0,0,0,0,0,0,0,3,0,13,16,5,2,2,9,1,0,3,4
Xia DING,China,Setter,Women,Thailand,2022-06-05,Pool,2,5,2,2,1,2,5,0,1,3,4,0,0,8,8,0,0,0,0,1,2,2,5,39,0,34,73
Feifan NI,China,Libero,Women,Thailand,2022-06-05,Pool,2,5,0,0,0,0,0,0,0,0,0,0,0,0,0,0,0,0,0,10,0,0,10,1,0,2,3
Yiwen MIAO,China,Opposite Spiker,Women,Thailand,2022-06-05,Pool,2,5,0,0,1,0,1,0,0,0,0,0,0,1,1,0,0,1,1,0,0,0,0,0,0,0,0
Xinyue YUAN,China,Middle Blocker,Women,Italy,2022-06-04,Pool,3,4,10,6,0,5,11,4,11,4,19,0,1,11,12,0,0,0,0,2,0,0,2,1,0,0,1
Linyu DIAO,China,Setter,Women,Italy,2022-06-04,Pool,3,4,1,1,0,0,1,0,2,0,2,0,0,6,6,0,0,1,1,3,5,0,8,25,0,12,37
Hanyu YANG,China,Middle Blocker,Women,Italy,2022-06-04,Pool,3,4,0,0,0,0,0,0,0,0,0,0,0,0,0,0,0,0,0,0,0,0,0,0,0,0,0
Xiangyu GONG,China,Opposite Spiker,Women,Italy,2022-06-04,Pool,3,4,16,13,4,7,24,2,3,1,6,1,0,9,10,6,0,13,19,9,1,0,10,0,0,1,1
Yuanyuan WANG,China,Middle Blocker,Women,Italy,2022-06-04,Pool,3,4,6,4,1,6,11,2,5,12,19,0,0,13,13,0,0,0,0,2,0,1,3,0,0,3,3
Ye JIN,China,Outside Hitter,Women,Italy,2022-06-04,Pool,3,4,6,4,0,7,11,2,1,1,4,0,1,11,12,0,1,6,7,3,0,0,3,0,0,2,2
Yunlu WANG,China,Outside Hitter,Women,Italy,2022-06-04,Pool,3,4,5,4,2,8,14,1,1,0,2,0,0,10,10,3,0,7,10,6,2,1,9,0,0,1,1
Yizhu WANG,China,Outside Hitter,Women,Italy,2022-06-04,Pool,3,4,0,0,0,0,0,0,0,0,0,0,0,0,0,0,0,0,0,0,0,0,0,0,0,0,0
Yingying LI,China,Outside Hitter,Women,Italy,2022-06-04,Pool,3,4,21,15,3,14,32,3,0,4,7,3,3,15,21,1,1,17,19,7,3,2,12,0,0,0,0
Yixin ZHENG,China,Middle Blocker,Women,Italy,2022-06-04,Pool,3,4,0,0,0,0,0,0,0,0,0,0,0,0,0,0,0,0,0,0,0,0,0,0,0,0,0
Weiyi WANG,China,Libero,Women,Italy,2022-06-04,Pool,3,4,0,0,0,0,0,0,0,0,0,0,0,0,0,3,2,7,12,4,3,6,13,0,0,3,3
Xia DING,China,Setter,Women,Italy,2022-06-04,Pool,3,4,2,1,0,2,3,0,0,3,3,1,0,9,10,0,0,0,0,4,2,2,8,36,0,17,53
Feifan NI,China,Libero,Women,Italy,2022-06-04,Pool,3,4,0,0,0,0,0,0,0,0,0,0,0,0,0,0,0,0,0,2,0,1,3,0,0,2,2
Yiwen MIAO,China,Opposite Spiker,Women,Italy,2022-06-04,Pool,3,4,0,0,0,0,0,0,0,0,0,0,0,0,0,0,0,0,0,0,0,0,0,0,0,0,0
Xinyue YUAN,China,Middle Blocker,Women,Türkiye,2022-06-03,Pool,3,4,11,7,2,6,15,3,3,6,12,1,2,13,16,0,0,1,1,2,0,1,3,0,0,1,1
Linyu DIAO,China,Setter,Women,Türkiye,2022-06-03,Pool,3,4,6,3,0,0,3,2,3,1,6,1,1,15,17,0,0,1,1,1,2,0,3,48,0,39,87
Hanyu YANG,China,Middle Blocker,Women,Türkiye,2022-06-03,Pool,3,4,0,0,0,0,0,0,0,0,0,0,0,0,0,0,0,0,0,0,0,0,0,0,0,0,0
Xiangyu GONG,China,Opposite Spiker,Women,Türkiye,2022-06-03,Pool,3,4,12,12,6,6,24,0,1,2,3,0,1,20,21,8,1,2,11,12,1,5,18,0,0,6,6
Yuanyuan WANG,China,Middle Blocker,Women,Türkiye,2022-06-03,Pool,3,4,8,5,3,5,13,3,3,5,11,0,1,10,11,1,0,3,4,2,0,0,2,0,0,2,2
Ye JIN,China,Outside Hitter,Women,Türkiye,2022-06-03,Pool,3,4,6,6,5,4,15,0,1,3,4,0,1,8,9,4,0,9,13,6,1,1,8,0,0,2,2
Yunlu WANG,China,Outside Hitter,Women,Türkiye,2022-06-03,Pool,3,4,1,1,0,0,1,0,0,1,1,0,1,3,4,3,0,6,9,1,2,0,3,0,0,0,0
Yizhu WANG,China,Outside Hitter,Women,Türkiye,2022-06-03,Pool,3,4,0,0,0,0,0,0,0,0,0,0,0,2,2,0,0,0,0,0,0,0,0,0,0,0,0
Yingying LI,China,Outside Hitter,Women,Türkiye,2022-06-03,Pool,3,4,22,20,2,15,37,1,6,1,8,1,2,11,14,7,1,12,20,7,4,4,15,0,0,0,0
Yixin ZHENG,China,Middle Blocker,Women,Türkiye,2022-06-03,Pool,3,4,0,0,0,0,0,0,0,0,0,0,0,0,0,0,0,0,0,0,0,0,0,0,0,0,0
Weiyi WANG,China,Libero,Women,Türkiye,2022-06-03,Pool,3,4,0,0,0,0,0,0,0,0,0,0,0,0,0,3,0,8,11,10,2,1,13,0,0,4,4
Xia DING,China,Setter,Women,Türkiye,2022-06-03,Pool,3,4,0,0,0,0,0,0,0,0,0,0,0,0,0,0,0,0,0,0,0,0,0,0,0,0,0
Feifan NI,China,Libero,Women,Türkiye,2022-06-03,Pool,3,4,0,0,0,0,0,0,0,0,0,0,0,0,0,0,0,0,0,0,0,0,0,0,0,0,0
Yiwen MIAO,China,Opposite Spiker,Women,Türkiye,2022-06-03,Pool,3,4,0,0,0,0,0,0,0,0,0,0,0,0,0,0,0,0,0,0,0,0,0,0,0,0,0
Xinyue YUAN,China,Middle Blocker,Women,Netherlands,2022-06-01,Pool,3,4,11,7,1,3,11,4,7,10,21,0,0,13,13,0,0,0,0,1,1,2,4,0,0,3,3
Linyu DIAO,China,Setter,Women,Netherlands,2022-06-01,Pool,3,4,6,1,0,2,3,3,3,5,11,2,0,12,14,0,0,0,0,6,5,7,18,22,1,71,94
Hanyu YANG,China,Middle Blocker,Women,Netherlands,2022-06-01,Pool,3,4,0,0,0,0,0,0,0,0,0,0,0,0,0,0,0,0,0,0,0,0,0,0,0,0,0
Xiangyu GONG,China,Opposite Spiker,Women,Netherlands,2022-06-01,Pool,3,4,20,19,1,17,37,0,5,2,7,1,0,13,14,4,1,16,21,6,3,6,15,0,1,5,6
Yuanyuan WANG,China,Middle Blocker,Women,Netherlands,2022-06-01,Pool,3,4,21,18,4,7,29,3,6,9,18,0,2,6,8,0,0,0,0,1,0,3,4,0,0,6,6
Ye JIN,China,Outside Hitter,Women,Netherlands,2022-06-01,Pool,3,4,1,1,2,4,7,0,1,0,1,0,0,2,2,0,0,5,5,0,1,1,2,0,0,0,0
Yunlu WANG,China,Outside Hitter,Women,Netherlands,2022-06-01,Pool,3,4,4,3,4,7,14,1,0,2,3,0,0,18,18,9,0,25,34,7,4,5,16,0,0,2,2
Yizhu WANG,China,Outside Hitter,Women,Netherlands,2022-06-01,Pool,3,4,0,0,0,0,0,0,0,0,0,0,1,2,3,0,0,0,0,0,0,0,0,0,0,0,0
Yingying LI,China,Outside Hitter,Women,Netherlands,2022-06-01,Pool,3,4,19,19,3,23,45,0,5,4,9,0,1,13,14,5,0,11,16,6,6,5,17,0,1,1,2
Yixin ZHENG,China,Middle Blocker,Women,Netherlands,2022-06-01,Pool,3,4,0,0,0,0,0,0,0,0,0,0,0,0,0,0,0,0,0,0,0,0,0,0,0,0,0
Weiyi WANG,China,Libero,Women,Netherlands,2022-06-01,Pool,3,4,0,0,0,0,0,0,0,0,0,0,0,0,0,3,0,12,15,14,5,2,21,0,0,12,12
Xia DING,China,Setter,Women,Netherlands,2022-06-01,Pool,3,4,0,0,0,0,0,0,0,1,1,0,0,4,4,0,0,0,0,0,1,0,1,0,0,18,18
Feifan NI,China,Libero,Women,Netherlands,2022-06-01,Pool,3,4,0,0,0,0,0,0,0,0,0,0,0,0,0,0,0,0,0,0,0,0,0,0,0,0,0
Yiwen MIAO,China,Opposite Spiker,Women,Netherlands,2022-06-01,Pool,3,4,0,0,0,0,0,0,0,0,0,0,0,0,0,0,0,0,0,0,0,0,0,0,0,0,0
Yaneirys RODRIGUEZ DURAN,Dominican Republic,Libero,Women,Germany,2022-06-19,Pool,3,4,0,0,0,0,0,0,0,0,0,0,0,0,0,7,2,15,24,9,5,2,16,0,1,12,13
Esthefany RABIT,Dominican Republic,Libero,Women,Germany,2022-06-19,Pool,3,4,0,0,0,0,0,0,0,0,0,0,0,0,0,0,0,0,0,0,0,0,0,0,0,0,0
Vielka Michelle PERALTA LUNA,Dominican Republic,Outside Hitter,Women,Germany,2022-06-19,Pool,3,4,0,0,0,3,3,0,0,1,1,0,0,1,1,1,0,1,2,0,0,0,0,0,0,0,0
Camil Inmaculada DOMINGUEZ MARTINEZ,Dominican Republic,Setter,Women,Germany,2022-06-19,Pool,3,4,0,0,0,0,0,0,0,0,0,0,0,0,0,0,0,0,0,0,0,0,0,1,0,5,6
Niverka Dharlenis MARTE FRICA,Dominican Republic,Setter,Women,Germany,2022-06-19,Pool,3,4,0,0,1,2,3,0,2,1,3,0,2,10,12,0,0,0,0,5,2,1,8,18,1,78,97
Angelica Maria HINOJOSA DIAZ,Dominican Republic,Middle Blocker,Women,Germany,2022-06-19,Pool,3,4,1,1,0,0,1,0,1,0,1,0,0,1,1,0,0,0,0,1,0,0,1,0,0,0,0
Madeline Jazmin GUILLEN PAREDES,Dominican Republic,Outside Hitter,Women,Germany,2022-06-19,Pool,3,4,0,0,1,0,1,0,0,0,0,0,0,3,3,0,1,1,2,0,0,0,0,0,0,0,0
Yonkaira Paola PEÑA ISABEL,Dominican Republic,Outside Hitter,Women,Germany,2022-06-19,Pool,3,4,18,16,8,11,35,2,1,4,7,0,2,14,16,3,0,13,16,10,0,2,12,0,0,2,2
Gina Altagracia MAMBRU CASILLA,Dominican Republic,Opposite Spiker,Women,Germany,2022-06-19,Pool,3,4,0,0,0,2,2,0,1,1,2,0,0,1,1,0,0,0,0,0,0,0,0,0,0,0,0
Brayelin Elizabeth MARTINEZ,Dominican Republic,Outside Hitter,Women,Germany,2022-06-19,Pool,3,4,9,9,4,18,31,0,1,5,6,0,3,6,9,8,2,18,28,5,2,1,8,0,0,3,3
Jineiry MARTINEZ,Dominican Republic,Middle Blocker,Women,Germany,2022-06-19,Pool,3,4,16,8,1,8,17,8,4,10,22,0,2,14,16,0,0,0,0,1,1,0,2,0,0,1,1
Gaila Ceneida GONZALEZ LOPEZ,Dominican Republic,Opposite Spiker,Women,Germany,2022-06-19,Pool,3,4,17,15,2,9,26,1,1,4,6,1,3,11,15,2,1,4,7,6,5,0,11,0,0,1,1
Geraldine Sthefany GONZALEZ,Dominican Republic,Middle Blocker,Women,Germany,2022-06-19,Pool,3,4,2,2,1,0,3,0,0,5,5,0,2,9,11,0,0,2,2,1,1,0,2,0,1,2,3
Larysmer MARTINEZ CARO,Dominican Republic,Libero,Women,Germany,2022-06-19,Pool,3,4,0,0,0,0,0,0,0,0,0,0,0,2,2,0,0,4,4,0,0,0,0,0,0,0,0
Yaneirys RODRIGUEZ DURAN,Dominican Republic,Libero,Women,Netherlands,2022-06-18,Pool,3,5,0,0,0,0,0,0,0,0,0,0,0,0,0,7,2,9,18,7,11,2,20,0,0,13,13
Esthefany RABIT,Dominican Republic,Libero,Women,Netherlands,2022-06-18,Pool,3,5,0,0,0,0,0,0,0,0,0,0,0,0,0,0,0,0,0,0,0,0,0,0,0,0,0
Vielka Michelle PERALTA LUNA,Dominican Republic,Outside Hitter,Women,Netherlands,2022-06-18,Pool,3,5,1,1,0,0,1,0,0,1,1,0,1,4,5,1,0,2,3,0,1,0,1,0,0,0,0
Camil Inmaculada DOMINGUEZ MARTINEZ,Dominican Republic,Setter,Women,Netherlands,2022-06-18,Pool,3,5,0,0,0,0,0,0,0,0,0,0,0,0,0,0,0,0,0,0,0,1,1,2,0,8,10
Niverka Dharlenis MARTE FRICA,Dominican Republic,Setter,Women,Netherlands,2022-06-18,Pool,3,5,5,3,0,2,5,1,3,3,7,1,0,17,18,0,0,0,0,7,3,2,12,33,0,86,119
Angelica Maria HINOJOSA DIAZ,Dominican Republic,Middle Blocker,Women,Netherlands,2022-06-18,Pool,3,5,0,0,0,0,0,0,0,0,0,0,0,0,0,0,0,0,0,1,1,0,2,0,0,1,1
Madeline Jazmin GUILLEN PAREDES,Dominican Republic,Outside Hitter,Women,Netherlands,2022-06-18,Pool,3,5,10,10,1,5,16,0,0,2,2,0,1,15,16,4,0,6,10,7,1,2,10,0,0,0,0
Yonkaira Paola PEÑA ISABEL,Dominican Republic,Outside Hitter,Women,Netherlands,2022-06-18,Pool,3,5,14,14,5,17,36,0,3,3,6,0,0,20,20,7,0,25,32,11,3,1,15,0,0,6,6
Gina Altagracia MAMBRU CASILLA,Dominican Republic,Opposite Spiker,Women,Netherlands,2022-06-18,Pool,3,5,0,0,0,0,0,0,0,0,0,0,0,0,0,0,0,0,0,0,0,0,0,0,0,0,0
Brayelin Elizabeth MARTINEZ,Dominican Republic,Outside Hitter,Women,Netherlands,2022-06-18,Pool,3,5,23,21,3,25,49,1,1,8,10,1,1,8,10,2,0,23,25,10,5,4,19,0,1,4,5
Jineiry MARTINEZ,Dominican Republic,Middle Blocker,Women,Netherlands,2022-06-18,Pool,3,5,12,9,1,8,18,2,5,5,12,1,3,14,18,0,0,1,1,3,0,2,5,0,0,3,3
Gaila Ceneida GONZALEZ LOPEZ,Dominican Republic,Opposite Spiker,Women,Netherlands,2022-06-18,Pool,3,5,10,8,5,10,23,2,4,2,8,0,1,4,5,1,0,0,1,5,2,1,8,0,0,1,1
Geraldine Sthefany GONZALEZ,Dominican Republic,Middle Blocker,Women,Netherlands,2022-06-18,Pool,3,5,5,3,3,4,10,2,2,6,10,0,2,8,10,0,0,0,0,0,1,3,4,0,0,1,1
Larysmer MARTINEZ CARO,Dominican Republic,Libero,Women,Netherlands,2022-06-18,Pool,3,5,0,0,0,0,0,0,0,0,0,0,0,0,0,0,0,0,0,0,0,0,0,0,0,0,0
Yaneirys RODRIGUEZ DURAN,Dominican Republic,Libero,Women,Italy,2022-06-16,Pool,2,5,0,0,0,0,0,0,0,0,0,0,0,0,0,9,0,9,18,10,4,1,15,0,0,13,13
Esthefany RABIT,Dominican Republic,Libero,Women,Italy,2022-06-16,Pool,2,5,0,0,0,0,0,0,0,0,0,0,0,0,0,0,0,0,0,0,0,0,0,0,0,0,0
Vielka Michelle PERALTA LUNA,Dominican Republic,Outside Hitter,Women,Italy,2022-06-16,Pool,2,5,3,3,0,1,4,0,1,1,2,0,0,1,1,1,0,2,3,1,0,1,2,0,0,0,0
Camil Inmaculada DOMINGUEZ MARTINEZ,Dominican Republic,Setter,Women,Italy,2022-06-16,Pool,2,5,0,0,1,0,1,0,0,0,0,0,0,2,2,0,0,0,0,0,0,0,0,0,0,6,6
Niverka Dharlenis MARTE FRICA,Dominican Republic,Setter,Women,Italy,2022-06-16,Pool,2,5,3,1,1,3,5,0,5,4,9,2,1,13,16,0,0,0,0,6,1,1,8,22,0,84,106
Angelica Maria HINOJOSA DIAZ,Dominican Republic,Middle Blocker,Women,Italy,2022-06-16,Pool,2,5,0,0,0,0,0,0,1,0,1,0,0,0,0,0,0,0,0,0,0,0,0,0,0,1,1
Madeline Jazmin GUILLEN PAREDES,Dominican Republic,Outside Hitter,Women,Italy,2022-06-16,Pool,2,5,0,0,0,0,0,0,0,0,0,0,1,7,8,0,0,0,0,0,1,0,1,0,0,0,0
Yonkaira Paola PEÑA ISABEL,Dominican Republic,Outside Hitter,Women,Italy,2022-06-16,Pool,2,5,20,19,9,15,43,1,1,3,5,0,4,13,17,22,1,18,41,4,1,2,7,0,0,5,5
Gina Altagracia MAMBRU CASILLA,Dominican Republic,Opposite Spiker,Women,Italy,2022-06-16,Pool,2,5,1,1,0,0,1,0,1,0,1,0,1,0,1,0,0,0,0,1,0,0,1,0,0,3,3
Brayelin Elizabeth MARTINEZ,Dominican Republic,Outside Hitter,Women,Italy,2022-06-16,Pool,2,5,17,15,3,18,36,2,1,6,9,0,3,10,13,6,0,18,24,9,0,4,13,0,0,5,5
Jineiry MARTINEZ,Dominican Republic,Middle Blocker,Women,Italy,2022-06-16,Pool,2,5,11,7,1,5,13,2,4,4,10,2,0,16,18,0,0,0,0,1,0,0,1,0,0,0,0
Gaila Ceneida GONZALEZ LOPEZ,Dominican Republic,Opposite Spiker,Women,Italy,2022-06-16,Pool,2,5,16,13,9,11,33,3,1,2,6,0,3,11,14,1,0,0,1,4,2,1,7,0,0,1,1
Geraldine Sthefany GONZALEZ,Dominican Republic,Middle Blocker,Women,Italy,2022-06-16,Pool,2,5,8,5,1,0,6,3,3,3,9,0,3,11,14,0,1,1,2,1,0,0,1,0,0,4,4
Larysmer MARTINEZ CARO,Dominican Republic,Libero,Women,Italy,2022-06-16,Pool,2,5,0,0,0,0,0,0,0,0,0,0,0,0,0,0,0,0,0,0,0,0,0,0,0,0,0
Yaneirys RODRIGUEZ DURAN,Dominican Republic,Libero,Women,Korea,2022-06-15,Pool,3,3,0,0,0,0,0,0,0,0,0,0,0,0,0,2,1,4,7,9,3,1,13,0,0,4,4
Esthefany RABIT,Dominican Republic,Libero,Women,Korea,2022-06-15,Pool,3,3,0,0,0,0,0,0,0,0,0,0,0,0,0,0,0,0,0,0,0,0,0,0,0,0,0
Vielka Michelle PERALTA LUNA,Dominican Republic,Outside Hitter,Women,Korea,2022-06-15,Pool,3,3,0,0,0,3,3,0,0,0,0,0,0,1,1,0,0,4,4,1,0,0,1,0,0,0,0
Camil Inmaculada DOMINGUEZ MARTINEZ,Dominican Republic,Setter,Women,Korea,2022-06-15,Pool,3,3,0,0,0,0,0,0,0,0,0,0,0,0,0,0,0,0,0,0,0,0,0,0,0,0,0
Niverka Dharlenis MARTE FRICA,Dominican Republic,Setter,Women,Korea,2022-06-15,Pool,3,3,1,1,0,1,2,0,1,4,5,0,0,14,14,0,0,0,0,1,1,0,2,14,1,53,68
Angelica Maria HINOJOSA DIAZ,Dominican Republic,Middle Blocker,Women,Korea,2022-06-15,Pool,3,3,0,0,0,0,0,0,0,0,0,0,0,0,0,0,0,0,0,0,0,0,0,0,0,0,0
Madeline Jazmin GUILLEN PAREDES,Dominican Republic,Outside Hitter,Women,Korea,2022-06-15,Pool,3,3,0,0,0,0,0,0,0,0,0,0,1,3,4,0,0,0,0,0,0,0,0,0,0,0,0
Yonkaira Paola PEÑA ISABEL,Dominican Republic,Outside Hitter,Women,Korea,2022-06-15,Pool,3,3,22,19,4,9,32,1,1,1,3,2,3,9,14,5,0,8,13,11,0,0,11,0,0,0,0
Gina Altagracia MAMBRU CASILLA,Dominican Republic,Opposite Spiker,Women,Korea,2022-06-15,Pool,3,3,0,0,0,0,0,0,0,0,0,0,0,0,0,0,0,0,0,0,0,0,0,0,0,0,0
Brayelin Elizabeth MARTINEZ,Dominican Republic,Outside Hitter,Women,Korea,2022-06-15,Pool,3,3,10,10,0,6,16,0,1,1,2,0,2,11,13,2,0,7,9,3,2,1,6,0,0,3,3
Jineiry MARTINEZ,Dominican Republic,Middle Blocker,Women,Korea,2022-06-15,Pool,3,3,4,3,0,3,6,1,2,7,10,0,2,4,6,0,0,0,0,2,0,0,2,0,0,1,1
Gaila Ceneida GONZALEZ LOPEZ,Dominican Republic,Opposite Spiker,Women,Korea,2022-06-15,Pool,3,3,9,8,6,4,18,1,4,0,5,0,2,10,12,0,0,0,0,5,0,0,5,0,0,2,2
Geraldine Sthefany GONZALEZ,Dominican Republic,Middle Blocker,Women,Korea,2022-06-15,Pool,3,3,3,0,1,1,2,3,4,4,11,0,0,9,9,0,0,0,0,0,0,0,0,0,0,0,0
Larysmer MARTINEZ CARO,Dominican Republic,Libero,Women,Korea,2022-06-15,Pool,3,3,0,0,0,0,0,0,0,0,0,0,0,0,0,0,0,0,0,0,0,0,0,0,0,0,0
Yaneirys RODRIGUEZ DURAN,Dominican Republic,Libero,Women,Japan,2022-06-04,Pool,1,4,0,0,0,0,0,0,0,0,0,0,0,0,0,0,0,0,0,0,0,0,0,0,0,0,0
Esthefany RABIT,Dominican Republic,Libero,Women,Japan,2022-06-04,Pool,1,4,0,0,0,0,0,0,0,0,0,0,0,1,1,0,0,0,0,0,0,0,0,0,0,0,0
Vielka Michelle PERALTA LUNA,Dominican Republic,Outside Hitter,Women,Japan,2022-06-04,Pool,1,4,8,7,4,18,29,1,2,1,4,0,0,8,8,17,1,13,31,11,3,1,15,0,0,1,1
Camil Inmaculada DOMINGUEZ MARTINEZ,Dominican Republic,Setter,Women,Japan,2022-06-04,Pool,1,4,0,0,0,0,0,0,0,0,0,0,0,0,0,0,0,0,0,1,0,1,2,1,0,28,29
Niverka Dharlenis MARTE FRICA,Dominican Republic,Setter,Women,Japan,2022-06-04,Pool,1,4,1,0,2,3,5,0,1,1,2,1,1,7,9,0,0,0,0,9,1,0,10,12,1,75,88
Angelica Maria HINOJOSA DIAZ,Dominican Republic,Middle Blocker,Women,Japan,2022-06-04,Pool,1,4,0,0,0,0,0,0,0,0,0,0,0,0,0,0,0,0,0,0,0,0,0,0,0,0,0
Madeline Jazmin GUILLEN PAREDES,Dominican Republic,Outside Hitter,Women,Japan,2022-06-04,Pool,1,4,1,1,1,4,6,0,1,1,2,0,1,2,3,5,0,1,6,2,1,0,3,0,0,0,0
Yonkaira Paola PEÑA ISABEL,Dominican Republic,Outside Hitter,Women,Japan,2022-06-04,Pool,1,4,19,16,2,28,46,2,0,1,3,1,1,12,14,25,2,5,32,16,3,0,19,0,0,5,5
Gina Altagracia MAMBRU CASILLA,Dominican Republic,Opposite Spiker,Women,Japan,2022-06-04,Pool,1,4,2,2,1,6,9,0,1,1,2,0,2,1,3,0,0,0,0,2,0,0,2,0,0,1,1
Brayelin Elizabeth MARTINEZ,Dominican Republic,Outside Hitter,Women,Japan,2022-06-04,Pool,1,4,0,0,0,0,0,0,0,0,0,0,0,0,0,0,0,0,0,0,0,0,0,0,0,0,0
Jineiry MARTINEZ,Dominican Republic,Middle Blocker,Women,Japan,2022-06-04,Pool,1,4,5,3,2,10,15,2,5,6,13,0,0,14,14,1,0,0,1,9,1,0,10,0,0,5,5
Gaila Ceneida GONZALEZ LOPEZ,Dominican Republic,Opposite Spiker,Women,Japan,2022-06-04,Pool,1,4,14,10,8,13,31,4,2,1,7,0,1,8,9,0,0,0,0,6,2,0,8,0,0,0,0
Geraldine Sthefany GONZALEZ,Dominican Republic,Middle Blocker,Women,Japan,2022-06-04,Pool,1,4,8,3,2,4,9,4,6,3,13,1,3,9,13,0,0,1,1,3,0,0,3,0,0,1,1
Larysmer MARTINEZ CARO,Dominican Republic,Libero,Women,Japan,2022-06-04,Pool,1,4,0,0,0,0,0,0,0,0,0,0,0,0,0,8,0,6,14,17,5,1,23,0,0,12,12
Yaneirys RODRIGUEZ DURAN,Dominican Republic,Libero,Women,Brazil,2022-06-03,Pool,1,4,0,0,0,0,0,0,0,0,0,0,0,0,0,8,2,1,11,6,3,0,9,0,0,4,4
Esthefany RABIT,Dominican Republic,Libero,Women,Brazil,2022-06-03,Pool,1,4,0,0,0,0,0,0,0,0,0,0,0,0,0,0,0,0,0,0,0,0,0,0,0,0,0
Vielka Michelle PERALTA LUNA,Dominican Republic,Outside Hitter,Women,Brazil,2022-06-03,Pool,1,4,7,5,4,14,23,0,0,1,1,2,0,8,10,11,1,19,31,4,2,0,6,0,0,5,5
Camil Inmaculada DOMINGUEZ MARTINEZ,Dominican Republic,Setter,Women,Brazil,2022-06-03,Pool,1,4,0,0,0,0,0,0,0,0,0,0,0,0,0,0,0,0,0,1,1,0,2,0,0,5,5
Niverka Dharlenis MARTE FRICA,Dominican Republic,Setter,Women,Brazil,2022-06-03,Pool,1,4,1,1,0,4,5,0,2,3,5,0,0,6,6,1,0,0,1,10,2,0,12,7,0,76,83
Angelica Maria HINOJOSA DIAZ,Dominican Republic,Middle Blocker,Women,Brazil,2022-06-03,Pool,1,4,0,0,0,0,0,0,0,0,0,0,0,0,0,0,0,0,0,0,0,0,0,0,0,0,0
Madeline Jazmin GUILLEN PAREDES,Dominican Republic,Outside Hitter,Women,Brazil,2022-06-03,Pool,1,4,1,1,4,2,7,0,1,0,1,0,1,5,6,2,0,4,6,3,1,0,4,0,0,0,0
Yonkaira Paola PEÑA ISABEL,Dominican Republic,Outside Hitter,Women,Brazil,2022-06-03,Pool,1,4,17,15,6,26,47,1,1,1,3,1,3,11,15,8,1,9,18,12,4,0,16,0,0,3,3
Gina Altagracia MAMBRU CASILLA,Dominican Republic,Opposite Spiker,Women,Brazil,2022-06-03,Pool,1,4,0,0,0,0,0,0,0,0,0,0,0,2,2,0,0,0,0,0,0,0,0,0,0,1,1
Brayelin Elizabeth MARTINEZ,Dominican Republic,Outside Hitter,Women,Brazil,2022-06-03,Pool,1,4,0,0,0,0,0,0,0,0,0,0,0,0,0,0,0,0,0,0,0,0,0,0,0,0,0
Jineiry MARTINEZ,Dominican Republic,Middle Blocker,Women,Brazil,2022-06-03,Pool,1,4,6,5,1,2,8,1,0,2,3,0,2,8,10,0,0,0,0,1,1,0,2,0,0,2,2
Gaila Ceneida GONZALEZ LOPEZ,Dominican Republic,Opposite Spiker,Women,Brazil,2022-06-03,Pool,1,4,16,12,7,10,29,2,4,1,7,2,1,9,12,1,0,1,2,6,1,0,7,0,0,2,2
Geraldine Sthefany GONZALEZ,Dominican Republic,Middle Blocker,Women,Brazil,2022-06-03,Pool,1,4,3,3,2,2,7,0,4,4,8,0,4,5,9,0,0,0,0,2,0,1,3,0,0,2,2
Larysmer MARTINEZ CARO,Dominican Republic,Libero,Women,Brazil,2022-06-03,Pool,1,4,0,0,0,0,0,0,0,0,0,0,0,0,0,6,2,9,17,11,4,0,15,0,0,5,5
Yaneirys RODRIGUEZ DURAN,Dominican Republic,Libero,Women,Canada,2022-06-03,Pool,0,3,0,0,0,0,0,0,0,0,0,0,0,0,0,5,2,1,8,4,1,0,5,0,0,1,1
Esthefany RABIT,Dominican Republic,Libero,Women,Canada,2022-06-03,Pool,0,3,0,0,0,0,0,0,0,0,0,0,0,0,0,0,0,0,0,0,0,0,0,0,0,0,0
Vielka Michelle PERALTA LUNA,Dominican Republic,Outside Hitter,Women,Canada,2022-06-03,Pool,0,3,2,2,0,6,8,0,1,0,1,0,0,4,4,3,1,3,7,3,0,0,3,0,0,0,0
Camil Inmaculada DOMINGUEZ MARTINEZ,Dominican Republic,Setter,Women,Canada,2022-06-03,Pool,0,3,0,0,0,0,0,0,0,0,0,0,0,0,0,0,0,0,0,0,0,0,0,0,0,9,9
Niverka Dharlenis MARTE FRICA,Dominican Republic,Setter,Women,Canada,2022-06-03,Pool,0,3,1,1,0,2,3,0,0,1,1,0,1,5,6,0,0,0,0,4,0,0,4,4,0,70,74
Angelica Maria HINOJOSA DIAZ,Dominican Republic,Middle Blocker,Women,Canada,2022-06-03,Pool,0,3,1,1,0,3,4,0,1,0,1,0,2,2,4,0,1,0,1,2,0,0,2,0,0,0,0
Madeline Jazmin GUILLEN PAREDES,Dominican Republic,Outside Hitter,Women,Canada,2022-06-03,Pool,0,3,12,11,4,14,29,1,1,1,3,0,1,10,11,11,0,7,18,6,1,1,8,0,0,4,4
Yonkaira Paola PEÑA ISABEL,Dominican Republic,Outside Hitter,Women,Canada,2022-06-03,Pool,0,3,9,6,6,12,24,1,1,0,2,2,3,4,9,16,2,3,21,8,2,0,10,0,0,3,3
Gina Altagracia MAMBRU CASILLA,Dominican Republic,Opposite Spiker,Women,Canada,2022-06-03,Pool,0,3,0,0,0,2,2,0,1,0,1,0,0,1,1,0,0,0,0,0,1,0,1,0,0,0,0
Brayelin Elizabeth MARTINEZ,Dominican Republic,Outside Hitter,Women,Canada,2022-06-03,Pool,0,3,0,0,0,0,0,0,0,0,0,0,0,0,0,0,0,0,0,0,0,0,0,0,0,0,0
Jineiry MARTINEZ,Dominican Republic,Middle Blocker,Women,Canada,2022-06-03,Pool,0,3,6,4,1,4,9,1,5,4,10,1,1,5,7,0,0,0,0,1,1,0,2,0,0,0,0
Gaila Ceneida GONZALEZ LOPEZ,Dominican Republic,Opposite Spiker,Women,Canada,2022-06-03,Pool,0,3,4,1,4,10,15,1,1,2,4,2,1,5,8,0,0,0,0,4,1,0,5,0,0,0,0
Geraldine Sthefany GONZALEZ,Dominican Republic,Middle Blocker,Women,Canada,2022-06-03,Pool,0,3,0,0,0,4,4,0,1,0,1,0,0,3,3,0,1,0,1,0,0,0,0,0,0,3,3
Larysmer MARTINEZ CARO,Dominican Republic,Libero,Women,Canada,2022-06-03,Pool,0,3,0,0,0,0,0,0,0,0,0,0,0,0,0,4,1,6,11,8,2,0,10,0,0,1,1
Yaneirys RODRIGUEZ DURAN,Dominican Republic,Libero,Women,United States,2022-06-01,Pool,0,3,0,0,0,0,0,0,0,0,0,0,0,0,0,0,0,0,0,0,0,0,0,0,0,0,0
Esthefany RABIT,Dominican Republic,Libero,Women,United States,2022-06-01,Pool,0,3,2,1,2,0,3,1,1,0,2,0,1,3,4,0,0,0,0,1,0,0,1,0,0,0,0
Vielka Michelle PERALTA LUNA,Dominican Republic,Outside Hitter,Women,United States,2022-06-01,Pool,0,3,5,4,0,2,6,1,2,0,3,0,0,3,3,10,1,12,23,4,2,0,6,0,0,1,1
Camil Inmaculada DOMINGUEZ MARTINEZ,Dominican Republic,Setter,Women,United States,2022-06-01,Pool,0,3,0,0,0,0,0,0,0,0,0,0,0,0,0,0,0,0,0,0,0,0,0,0,0,4,4
Niverka Dharlenis MARTE FRICA,Dominican Republic,Setter,Women,United States,2022-06-01,Pool,0,3,3,3,0,1,4,0,0,1,1,0,1,8,9,0,0,0,0,7,1,0,8,5,0,67,72
Angelica Maria HINOJOSA DIAZ,Dominican Republic,Middle Blocker,Women,United States,2022-06-01,Pool,0,3,0,0,0,0,0,0,0,0,0,0,0,0,0,0,0,0,0,0,0,0,0,0,0,0,0
Madeline Jazmin GUILLEN PAREDES,Dominican Republic,Outside Hitter,Women,United States,2022-06-01,Pool,0,3,2,2,5,4,11,0,0,0,0,0,0,6,6,8,3,14,25,7,0,0,7,0,0,0,0
Yonkaira Paola PEÑA ISABEL,Dominican Republic,Outside Hitter,Women,United States,2022-06-01,Pool,0,3,9,9,6,17,32,0,0,2,2,0,0,11,11,5,0,4,9,5,1,0,6,0,0,6,6
Gina Altagracia MAMBRU CASILLA,Dominican Republic,Opposite Spiker,Women,United States,2022-06-01,Pool,0,3,2,2,0,2,4,0,1,1,2,0,0,1,1,0,0,0,0,0,0,0,0,0,0,0,0
Brayelin Elizabeth MARTINEZ,Dominican Republic,Outside Hitter,Women,United States,2022-06-01,Pool,0,3,0,0,0,0,0,0,0,0,0,0,0,0,0,0,0,0,0,0,0,0,0,0,0,0,0
Jineiry MARTINEZ,Dominican Republic,Middle Blocker,Women,United States,2022-06-01,Pool,0,3,3,0,1,3,4,3,0,2,5,0,0,4,4,0,0,0,0,2,0,0,2,0,0,3,3
Gaila Ceneida GONZALEZ LOPEZ,Dominican Republic,Opposite Spiker,Women,United States,2022-06-01,Pool,0,3,7,7,5,21,33,0,0,3,3,0,1,9,10,1,0,0,1,12,2,2,16,0,0,1,1
Geraldine Sthefany GONZALEZ,Dominican Republic,Middle Blocker,Women,United States,2022-06-01,Pool,0,3,6,4,1,2,7,2,4,2,8,0,1,9,10,0,0,0,0,2,0,0,2,0,0,4,4
Larysmer MARTINEZ CARO,Dominican Republic,Libero,Women,United States,2022-06-01,Pool,0,3,0,0,0,0,0,0,0,0,0,0,0,0,0,4,0,4,8,10,2,0,12,0,0,6,6
Vielka Michelle PERALTA LUNA,Dominican Republic,Outside Hitter,Women,Poland,2022-07-02,Pool,3,5,4,4,2,3,9,0,0,0,0,0,0,1,1,0,0,2,2,1,0,0,1,0,0,0,0
Camil Inmaculada DOMINGUEZ MARTINEZ,Dominican Republic,Setter,Women,Poland,2022-07-02,Pool,3,5,0,0,0,0,0,0,0,0,0,0,0,0,0,0,0,0,0,0,0,0,0,0,0,0,0
Niverka Dharlenis MARTE FRICA,Dominican Republic,Setter,Women,Poland,2022-07-02,Pool,3,5,2,1,1,2,4,1,5,6,12,0,2,16,18,0,0,0,0,9,0,1,10,10,1,137,148
Angelica Maria HINOJOSA DIAZ,Dominican Republic,Middle Blocker,Women,Poland,2022-07-02,Pool,3,5,6,2,0,3,5,4,1,0,5,0,0,9,9,0,0,0,0,1,1,2,4,0,0,0,0
Yokaty PEREZ FLORES,Dominican Republic,Libero,Women,Poland,2022-07-02,Pool,3,5,0,0,0,0,0,0,0,0,0,0,0,0,0,0,0,0,0,0,0,0,0,0,0,0,0
Massiel MATOS DURAN,Dominican Republic,Outside Hitter,Women,Poland,2022-07-02,Pool,3,5,0,0,0,0,0,0,0,0,0,0,0,0,0,0,0,0,0,0,0,0,0,0,0,0,0
Yonkaira Paola PEÑA ISABEL,Dominican Republic,Outside Hitter,Women,Poland,2022-07-02,Pool,3,5,15,13,8,18,39,0,6,2,8,2,1,11,14,5,4,16,25,8,2,5,15,0,0,4,4
Brayelin Elizabeth MARTINEZ,Dominican Republic,Outside Hitter,Women,Poland,2022-07-02,Pool,3,5,23,19,7,16,42,3,5,2,10,1,2,16,19,2,1,24,27,14,2,3,19,0,0,4,4
Jineiry MARTINEZ,Dominican Republic,Middle Blocker,Women,Poland,2022-07-02,Pool,3,5,12,9,2,9,20,2,13,5,20,1,1,18,20,0,1,2,3,4,0,1,5,0,0,0,0
Samaret Jailene CARABALLO ARIAS,Dominican Republic,Outside Hitter,Women,Poland,2022-07-02,Pool,3,5,0,0,0,0,0,0,0,0,0,0,0,5,5,2,0,3,5,5,1,0,6,0,0,1,1
Gaila Ceneida GONZALEZ LOPEZ,Dominican Republic,Opposite Spiker,Women,Poland,2022-07-02,Pool,3,5,23,21,9,14,44,2,6,3,11,0,5,14,19,1,0,2,3,5,2,2,9,0,0,1,1
Geraldine Sthefany GONZALEZ,Dominican Republic,Middle Blocker,Women,Poland,2022-07-02,Pool,3,5,0,0,1,2,3,0,0,0,0,0,1,5,6,0,0,0,0,1,0,0,1,0,0,2,2
Larysmer MARTINEZ CARO,Dominican Republic,Libero,Women,Poland,2022-07-02,Pool,3,5,0,0,0,0,0,0,0,0,0,0,0,0,0,8,2,27,37,10,3,1,14,0,0,6,6
Vielka Michelle PERALTA LUNA,Dominican Republic,Outside Hitter,Women,China,2022-07-01,Pool,0,3,8,8,2,7,17,0,1,0,1,0,1,7,8,2,1,14,17,0,0,1,1,2,0,0,2
Camil Inmaculada DOMINGUEZ MARTINEZ,Dominican Republic,Setter,Women,China,2022-07-01,Pool,0,3,1,1,0,1,2,0,1,0,1,0,0,5,5,0,0,1,1,1,1,1,3,41,0,3,44
Niverka Dharlenis MARTE FRICA,Dominican Republic,Setter,Women,China,2022-07-01,Pool,0,3,0,0,0,0,0,0,1,0,1,0,0,3,3,0,0,0,0,0,0,1,1,31,0,1,32
Angelica Maria HINOJOSA DIAZ,Dominican Republic,Middle Blocker,Women,China,2022-07-01,Pool,0,3,0,0,0,3,3,0,3,1,4,0,1,4,5,0,0,1,1,0,0,0,0,0,0,0,0
Yokaty PEREZ FLORES,Dominican Republic,Libero,Women,China,2022-07-01,Pool,0,3,0,0,0,0,0,0,0,0,0,0,0,2,2,0,0,0,0,1,0,1,2,6,1,1,8
Massiel MATOS DURAN,Dominican Republic,Outside Hitter,Women,China,2022-07-01,Pool,0,3,2,2,3,1,6,0,3,0,3,0,1,0,1,0,0,4,4,2,0,1,3,0,0,0,0
Yonkaira Paola PEÑA ISABEL,Dominican Republic,Outside Hitter,Women,China,2022-07-01,Pool,0,3,15,11,8,11,30,3,2,1,6,1,1,7,9,2,2,24,28,2,2,2,6,2,0,0,2
Brayelin Elizabeth MARTINEZ,Dominican Republic,Outside Hitter,Women,China,2022-07-01,Pool,0,3,5,4,1,6,11,1,1,0,2,0,1,1,2,0,1,11,12,4,0,1,5,0,0,0,0
Jineiry MARTINEZ,Dominican Republic,Middle Blocker,Women,China,2022-07-01,Pool,0,3,1,0,0,5,5,1,1,0,2,0,0,2,2,0,0,0,0,0,0,0,0,0,0,0,0
Samaret Jailene CARABALLO ARIAS,Dominican Republic,Outside Hitter,Women,China,2022-07-01,Pool,0,3,0,0,0,0,0,0,0,0,0,0,0,0,0,0,0,2,2,2,0,3,5,0,0,0,0
Gaila Ceneida GONZALEZ LOPEZ,Dominican Republic,Opposite Spiker,Women,China,2022-07-01,Pool,0,3,10,8,5,8,21,0,1,1,2,2,1,4,7,0,0,0,0,2,2,2,6,0,0,0,0
Geraldine Sthefany GONZALEZ,Dominican Republic,Middle Blocker,Women,China,2022-07-01,Pool,0,3,1,1,1,2,4,0,4,1,5,0,1,6,7,0,0,1,1,1,0,2,3,4,1,0,5
Larysmer MARTINEZ CARO,Dominican Republic,Libero,Women,China,2022-07-01,Pool,0,3,0,0,0,0,0,0,0,0,0,0,0,0,0,0,1,6,7,4,0,5,9,4,0,0,4
Vielka Michelle PERALTA LUNA,Dominican Republic,Outside Hitter,Women,Thailand,2022-06-30,Pool,3,4,0,0,0,0,0,0,0,0,0,0,0,2,2,1,0,0,1,0,0,0,0,0,0,0,0
Camil Inmaculada DOMINGUEZ MARTINEZ,Dominican Republic,Setter,Women,Thailand,2022-06-30,Pool,3,4,0,0,0,0,0,0,0,0,0,0,0,0,0,0,0,0,0,0,0,0,0,0,0,0,0
Niverka Dharlenis MARTE FRICA,Dominican Republic,Setter,Women,Thailand,2022-06-30,Pool,3,4,0,0,0,0,0,0,2,3,5,0,0,10,10,0,0,0,0,4,5,4,13,94,1,2,97
Angelica Maria HINOJOSA DIAZ,Dominican Republic,Middle Blocker,Women,Thailand,2022-06-30,Pool,3,4,5,0,0,1,1,4,1,1,6,1,2,7,10,0,0,0,0,1,0,0,1,0,0,0,0
Yokaty PEREZ FLORES,Dominican Republic,Libero,Women,Thailand,2022-06-30,Pool,3,4,0,0,0,0,0,0,0,0,0,0,0,0,0,0,0,0,0,0,0,0,0,0,0,0,0
Massiel MATOS DURAN,Dominican Republic,Outside Hitter,Women,Thailand,2022-06-30,Pool,3,4,0,0,0,0,0,0,0,0,0,0,0,0,0,0,0,0,0,0,0,0,0,0,0,0,0
Yonkaira Paola PEÑA ISABEL,Dominican Republic,Outside Hitter,Women,Thailand,2022-06-30,Pool,3,4,19,18,6,16,40,0,4,3,7,1,2,15,18,5,1,19,25,8,1,3,12,3,0,1,4
Brayelin Elizabeth MARTINEZ,Dominican Republic,Outside Hitter,Women,Thailand,2022-06-30,Pool,3,4,19,19,3,20,42,0,3,3,6,0,2,15,17,3,3,16,22,11,4,0,15,3,0,0,3
Jineiry MARTINEZ,Dominican Republic,Middle Blocker,Women,Thailand,2022-06-30,Pool,3,4,13,11,4,9,24,2,2,1,5,0,2,15,17,0,0,0,0,3,0,1,4,2,0,0,2
Samaret Jailene CARABALLO ARIAS,Dominican Republic,Outside Hitter,Women,Thailand,2022-06-30,Pool,3,4,0,0,0,0,0,0,0,0,0,0,0,0,0,0,0,0,0,0,0,0,0,0,0,0,0
Gaila Ceneida GONZALEZ LOPEZ,Dominican Republic,Opposite Spiker,Women,Thailand,2022-06-30,Pool,3,4,18,15,3,15,33,1,5,2,8,2,3,14,19,0,0,0,0,5,1,1,7,0,0,0,0
Geraldine Sthefany GONZALEZ,Dominican Republic,Middle Blocker,Women,Thailand,2022-06-30,Pool,3,4,2,1,1,0,2,1,2,3,6,0,0,3,3,0,0,0,0,0,0,1,1,0,0,0,0
Larysmer MARTINEZ CARO,Dominican Republic,Libero,Women,Thailand,2022-06-30,Pool,3,4,0,0,0,0,0,0,0,0,0,0,0,0,0,7,2,25,34,16,4,4,24,7,0,1,8
Vielka Michelle PERALTA LUNA,Dominican Republic,Outside Hitter,Women,Bulgaria,2022-06-28,Pool,0,3,3,3,2,4,9,0,0,0,0,0,1,4,5,3,0,7,10,3,2,1,6,0,0,0,0
Camil Inmaculada DOMINGUEZ MARTINEZ,Dominican Republic,Setter,Women,Bulgaria,2022-06-28,Pool,0,3,0,0,0,0,0,0,0,0,0,0,0,1,1,0,0,0,0,0,0,0,0,0,0,0,0
Niverka Dharlenis MARTE FRICA,Dominican Republic,Setter,Women,Bulgaria,2022-06-28,Pool,0,3,1,0,0,2,2,1,4,2,7,0,1,6,7,0,0,0,0,2,0,0,2,48,2,1,51
Angelica Maria HINOJOSA DIAZ,Dominican Republic,Middle Blocker,Women,Bulgaria,2022-06-28,Pool,0,3,0,0,0,0,0,0,0,0,0,0,0,0,0,0,0,0,0,0,0,0,0,0,0,0,0
Yokaty PEREZ FLORES,Dominican Republic,Libero,Women,Bulgaria,2022-06-28,Pool,0,3,0,0,0,0,0,0,0,0,0,0,0,0,0,0,0,0,0,0,0,0,0,0,0,0,0
Massiel MATOS DURAN,Dominican Republic,Outside Hitter,Women,Bulgaria,2022-06-28,Pool,0,3,0,0,0,0,0,0,0,0,0,0,0,0,0,0,0,0,0,0,0,0,0,0,0,0,0
Yonkaira Paola PEÑA ISABEL,Dominican Republic,Outside Hitter,Women,Bulgaria,2022-06-28,Pool,0,3,3,3,2,11,16,0,0,0,0,0,0,6,6,2,2,21,25,1,0,0,1,1,1,0,2
Brayelin Elizabeth MARTINEZ,Dominican Republic,Outside Hitter,Women,Bulgaria,2022-06-28,Pool,0,3,3,3,4,9,16,0,1,0,1,0,2,11,13,1,1,7,9,2,0,1,3,0,0,0,0
Jineiry MARTINEZ,Dominican Republic,Middle Blocker,Women,Bulgaria,2022-06-28,Pool,0,3,9,8,1,4,13,1,4,0,5,0,0,5,5,0,1,0,1,1,0,0,1,3,0,0,3
Samaret Jailene CARABALLO ARIAS,Dominican Republic,Outside Hitter,Women,Bulgaria,2022-06-28,Pool,0,3,0,0,0,0,0,0,0,0,0,0,0,3,3,0,0,2,2,0,0,0,0,0,0,0,0
Gaila Ceneida GONZALEZ LOPEZ,Dominican Republic,Opposite Spiker,Women,Bulgaria,2022-06-28,Pool,0,3,10,8,6,9,23,2,4,2,8,0,1,6,7,0,0,0,0,0,0,2,2,0,0,0,0
Geraldine Sthefany GONZALEZ,Dominican Republic,Middle Blocker,Women,Bulgaria,2022-06-28,Pool,0,3,4,4,3,1,8,0,0,0,0,0,1,3,4,0,0,0,0,0,0,0,0,0,0,0,0
Larysmer MARTINEZ CARO,Dominican Republic,Libero,Women,Bulgaria,2022-06-28,Pool,0,3,0,0,0,0,0,0,0,0,0,0,0,0,0,1,1,18,20,0,2,1,3,0,0,0,0
Linda BOCK,Germany,Libero,Women,Dominican Republic,2022-06-19,Pool,1,4,0,0,0,0,0,0,0,0,0,0,0,0,0,0,0,0,0,0,0,0,0,0,0,0,0
Pia KÄSTNER,Germany,Setter,Women,Dominican Republic,2022-06-19,Pool,1,4,1,1,0,0,1,0,3,4,7,0,2,5,7,0,0,0,0,3,2,1,6,32,0,71,103
Anna POGANY,Germany,Libero,Women,Dominican Republic,2022-06-19,Pool,1,4,0,0,0,0,0,0,0,0,0,0,0,0,0,15,0,12,27,11,4,2,17,0,0,9,9
Corina GLAAB,Germany,Setter,Women,Dominican Republic,2022-06-19,Pool,1,4,1,1,0,1,2,0,1,0,1,0,0,2,2,0,0,0,0,3,0,0,3,7,1,5,13
Jennifer JANISKA,Germany,Outside Hitter,Women,Dominican Republic,2022-06-19,Pool,1,4,9,7,7,14,28,0,1,0,1,2,1,12,15,9,0,9,18,6,1,0,7,0,0,2,2
Ivana VANJAK,Germany,Outside Hitter,Women,Dominican Republic,2022-06-19,Pool,1,4,0,0,0,0,0,0,0,0,0,0,0,0,0,0,0,0,0,0,0,0,0,0,0,0,0
Lina ALSMEIER,Germany,Outside Hitter,Women,Dominican Republic,2022-06-19,Pool,1,4,11,9,6,6,21,0,0,1,1,2,1,16,19,6,0,3,9,11,3,1,15,0,0,2,2
Lena STIGROT,Germany,Outside Hitter,Women,Dominican Republic,2022-06-19,Pool,1,4,9,5,4,7,16,4,1,0,5,0,0,7,7,1,0,2,3,2,0,0,2,0,0,1,1
Hanna ORTHMANN,Germany,Outside Hitter,Women,Dominican Republic,2022-06-19,Pool,1,4,22,20,5,14,39,0,1,0,1,2,4,6,12,7,1,8,16,4,1,1,6,0,0,1,1
Saskia HIPPE,Germany,Opposite Spiker,Women,Dominican Republic,2022-06-19,Pool,1,4,1,1,0,1,2,0,0,0,0,0,1,4,5,0,0,0,0,2,0,0,2,0,0,0,0
Marie SCHÖLZEL,Germany,Middle Blocker,Women,Dominican Republic,2022-06-19,Pool,1,4,2,1,1,4,6,1,3,0,4,0,0,3,3,0,0,0,0,1,0,1,2,0,0,1,1
Camilla WEITZEL,Germany,Middle Blocker,Women,Dominican Republic,2022-06-19,Pool,1,4,9,6,1,7,14,2,7,7,16,1,1,18,20,0,0,0,0,1,0,0,1,0,0,1,1
Monique STRUBBE,Germany,Middle Blocker,Women,Dominican Republic,2022-06-19,Pool,1,4,0,0,0,0,0,0,0,0,0,0,0,0,0,0,0,0,0,0,0,0,0,0,0,0,0
Anastasia CEKULAEV,Germany,Middle Blocker,Women,Dominican Republic,2022-06-19,Pool,1,4,5,4,0,3,7,1,1,3,5,0,1,6,7,0,0,0,0,0,0,0,0,0,0,1,1
Linda BOCK,Germany,Libero,Women,Türkiye,2022-06-18,Pool,0,3,0,0,0,0,0,0,0,0,0,0,0,0,0,0,0,0,0,1,1,0,2,0,0,0,0
Pia KÄSTNER,Germany,Setter,Women,Türkiye,2022-06-18,Pool,0,3,0,0,0,0,0,0,2,0,2,0,0,3,3,0,0,0,0,0,0,0,0,12,0,33,45
Anna POGANY,Germany,Libero,Women,Türkiye,2022-06-18,Pool,0,3,0,0,0,0,0,0,0,0,0,0,0,0,0,2,0,2,4,4,3,0,7,0,0,3,3
Corina GLAAB,Germany,Setter,Women,Türkiye,2022-06-18,Pool,0,3,0,0,0,0,0,0,0,3,3,0,1,6,7,0,0,0,0,2,2,1,5,8,0,30,38
Jennifer JANISKA,Germany,Outside Hitter,Women,Türkiye,2022-06-18,Pool,0,3,4,3,1,6,10,0,2,2,4,1,0,6,7,5,0,7,12,3,2,2,7,0,0,1,1
Ivana VANJAK,Germany,Outside Hitter,Women,Türkiye,2022-06-18,Pool,0,3,13,8,9,12,29,3,3,0,6,2,2,3,7,11,0,19,30,4,3,0,7,0,0,0,0
Lena STIGROT,Germany,Outside Hitter,Women,Türkiye,2022-06-18,Pool,0,3,5,5,3,5,13,0,0,0,0,0,1,5,6,11,1,7,19,1,0,0,1,0,0,1,1
Hanna ORTHMANN,Germany,Outside Hitter,Women,Türkiye,2022-06-18,Pool,0,3,0,0,0,0,0,0,0,1,1,0,0,0,0,0,0,0,0,0,0,0,0,0,0,1,1
Saskia HIPPE,Germany,Opposite Spiker,Women,Türkiye,2022-06-18,Pool,0,3,14,10,6,7,23,1,2,0,3,3,2,14,19,0,1,0,1,1,3,0,4,0,0,1,1
Marie SCHÖLZEL,Germany,Middle Blocker,Women,Türkiye,2022-06-18,Pool,0,3,5,5,0,6,11,0,2,4,6,0,1,8,9,0,0,0,0,2,0,1,3,0,0,0,0
Camilla WEITZEL,Germany,Middle Blocker,Women,Türkiye,2022-06-18,Pool,0,3,3,2,0,2,4,1,1,0,2,0,0,0,0,0,0,0,0,0,0,0,0,0,0,1,1
Monique STRUBBE,Germany,Middle Blocker,Women,Türkiye,2022-06-18,Pool,0,3,1,1,0,2,3,0,2,2,4,0,2,6,8,0,0,0,0,1,0,0,1,0,0,0,0
Anastasia CEKULAEV,Germany,Middle Blocker,Women,Türkiye,2022-06-18,Pool,0,3,0,0,0,0,0,0,0,0,0,0,0,0,0,0,0,0,0,0,0,0,0,0,0,0,0
Linda BOCK,Germany,Libero,Women,Italy,2022-06-17,Pool,0,3,0,0,0,0,0,0,0,0,0,0,0,0,0,0,0,0,0,0,0,0,0,0,0,0,0
Pia KÄSTNER,Germany,Setter,Women,Italy,2022-06-17,Pool,0,3,3,1,1,0,2,1,2,2,5,1,0,11,12,0,0,0,0,1,2,3,6,19,0,55,74
Anna POGANY,Germany,Libero,Women,Italy,2022-06-17,Pool,0,3,0,0,0,0,0,0,0,0,0,0,0,0,0,8,0,6,14,3,7,4,14,0,0,5,5
Corina GLAAB,Germany,Setter,Women,Italy,2022-06-17,Pool,0,3,0,0,0,0,0,0,0,0,0,0,0,0,0,0,0,0,0,0,0,0,0,0,0,4,4
Jennifer JANISKA,Germany,Outside Hitter,Women,Italy,2022-06-17,Pool,0,3,1,1,1,0,2,0,0,1,1,0,0,4,4,1,0,2,3,1,0,1,2,0,0,0,0
Ivana VANJAK,Germany,Outside Hitter,Women,Italy,2022-06-17,Pool,0,3,0,0,1,0,1,0,0,0,0,0,0,0,0,0,0,0,0,0,0,0,0,0,0,0,0
Lina ALSMEIER,Germany,Outside Hitter,Women,Italy,2022-06-17,Pool,0,3,11,7,1,8,16,2,0,1,3,2,3,10,15,12,1,18,31,4,3,1,8,0,0,3,3
Lena STIGROT,Germany,Outside Hitter,Women,Italy,2022-06-17,Pool,0,3,6,5,1,12,18,0,0,1,1,1,0,10,11,4,1,7,12,1,0,1,2,0,0,0,0
Hanna ORTHMANN,Germany,Outside Hitter,Women,Italy,2022-06-17,Pool,0,3,13,11,5,17,33,1,1,1,3,1,3,5,9,2,0,5,7,0,1,0,1,0,0,0,0
Saskia HIPPE,Germany,Opposite Spiker,Women,Italy,2022-06-17,Pool,0,3,0,0,0,0,0,0,0,0,0,0,0,1,1,0,0,0,0,0,1,0,1,0,0,0,0
Marie SCHÖLZEL,Germany,Middle Blocker,Women,Italy,2022-06-17,Pool,0,3,4,2,1,1,4,2,2,0,4,0,0,5,5,0,0,0,0,0,1,0,1,0,0,1,1
Camilla WEITZEL,Germany,Middle Blocker,Women,Italy,2022-06-17,Pool,0,3,5,4,3,3,10,1,2,2,5,0,0,9,9,0,0,0,0,0,0,0,0,0,0,1,1
Monique STRUBBE,Germany,Middle Blocker,Women,Italy,2022-06-17,Pool,0,3,0,0,0,0,0,0,0,0,0,0,0,0,0,0,0,0,0,0,0,0,0,0,0,0,0
Anastasia CEKULAEV,Germany,Middle Blocker,Women,Italy,2022-06-17,Pool,0,3,1,1,1,2,4,0,0,0,0,0,1,1,2,0,0,0,0,0,0,0,0,0,0,0,0
Linda BOCK,Germany,Libero,Women,Netherlands,2022-06-14,Pool,3,4,0,0,0,0,0,0,0,0,0,0,0,0,0,0,0,0,0,0,0,0,0,0,0,0,0
Pia KÄSTNER,Germany,Setter,Women,Netherlands,2022-06-14,Pool,3,4,1,1,0,0,1,0,0,0,0,0,1,8,9,0,0,0,0,4,0,2,6,9,0,30,39
Anna POGANY,Germany,Libero,Women,Netherlands,2022-06-14,Pool,3,4,0,0,0,0,0,0,0,0,0,0,0,0,0,7,1,10,18,9,7,0,16,0,0,0,0
Corina GLAAB,Germany,Setter,Women,Netherlands,2022-06-14,Pool,3,4,1,0,0,0,0,1,2,1,4,0,0,8,8,0,0,0,0,7,2,0,9,23,0,81,104
Jennifer JANISKA,Germany,Outside Hitter,Women,Netherlands,2022-06-14,Pool,3,4,4,4,2,6,12,0,0,0,0,0,0,8,8,5,0,3,8,1,0,1,2,0,0,0,0
Ivana VANJAK,Germany,Outside Hitter,Women,Netherlands,2022-06-14,Pool,3,4,0,0,1,1,2,0,0,0,0,0,0,1,1,0,0,0,0,1,1,0,2,0,0,0,0
Lina ALSMEIER,Germany,Outside Hitter,Women,Netherlands,2022-06-14,Pool,3,4,14,14,0,12,26,0,3,3,6,0,3,9,12,18,3,8,29,4,2,2,8,0,1,1,2
Lena STIGROT,Germany,Outside Hitter,Women,Netherlands,2022-06-14,Pool,3,4,9,8,1,16,25,1,5,2,8,0,0,12,12,6,0,4,10,3,0,0,3,0,1,0,1
Hanna ORTHMANN,Germany,Outside Hitter,Women,Netherlands,2022-06-14,Pool,3,4,23,22,5,17,44,1,2,2,5,0,5,6,11,5,0,5,10,3,1,1,5,0,0,0,0
Saskia HIPPE,Germany,Opposite Spiker,Women,Netherlands,2022-06-14,Pool,3,4,0,0,0,0,0,0,0,0,0,0,0,0,0,0,0,0,0,0,0,0,0,0,0,0,0
Marie SCHÖLZEL,Germany,Middle Blocker,Women,Netherlands,2022-06-14,Pool,3,4,8,7,4,4,15,1,7,0,8,0,3,9,12,0,1,0,1,2,1,1,4,0,0,0,0
Camilla WEITZEL,Germany,Middle Blocker,Women,Netherlands,2022-06-14,Pool,3,4,11,7,0,4,11,3,1,4,8,1,2,10,13,1,0,0,1,1,2,0,3,0,0,0,0
Monique STRUBBE,Germany,Middle Blocker,Women,Netherlands,2022-06-14,Pool,3,4,0,0,0,0,0,0,0,0,0,0,0,0,0,0,0,0,0,0,0,0,0,0,0,0,0
Anastasia CEKULAEV,Germany,Middle Blocker,Women,Netherlands,2022-06-14,Pool,3,4,0,0,0,0,0,0,0,0,0,0,0,0,0,0,0,0,0,0,0,0,0,0,0,0,0
Linda BOCK,Germany,Libero,Women,Poland,2022-06-05,Pool,2,5,0,0,0,0,0,0,0,0,0,0,0,0,0,0,0,0,0,0,0,0,0,0,0,0,0
Pia KÄSTNER,Germany,Setter,Women,Poland,2022-06-05,Pool,2,5,1,1,0,1,2,0,1,0,1,0,0,3,3,0,0,0,0,2,0,1,3,4,0,27,31
Anna POGANY,Germany,Libero,Women,Poland,2022-06-05,Pool,2,5,0,0,0,0,0,0,0,0,0,0,0,0,0,20,2,11,33,20,7,0,27,0,0,11,11
Corina GLAAB,Germany,Setter,Women,Poland,2022-06-05,Pool,2,5,0,0,0,1,1,0,2,0,2,0,1,11,12,0,0,0,0,9,4,0,13,17,1,74,92
Jennifer JANISKA,Germany,Outside Hitter,Women,Poland,2022-06-05,Pool,2,5,0,0,0,0,0,0,0,0,0,0,0,2,2,5,0,2,7,5,3,0,8,0,0,2,2
Ivana VANJAK,Germany,Outside Hitter,Women,Poland,2022-06-05,Pool,2,5,7,7,1,11,19,0,2,2,4,0,2,1,3,4,1,4,9,7,2,1,10,0,0,0,0
Lina ALSMEIER,Germany,Outside Hitter,Women,Poland,2022-06-05,Pool,2,5,21,17,7,15,39,2,2,1,5,2,4,12,18,9,0,7,16,16,4,0,20,0,0,3,3
Lena STIGROT,Germany,Outside Hitter,Women,Poland,2022-06-05,Pool,2,5,11,9,1,22,32,2,3,1,6,0,0,18,18,9,1,6,16,10,1,1,12,0,0,4,4
Hanna ORTHMANN,Germany,Outside Hitter,Women,Poland,2022-06-05,Pool,2,5,21,18,4,12,34,2,1,0,3,1,5,10,16,3,1,3,7,4,0,1,5,0,0,1,1
Saskia HIPPE,Germany,Opposite Spiker,Women,Poland,2022-06-05,Pool,2,5,0,0,0,0,0,0,0,0,0,0,0,0,0,0,0,0,0,0,0,0,0,0,0,0,0
Marie SCHÖLZEL,Germany,Middle Blocker,Women,Poland,2022-06-05,Pool,2,5,7,7,2,2,11,0,4,7,11,0,0,11,11,0,1,1,2,1,0,0,1,0,0,2,2
Camilla WEITZEL,Germany,Middle Blocker,Women,Poland,2022-06-05,Pool,2,5,9,6,4,7,17,2,3,4,9,1,1,15,17,1,0,0,1,2,0,0,2,0,0,1,1
Monique STRUBBE,Germany,Middle Blocker,Women,Poland,2022-06-05,Pool,2,5,0,0,0,0,0,0,0,0,0,0,0,5,5,0,0,0,0,0,1,0,1,0,0,0,0
Anastasia CEKULAEV,Germany,Middle Blocker,Women,Poland,2022-06-05,Pool,2,5,0,0,0,0,0,0,0,0,0,0,0,0,0,0,0,0,0,0,0,0,0,0,0,0,0
Linda BOCK,Germany,Libero,Women,Korea,2022-06-03,Pool,3,3,0,0,0,0,0,0,0,0,0,0,0,0,0,1,0,2,3,2,1,0,3,0,0,0,0
Pia KÄSTNER,Germany,Setter,Women,Korea,2022-06-03,Pool,3,3,3,1,0,0,1,0,3,2,5,2,1,11,14,0,0,0,0,6,0,0,6,16,0,51,67
Anna POGANY,Germany,Libero,Women,Korea,2022-06-03,Pool,3,3,0,0,0,0,0,0,0,0,0,0,0,0,0,12,4,5,21,13,4,0,17,0,0,6,6
Corina GLAAB,Germany,Setter,Women,Korea,2022-06-03,Pool,3,3,0,0,0,0,0,0,0,0,0,0,0,0,0,0,0,0,0,0,0,0,0,0,0,0,0
Jennifer JANISKA,Germany,Outside Hitter,Women,Korea,2022-06-03,Pool,3,3,0,0,2,8,10,0,2,0,2,0,0,7,7,2,0,2,4,5,1,0,6,0,0,1,1
Ivana VANJAK,Germany,Outside Hitter,Women,Korea,2022-06-03,Pool,3,3,0,0,0,1,1,0,0,0,0,0,0,0,0,0,0,0,0,0,0,0,0,0,0,0,0
Lina ALSMEIER,Germany,Outside Hitter,Women,Korea,2022-06-03,Pool,3,3,5,4,0,7,11,1,1,0,2,0,1,5,6,1,1,3,5,10,0,0,10,0,0,1,1
Lena STIGROT,Germany,Outside Hitter,Women,Korea,2022-06-03,Pool,3,3,7,7,0,4,11,0,2,0,2,0,0,11,11,5,0,0,5,5,0,1,6,0,0,8,8
Hanna ORTHMANN,Germany,Outside Hitter,Women,Korea,2022-06-03,Pool,3,3,22,19,1,12,32,3,2,3,8,0,2,5,7,1,2,2,5,5,1,0,6,0,0,2,2
Saskia HIPPE,Germany,Opposite Spiker,Women,Korea,2022-06-03,Pool,3,3,0,0,1,2,3,0,1,0,1,0,0,1,1,0,0,0,0,0,0,0,0,0,0,0,0
Marie SCHÖLZEL,Germany,Middle Blocker,Women,Korea,2022-06-03,Pool,3,3,0,0,0,0,0,0,0,0,0,0,0,0,0,0,0,0,0,0,0,0,0,0,0,0,0
Camilla WEITZEL,Germany,Middle Blocker,Women,Korea,2022-06-03,Pool,3,3,9,6,1,10,17,2,3,4,9,1,1,15,17,1,0,1,2,4,0,1,5,0,0,1,1
Monique STRUBBE,Germany,Middle Blocker,Women,Korea,2022-06-03,Pool,3,3,0,0,0,0,0,0,0,0,0,0,0,0,0,0,0,0,0,0,0,0,0,0,0,0,0
Anastasia CEKULAEV,Germany,Middle Blocker,Women,Korea,2022-06-03,Pool,3,3,10,8,0,0,8,0,1,4,5,2,1,8,11,0,0,1,1,2,0,1,3,0,0,0,0
Linda BOCK,Germany,Libero,Women,Japan,2022-06-02,Pool,2,5,1,1,0,0,1,0,0,0,0,0,0,2,2,0,0,2,2,2,1,0,3,0,0,0,0
Pia KÄSTNER,Germany,Setter,Women,Japan,2022-06-02,Pool,2,5,1,1,1,1,3,0,0,3,3,0,1,5,6,0,0,0,0,1,3,0,4,19,0,37,56
Anna POGANY,Germany,Libero,Women,Japan,2022-06-02,Pool,2,5,0,0,0,0,0,0,0,0,0,0,0,0,0,35,2,15,52,26,5,0,31,0,0,17,17
Corina GLAAB,Germany,Setter,Women,Japan,2022-06-02,Pool,2,5,0,0,0,1,1,0,1,0,1,0,2,9,11,0,0,0,0,13,4,0,17,19,0,67,86
Jennifer JANISKA,Germany,Outside Hitter,Women,Japan,2022-06-02,Pool,2,5,2,2,4,6,12,0,0,1,1,0,0,9,9,5,0,1,6,9,0,0,9,0,0,1,1
Ivana VANJAK,Germany,Outside Hitter,Women,Japan,2022-06-02,Pool,2,5,9,7,3,10,20,1,0,1,2,1,1,4,6,8,1,1,10,7,3,0,10,0,0,0,0
Lina ALSMEIER,Germany,Outside Hitter,Women,Japan,2022-06-02,Pool,2,5,16,13,2,22,37,2,1,0,3,1,1,6,8,4,0,7,11,11,1,0,12,0,0,6,6
Lena STIGROT,Germany,Outside Hitter,Women,Japan,2022-06-02,Pool,2,5,13,12,4,18,34,1,1,1,3,0,0,15,15,5,0,3,8,13,2,2,17,0,0,5,5
Hanna ORTHMANN,Germany,Outside Hitter,Women,Japan,2022-06-02,Pool,2,5,12,11,4,15,30,0,1,1,2,1,3,7,11,3,0,0,3,5,3,0,8,0,1,3,4
Saskia HIPPE,Germany,Opposite Spiker,Women,Japan,2022-06-02,Pool,2,5,1,1,0,1,2,0,0,1,1,0,2,2,4,1,0,0,1,0,0,0,0,0,0,0,0
Marie SCHÖLZEL,Germany,Middle Blocker,Women,Japan,2022-06-02,Pool,2,5,14,10,2,4,16,1,5,4,10,3,1,12,16,2,1,2,5,0,0,0,0,0,0,1,1
Camilla WEITZEL,Germany,Middle Blocker,Women,Japan,2022-06-02,Pool,2,5,14,13,1,18,32,1,2,7,10,0,1,13,14,2,0,3,5,5,0,0,5,0,0,1,1
Monique STRUBBE,Germany,Middle Blocker,Women,Japan,2022-06-02,Pool,2,5,0,0,0,0,0,0,0,0,0,0,0,4,4,0,0,0,0,1,0,0,1,0,0,0,0
Anastasia CEKULAEV,Germany,Middle Blocker,Women,Japan,2022-06-02,Pool,2,5,0,0,0,0,0,0,0,0,0,0,0,0,0,0,0,0,0,0,0,0,0,0,0,0,0
Linda BOCK,Germany,Libero,Women,Brazil,2022-05-31,Pool,1,4,0,0,0,0,0,0,0,0,0,0,0,0,0,0,1,1,2,0,0,0,0,0,0,0,0
Pia KÄSTNER,Germany,Setter,Women,Brazil,2022-05-31,Pool,1,4,3,1,0,1,2,0,3,2,5,2,0,11,13,0,0,1,1,11,3,0,14,20,0,72,92
Anna POGANY,Germany,Libero,Women,Brazil,2022-05-31,Pool,1,4,0,0,0,0,0,0,0,0,0,0,0,0,0,29,0,14,43,18,2,1,21,0,0,10,10
Corina GLAAB,Germany,Setter,Women,Brazil,2022-05-31,Pool,1,4,0,0,0,0,0,0,1,0,1,0,0,5,5,0,0,0,0,4,2,0,6,11,0,27,38
Jennifer JANISKA,Germany,Outside Hitter,Women,Brazil,2022-05-31,Pool,1,4,15,13,4,15,32,1,1,0,2,1,2,19,22,4,0,4,8,17,3,0,20,0,0,7,7
Ivana VANJAK,Germany,Outside Hitter,Women,Brazil,2022-05-31,Pool,1,4,4,4,2,13,19,0,0,0,0,0,2,4,6,4,0,2,6,1,0,0,1,0,0,0,0
Lina ALSMEIER,Germany,Outside Hitter,Women,Brazil,2022-05-31,Pool,1,4,3,3,2,6,11,0,1,1,2,0,3,3,6,8,0,3,11,4,2,0,6,0,0,0,0
Lena STIGROT,Germany,Outside Hitter,Women,Brazil,2022-05-31,Pool,1,4,10,9,5,18,32,1,2,0,3,0,0,8,8,6,1,10,17,10,2,1,13,0,0,2,2
Hanna ORTHMANN,Germany,Outside Hitter,Women,Brazil,2022-05-31,Pool,1,4,15,14,7,18,39,0,2,0,2,1,2,6,9,2,1,3,6,3,2,0,5,0,0,0,0
Saskia HIPPE,Germany,Opposite Spiker,Women,Brazil,2022-05-31,Pool,1,4,1,1,1,2,4,0,0,0,0,0,0,4,4,0,0,0,0,4,0,0,4,0,0,2,2
Marie SCHÖLZEL,Germany,Middle Blocker,Women,Brazil,2022-05-31,Pool,1,4,10,8,2,3,13,2,6,5,13,0,1,8,9,0,0,0,0,3,0,0,3,0,0,3,3
Camilla WEITZEL,Germany,Middle Blocker,Women,Brazil,2022-05-31,Pool,1,4,13,10,1,5,16,2,6,8,16,1,1,14,16,0,0,0,0,4,0,0,4,0,0,0,0
Monique STRUBBE,Germany,Middle Blocker,Women,Brazil,2022-05-31,Pool,1,4,0,0,0,0,0,0,0,0,0,0,0,0,0,0,0,0,0,0,0,0,0,0,0,0,0
Anastasia CEKULAEV,Germany,Middle Blocker,Women,Brazil,2022-05-31,Pool,1,4,1,1,0,0,1,0,0,0,0,0,0,1,1,1,0,0,1,0,0,0,0,0,0,0,0
Pia KÄSTNER,Germany,Setter,Women,United States,2022-07-03,Pool,1,4,1,0,1,1,2,0,2,1,3,1,0,10,11,0,0,0,0,15,2,0,17,5,0,102,107
Anna POGANY,Germany,Libero,Women,United States,2022-07-03,Pool,1,4,0,0,0,0,0,0,0,0,0,0,0,0,0,8,0,9,17,10,1,0,11,0,0,11,11
Corina GLAAB,Germany,Setter,Women,United States,2022-07-03,Pool,1,4,0,0,0,0,0,0,0,0,0,0,0,0,0,0,0,0,0,0,0,0,0,0,0,0,0
Jennifer JANISKA,Germany,Outside Hitter,Women,United States,2022-07-03,Pool,1,4,3,3,2,5,10,0,0,0,0,0,0,6,6,5,0,4,9,7,1,1,9,0,0,2,2
Ivana VANJAK,Germany,Outside Hitter,Women,United States,2022-07-03,Pool,1,4,3,3,3,3,9,0,0,2,2,0,2,0,2,1,0,2,3,0,2,0,2,0,0,2,2
Lina ALSMEIER,Germany,Outside Hitter,Women,United States,2022-07-03,Pool,1,4,7,7,3,12,22,0,0,0,0,0,1,8,9,3,1,7,11,7,3,0,10,0,0,8,8
Lena STIGROT,Germany,Outside Hitter,Women,United States,2022-07-03,Pool,1,4,6,6,3,10,19,0,0,1,1,0,1,4,5,5,1,8,14,5,0,0,5,0,0,3,3
Hanna ORTHMANN,Germany,Outside Hitter,Women,United States,2022-07-03,Pool,1,4,13,12,7,22,41,1,2,0,3,0,1,7,8,10,1,10,21,11,6,0,17,0,0,3,3
Saskia HIPPE,Germany,Opposite Spiker,Women,United States,2022-07-03,Pool,1,4,5,5,1,5,11,0,0,0,0,0,0,5,5,0,0,0,0,4,0,0,4,0,0,1,1
Marie SCHÖLZEL,Germany,Middle Blocker,Women,United States,2022-07-03,Pool,1,4,5,3,1,5,9,2,0,0,2,0,0,4,4,0,0,0,0,1,1,0,2,0,0,1,1
Camilla WEITZEL,Germany,Middle Blocker,Women,United States,2022-07-03,Pool,1,4,10,5,0,5,10,3,5,2,10,2,2,19,23,0,0,0,0,2,0,1,3,0,0,2,2
Monique STRUBBE,Germany,Middle Blocker,Women,United States,2022-07-03,Pool,1,4,0,0,0,0,0,0,0,0,0,0,0,0,0,0,0,0,0,0,0,0,0,0,0,0,0
Sarah STRAUBE,Germany,Setter,Women,United States,2022-07-03,Pool,1,4,0,0,0,0,0,0,1,0,1,0,0,0,0,0,0,0,0,2,1,0,3,0,0,9,9
Anastasia CEKULAEV,Germany,Middle Blocker,Women,United States,2022-07-03,Pool,1,4,7,6,1,4,11,1,1,2,4,0,1,4,5,0,0,0,0,2,1,0,3,0,0,2,2
Pia KÄSTNER,Germany,Setter,Women,Canada,2022-07-03,Pool,3,4,1,1,0,1,2,0,1,5,6,0,1,7,8,0,0,1,1,7,1,0,8,6,0,86,92
Anna POGANY,Germany,Libero,Women,Canada,2022-07-03,Pool,3,4,0,0,0,0,0,0,0,0,0,0,0,0,0,12,0,8,20,12,3,0,15,0,0,9,9
Corina GLAAB,Germany,Setter,Women,Canada,2022-07-03,Pool,3,4,1,0,0,0,0,0,1,0,1,1,0,7,8,0,0,0,0,4,0,0,4,0,0,14,14
Jennifer JANISKA,Germany,Outside Hitter,Women,Canada,2022-07-03,Pool,3,4,7,6,2,12,20,0,3,2,5,1,0,9,10,7,0,5,12,11,3,0,14,0,0,5,5
Ivana VANJAK,Germany,Outside Hitter,Women,Canada,2022-07-03,Pool,3,4,15,13,3,18,34,1,3,0,4,1,2,5,8,1,0,1,2,8,2,0,10,0,0,2,2
Lina ALSMEIER,Germany,Outside Hitter,Women,Canada,2022-07-03,Pool,3,4,2,1,4,5,10,0,0,0,0,1,0,5,6,7,0,5,12,3,3,0,6,0,0,3,3
Lena STIGROT,Germany,Outside Hitter,Women,Canada,2022-07-03,Pool,3,4,0,0,0,0,0,0,0,0,0,0,1,4,5,2,0,5,7,3,0,0,3,0,0,0,0
Hanna ORTHMANN,Germany,Outside Hitter,Women,Canada,2022-07-03,Pool,3,4,21,18,3,17,38,0,4,1,5,3,4,12,19,7,1,11,19,5,2,0,7,0,0,5,5
Saskia HIPPE,Germany,Opposite Spiker,Women,Canada,2022-07-03,Pool,3,4,0,0,0,0,0,0,0,0,0,0,0,1,1,0,0,0,0,0,0,0,0,0,0,0,0
Marie SCHÖLZEL,Germany,Middle Blocker,Women,Canada,2022-07-03,Pool,3,4,5,4,2,4,10,1,9,6,16,0,0,11,11,1,0,0,1,3,0,0,3,0,0,2,2
Camilla WEITZEL,Germany,Middle Blocker,Women,Canada,2022-07-03,Pool,3,4,12,10,2,5,17,2,5,0,7,0,0,19,19,0,0,0,0,3,0,0,3,0,0,1,1
Monique STRUBBE,Germany,Middle Blocker,Women,Canada,2022-07-03,Pool,3,4,0,0,0,0,0,0,0,0,0,0,0,0,0,0,0,0,0,0,0,0,0,0,0,0,0
Sarah STRAUBE,Germany,Setter,Women,Canada,2022-07-03,Pool,3,4,0,0,0,0,0,0,0,0,0,0,0,0,0,0,0,0,0,0,0,0,0,0,0,0,0
Anastasia CEKULAEV,Germany,Middle Blocker,Women,Canada,2022-07-03,Pool,3,4,0,0,0,0,0,0,0,0,0,0,0,0,0,0,0,0,0,0,0,0,0,0,0,0,0
Pia KÄSTNER,Germany,Setter,Women,Belgium,2022-06-30,Pool,3,4,3,2,0,2,4,0,1,0,1,1,0,12,13,0,0,0,0,16,0,0,16,7,0,97,104
Anna POGANY,Germany,Libero,Women,Belgium,2022-06-30,Pool,3,4,0,0,0,0,0,0,0,0,0,0,0,0,0,12,2,4,18,11,1,0,12,0,0,16,16
Corina GLAAB,Germany,Setter,Women,Belgium,2022-06-30,Pool,3,4,0,0,0,0,0,0,0,0,0,0,0,0,0,0,0,0,0,0,0,0,0,0,0,5,5
Jennifer JANISKA,Germany,Outside Hitter,Women,Belgium,2022-06-30,Pool,3,4,7,7,4,15,26,0,2,1,3,0,1,21,22,9,0,6,15,14,3,0,17,0,0,13,13
Ivana VANJAK,Germany,Outside Hitter,Women,Belgium,2022-06-30,Pool,3,4,0,0,0,0,0,0,0,0,0,0,0,0,0,0,0,0,0,0,0,0,0,0,0,0,0
Lina ALSMEIER,Germany,Outside Hitter,Women,Belgium,2022-06-30,Pool,3,4,28,27,3,17,47,0,0,2,2,1,3,7,11,7,0,3,10,9,0,0,9,0,0,6,6
Lena STIGROT,Germany,Outside Hitter,Women,Belgium,2022-06-30,Pool,3,4,14,13,1,12,26,1,7,0,8,0,1,12,13,12,0,16,28,9,2,0,11,0,0,3,3
Hanna ORTHMANN,Germany,Outside Hitter,Women,Belgium,2022-06-30,Pool,3,4,5,5,2,10,17,0,0,1,1,0,1,4,5,0,0,2,2,3,1,0,4,0,0,1,1
Saskia HIPPE,Germany,Opposite Spiker,Women,Belgium,2022-06-30,Pool,3,4,0,0,0,0,0,0,0,0,0,0,0,0,0,0,0,0,0,1,0,0,1,0,0,0,0
Marie SCHÖLZEL,Germany,Middle Blocker,Women,Belgium,2022-06-30,Pool,3,4,2,2,1,0,3,0,4,3,7,0,1,1,2,0,0,0,0,0,0,0,0,0,0,1,1
Camilla WEITZEL,Germany,Middle Blocker,Women,Belgium,2022-06-30,Pool,3,4,12,8,0,4,12,2,6,1,9,2,1,17,20,1,0,0,1,1,2,0,3,0,0,0,0
Monique STRUBBE,Germany,Middle Blocker,Women,Belgium,2022-06-30,Pool,3,4,0,0,0,0,0,0,0,0,0,0,0,0,0,0,0,0,0,0,0,0,0,0,0,0,0
Sarah STRAUBE,Germany,Setter,Women,Belgium,2022-06-30,Pool,3,4,0,0,0,0,0,0,0,0,0,0,0,0,0,0,0,0,0,0,0,0,0,0,0,0,0
Anastasia CEKULAEV,Germany,Middle Blocker,Women,Belgium,2022-06-30,Pool,3,4,5,5,1,5,11,0,2,0,2,0,0,7,7,0,0,0,0,1,0,0,1,0,0,1,1
Pia KÄSTNER,Germany,Setter,Women,Serbia,2022-06-28,Pool,1,4,0,0,0,1,1,0,1,2,3,0,0,14,14,0,0,0,0,10,1,0,11,19,0,84,103
Anna POGANY,Germany,Libero,Women,Serbia,2022-06-28,Pool,1,4,0,0,0,0,0,0,0,0,0,0,0,0,0,2,0,8,10,7,3,0,10,1,0,12,13
Corina GLAAB,Germany,Setter,Women,Serbia,2022-06-28,Pool,1,4,0,0,0,0,0,0,0,0,0,0,0,0,0,0,0,0,0,0,0,0,0,0,0,0,0
Jennifer JANISKA,Germany,Outside Hitter,Women,Serbia,2022-06-28,Pool,1,4,4,3,1,5,9,1,0,0,1,0,0,2,2,2,0,8,10,4,0,0,4,0,0,1,1
Ivana VANJAK,Germany,Outside Hitter,Women,Serbia,2022-06-28,Pool,1,4,1,1,1,2,4,0,2,1,3,0,0,3,3,1,0,3,4,2,0,0,2,0,0,0,0
Lina ALSMEIER,Germany,Outside Hitter,Women,Serbia,2022-06-28,Pool,1,4,12,9,4,11,24,1,2,1,4,2,3,9,14,2,2,30,34,5,1,2,8,0,0,3,3
Lena STIGROT,Germany,Outside Hitter,Women,Serbia,2022-06-28,Pool,1,4,7,6,2,8,16,1,2,4,7,0,0,5,5,4,0,6,10,7,1,0,8,0,0,2,2
Hanna ORTHMANN,Germany,Outside Hitter,Women,Serbia,2022-06-28,Pool,1,4,14,13,9,16,38,1,3,1,5,0,3,7,10,2,0,10,12,2,1,0,3,0,0,2,2
Saskia HIPPE,Germany,Opposite Spiker,Women,Serbia,2022-06-28,Pool,1,4,2,2,2,2,6,0,1,0,1,0,0,4,4,0,0,0,0,1,0,0,1,0,0,0,0
Marie SCHÖLZEL,Germany,Middle Blocker,Women,Serbia,2022-06-28,Pool,1,4,6,4,2,3,9,0,5,3,8,2,1,14,17,0,0,0,0,2,1,0,3,0,0,0,0
Camilla WEITZEL,Germany,Middle Blocker,Women,Serbia,2022-06-28,Pool,1,4,13,10,2,11,23,2,6,3,11,1,0,11,12,0,1,1,2,4,0,0,4,0,0,1,1
Monique STRUBBE,Germany,Middle Blocker,Women,Serbia,2022-06-28,Pool,1,4,0,0,0,0,0,0,0,0,0,0,0,0,0,0,0,0,0,0,0,0,0,0,0,0,0
Sarah STRAUBE,Germany,Setter,Women,Serbia,2022-06-28,Pool,1,4,0,0,0,0,0,0,0,0,0,0,0,0,0,0,0,0,0,0,0,0,0,0,0,0,0
Anastasia CEKULAEV,Germany,Middle Blocker,Women,Serbia,2022-06-28,Pool,1,4,0,0,0,0,0,0,0,0,0,0,0,0,0,0,0,0,0,0,0,0,0,0,0,0,0
Marina LUBIAN,Italy,Middle Blocker,Women,Brazil,2022-07-17,Finals (Gold),3,3,0,0,0,0,0,0,0,0,0,0,1,1,2,0,0,0,0,0,0,0,0,0,0,0,0
Alessia GENNARI,Italy,Outside Hitter,Women,Brazil,2022-07-17,Finals (Gold),3,3,0,0,0,0,0,0,0,0,0,0,0,0,0,0,0,0,0,0,0,0,0,0,0,0,0
Sara BONIFACIO,Italy,Middle Blocker,Women,Brazil,2022-07-17,Finals (Gold),3,3,0,0,0,0,0,0,0,0,0,0,0,0,0,0,0,0,0,0,0,0,0,0,0,0,0
Ofelia MALINOV,Italy,Setter,Women,Brazil,2022-07-17,Finals (Gold),3,3,1,1,0,0,1,0,0,1,1,0,0,0,0,0,0,0,0,0,0,0,0,0,0,5,5
Monica DE GENNARO,Italy,Libero,Women,Brazil,2022-07-17,Finals (Gold),3,3,0,0,0,0,0,0,0,0,0,0,0,0,0,4,1,1,6,7,4,4,15,0,0,7,7
Eleonora FERSINO,Italy,Libero,Women,Brazil,2022-07-17,Finals (Gold),3,3,0,0,0,0,0,0,0,0,0,0,0,0,0,0,0,0,0,0,1,0,1,0,0,0,0
Alessia ORRO,Italy,Setter,Women,Brazil,2022-07-17,Finals (Gold),3,3,0,0,0,4,4,0,0,2,2,0,1,8,9,1,1,1,3,4,5,3,12,19,0,58,77
Caterina Chiara BOSETTI,Italy,Outside Hitter,Women,Brazil,2022-07-17,Finals (Gold),3,3,11,10,0,7,17,0,0,1,1,1,1,8,10,6,1,6,13,3,4,2,9,0,1,7,8
Cristina CHIRICHELLA,Italy,Middle Blocker,Women,Brazil,2022-07-17,Finals (Gold),3,3,9,6,1,2,9,2,2,0,4,1,2,8,11,0,0,0,0,2,0,0,2,0,0,0,0
Anna DANESI,Italy,Middle Blocker,Women,Brazil,2022-07-17,Finals (Gold),3,3,9,8,0,0,8,1,5,6,12,0,1,16,17,0,0,0,0,3,1,2,6,0,0,1,1
Elena PIETRINI,Italy,Outside Hitter,Women,Brazil,2022-07-17,Finals (Gold),3,3,8,7,3,7,17,1,1,1,3,0,1,14,15,15,0,28,43,8,1,1,10,0,0,2,2
Sylvia Chinelo NWAKALOR,Italy,Opposite Spiker,Women,Brazil,2022-07-17,Finals (Gold),3,3,0,0,0,0,0,0,0,0,0,0,0,0,0,0,0,0,0,0,0,0,0,0,0,0,0
Miryam Fatime SYLLA,Italy,Outside Hitter,Women,Brazil,2022-07-17,Finals (Gold),3,3,0,0,0,0,0,0,0,0,0,0,0,0,0,0,0,0,0,0,0,0,0,0,0,0,0
Paola Ogechi EGONU,Italy,Opposite Spiker,Women,Brazil,2022-07-17,Finals (Gold),3,3,21,18,8,16,42,3,3,3,9,0,3,7,10,0,0,0,0,4,4,1,9,0,0,0,0
Marina LUBIAN,Italy,Middle Blocker,Women,Türkiye,2022-07-16,Semifinals,3,3,0,0,0,0,0,0,0,0,0,0,0,3,3,0,0,0,0,0,0,0,0,0,0,0,0
Alessia GENNARI,Italy,Outside Hitter,Women,Türkiye,2022-07-16,Semifinals,3,3,0,0,0,0,0,0,0,0,0,0,0,0,0,0,0,4,4,3,0,0,3,0,0,0,0
Sara BONIFACIO,Italy,Middle Blocker,Women,Türkiye,2022-07-16,Semifinals,3,3,0,0,0,0,0,0,0,0,0,0,0,0,0,0,0,0,0,0,0,0,0,0,0,0,0
Ofelia MALINOV,Italy,Setter,Women,Türkiye,2022-07-16,Semifinals,3,3,0,0,0,0,0,0,0,0,0,0,0,0,0,0,0,0,0,0,0,0,0,1,0,1,2
Monica DE GENNARO,Italy,Libero,Women,Türkiye,2022-07-16,Semifinals,3,3,0,0,0,0,0,0,0,0,0,0,0,0,0,6,0,3,9,11,1,1,13,0,0,13,13
Eleonora FERSINO,Italy,Libero,Women,Türkiye,2022-07-16,Semifinals,3,3,0,0,0,0,0,0,0,0,0,0,0,0,0,0,0,0,0,0,0,0,0,0,0,0,0
Alessia ORRO,Italy,Setter,Women,Türkiye,2022-07-16,Semifinals,3,3,1,1,0,0,1,0,0,3,3,0,0,16,16,0,1,0,1,11,2,0,13,15,1,69,85
Caterina Chiara BOSETTI,Italy,Outside Hitter,Women,Türkiye,2022-07-16,Semifinals,3,3,11,9,2,11,22,1,3,0,4,1,3,9,13,9,0,11,20,16,1,0,17,0,0,5,5
Cristina CHIRICHELLA,Italy,Middle Blocker,Women,Türkiye,2022-07-16,Semifinals,3,3,4,4,2,3,9,0,4,2,6,0,2,8,10,0,0,0,0,4,2,0,6,0,1,3,4
Anna DANESI,Italy,Middle Blocker,Women,Türkiye,2022-07-16,Semifinals,3,3,9,4,2,4,10,5,8,2,15,0,2,6,8,0,0,0,0,2,3,0,5,0,0,0,0
Elena PIETRINI,Italy,Outside Hitter,Women,Türkiye,2022-07-16,Semifinals,3,3,8,7,1,12,20,1,3,3,7,0,0,16,16,9,1,11,21,5,0,1,6,0,0,0,0
Sylvia Chinelo NWAKALOR,Italy,Opposite Spiker,Women,Türkiye,2022-07-16,Semifinals,3,3,0,0,0,0,0,0,0,0,0,0,0,0,0,0,0,0,0,0,0,0,0,0,0,0,0
Miryam Fatime SYLLA,Italy,Outside Hitter,Women,Türkiye,2022-07-16,Semifinals,3,3,0,0,0,2,2,0,0,0,0,0,0,0,0,1,0,3,4,0,0,0,0,0,0,0,0
Paola Ogechi EGONU,Italy,Opposite Spiker,Women,Türkiye,2022-07-16,Semifinals,3,3,26,22,5,18,45,3,2,4,9,1,2,8,11,0,0,0,0,2,2,0,4,0,0,2,2
Marina LUBIAN,Italy,Middle Blocker,Women,China,2022-07-14,Quarterfinals,3,4,2,1,1,0,2,1,0,0,1,0,2,2,4,0,0,0,0,0,1,0,1,0,0,0,0
Alessia GENNARI,Italy,Outside Hitter,Women,China,2022-07-14,Quarterfinals,3,4,0,0,0,0,0,0,0,0,0,0,0,0,0,0,0,0,0,0,0,0,0,0,0,0,0
Sara BONIFACIO,Italy,Middle Blocker,Women,China,2022-07-14,Quarterfinals,3,4,0,0,0,0,0,0,0,0,0,0,0,0,0,0,0,0,0,0,0,0,0,0,0,0,0
Ofelia MALINOV,Italy,Setter,Women,China,2022-07-14,Quarterfinals,3,4,1,1,0,0,1,0,0,3,3,0,0,5,5,0,0,0,0,3,0,0,3,6,0,27,33
Monica DE GENNARO,Italy,Libero,Women,China,2022-07-14,Quarterfinals,3,4,0,0,0,0,0,0,0,0,0,0,0,0,0,9,0,2,11,19,4,3,26,0,0,9,9
Eleonora FERSINO,Italy,Libero,Women,China,2022-07-14,Quarterfinals,3,4,0,0,0,0,0,0,0,0,0,0,0,0,0,0,0,0,0,0,0,0,0,0,0,0,0
Alessia ORRO,Italy,Setter,Women,China,2022-07-14,Quarterfinals,3,4,2,2,0,1,3,0,2,0,2,0,0,12,12,0,0,1,1,8,5,1,14,17,0,80,97
Caterina Chiara BOSETTI,Italy,Outside Hitter,Women,China,2022-07-14,Quarterfinals,3,4,14,11,1,13,25,1,3,2,6,2,2,10,14,21,2,16,39,7,2,0,9,0,0,5,5
Cristina CHIRICHELLA,Italy,Middle Blocker,Women,China,2022-07-14,Quarterfinals,3,4,9,7,1,8,16,1,3,7,11,1,2,12,15,1,0,0,1,6,0,0,6,0,0,2,2
Anna DANESI,Italy,Middle Blocker,Women,China,2022-07-14,Quarterfinals,3,4,8,5,1,4,10,3,3,2,8,0,1,11,12,0,0,1,1,5,0,0,5,0,0,2,2
Elena PIETRINI,Italy,Outside Hitter,Women,China,2022-07-14,Quarterfinals,3,4,6,4,3,4,11,1,1,1,3,1,1,8,10,7,0,4,11,3,0,0,3,0,0,0,0
Sylvia Chinelo NWAKALOR,Italy,Opposite Spiker,Women,China,2022-07-14,Quarterfinals,3,4,0,0,0,0,0,0,0,0,0,0,0,0,0,0,0,0,0,0,0,0,0,0,0,0,0
Miryam Fatime SYLLA,Italy,Outside Hitter,Women,China,2022-07-14,Quarterfinals,3,4,5,5,6,10,21,0,1,2,3,0,0,6,6,6,0,14,20,10,1,0,11,0,0,3,3
Paola Ogechi EGONU,Italy,Opposite Spiker,Women,China,2022-07-14,Quarterfinals,3,4,36,32,10,24,66,0,4,1,5,4,1,15,20,0,0,0,0,10,5,1,16,0,0,2,2
Marina LUBIAN,Italy,Middle Blocker,Women,Thailand,2022-07-03,Pool,3,3,0,0,0,0,0,0,0,0,0,0,0,0,0,0,0,0,0,0,0,0,0,0,0,0,0
Alessia GENNARI,Italy,Outside Hitter,Women,Thailand,2022-07-03,Pool,3,3,0,0,0,0,0,0,0,0,0,0,0,0,0,0,0,0,0,0,0,0,0,0,0,0,0
Sara BONIFACIO,Italy,Middle Blocker,Women,Thailand,2022-07-03,Pool,3,3,0,0,0,0,0,0,0,0,0,0,0,0,0,0,0,0,0,0,0,0,0,0,0,0,0
Ofelia MALINOV,Italy,Setter,Women,Thailand,2022-07-03,Pool,3,3,0,0,0,0,0,0,0,0,0,0,0,0,0,0,0,0,0,0,0,0,0,0,0,0,0
Monica DE GENNARO,Italy,Libero,Women,Thailand,2022-07-03,Pool,3,3,0,0,0,0,0,0,0,0,0,0,0,0,0,6,0,2,8,13,1,1,15,0,0,2,2
Eleonora FERSINO,Italy,Libero,Women,Thailand,2022-07-03,Pool,3,3,0,0,0,0,0,0,0,0,0,0,0,0,0,2,0,0,2,1,0,0,1,0,0,0,0
Alessia ORRO,Italy,Setter,Women,Thailand,2022-07-03,Pool,3,3,2,1,0,1,2,0,2,0,2,1,1,17,19,0,0,0,0,8,2,2,12,10,0,75,85
Cristina CHIRICHELLA,Italy,Middle Blocker,Women,Thailand,2022-07-03,Pool,3,3,7,7,0,5,12,0,3,3,6,0,2,8,10,0,0,0,0,1,1,0,2,0,0,0,0
Anna DANESI,Italy,Middle Blocker,Women,Thailand,2022-07-03,Pool,3,3,9,6,0,4,10,2,3,5,10,1,1,9,11,0,0,0,0,2,1,0,3,0,0,0,0
Elena PIETRINI,Italy,Outside Hitter,Women,Thailand,2022-07-03,Pool,3,3,12,8,0,8,16,3,3,0,6,1,2,7,10,4,0,14,18,3,1,1,5,0,0,0,0
Sylvia Chinelo NWAKALOR,Italy,Opposite Spiker,Women,Thailand,2022-07-03,Pool,3,3,0,0,0,0,0,0,0,0,0,0,0,0,0,0,0,0,0,0,0,0,0,0,0,0,0
Miryam Fatime SYLLA,Italy,Outside Hitter,Women,Thailand,2022-07-03,Pool,3,3,9,9,1,6,16,0,0,2,2,0,0,9,9,4,0,15,19,4,4,5,13,0,1,0,1
Paola Ogechi EGONU,Italy,Opposite Spiker,Women,Thailand,2022-07-03,Pool,3,3,24,19,4,10,33,1,1,1,3,4,1,9,14,0,0,0,0,4,2,2,8,0,1,1,2
Alice Carlotta DEGRADI,Italy,Outside Hitter,Women,Thailand,2022-07-03,Pool,3,3,0,0,0,0,0,0,0,0,0,0,0,0,0,0,0,0,0,0,0,0,0,0,0,0,0
Marina LUBIAN,Italy,Middle Blocker,Women,Bulgaria,2022-07-02,Pool,3,3,0,0,0,0,0,0,0,0,0,0,0,0,0,0,0,0,0,0,0,0,0,0,0,0,0
Alessia GENNARI,Italy,Outside Hitter,Women,Bulgaria,2022-07-02,Pool,3,3,9,8,0,8,16,1,3,0,4,0,1,14,15,2,0,14,16,8,2,1,11,0,0,0,0
Sara BONIFACIO,Italy,Middle Blocker,Women,Bulgaria,2022-07-02,Pool,3,3,0,0,0,0,0,0,0,0,0,0,0,0,0,0,0,0,0,0,0,0,0,0,0,0,0
Ofelia MALINOV,Italy,Setter,Women,Bulgaria,2022-07-02,Pool,3,3,0,0,0,0,0,0,0,0,0,0,0,0,0,0,0,0,0,0,0,0,0,0,0,0,0
Monica DE GENNARO,Italy,Libero,Women,Bulgaria,2022-07-02,Pool,3,3,0,0,0,0,0,0,0,0,0,0,0,0,0,1,1,4,6,8,4,1,13,0,0,1,1
Eleonora FERSINO,Italy,Libero,Women,Bulgaria,2022-07-02,Pool,3,3,0,0,0,0,0,0,0,0,0,0,0,0,0,0,0,0,0,0,0,0,0,0,0,0,0
Alessia ORRO,Italy,Setter,Women,Bulgaria,2022-07-02,Pool,3,3,3,2,0,1,3,0,5,3,8,1,2,11,14,0,0,0,0,3,1,1,5,6,2,73,81
Cristina CHIRICHELLA,Italy,Middle Blocker,Women,Bulgaria,2022-07-02,Pool,3,3,8,5,0,4,9,2,6,6,14,1,2,11,14,0,0,0,0,4,0,1,5,0,0,0,0
Anna DANESI,Italy,Middle Blocker,Women,Bulgaria,2022-07-02,Pool,3,3,9,6,1,1,8,1,4,5,10,2,2,8,12,0,0,0,0,1,0,0,1,0,0,0,0
Elena PIETRINI,Italy,Outside Hitter,Women,Bulgaria,2022-07-02,Pool,3,3,20,18,0,9,27,2,3,1,6,0,0,11,11,3,3,19,25,5,1,1,7,0,0,0,0
Sylvia Chinelo NWAKALOR,Italy,Opposite Spiker,Women,Bulgaria,2022-07-02,Pool,3,3,12,11,2,6,19,1,2,3,6,0,1,7,8,0,0,0,0,4,0,1,5,0,0,0,0
Miryam Fatime SYLLA,Italy,Outside Hitter,Women,Bulgaria,2022-07-02,Pool,3,3,0,0,0,0,0,0,0,0,0,0,0,0,0,0,0,0,0,0,0,0,0,0,0,0,0
Paola Ogechi EGONU,Italy,Opposite Spiker,Women,Bulgaria,2022-07-02,Pool,3,3,0,0,0,0,0,0,0,0,0,0,0,0,0,0,0,0,0,0,0,0,0,0,0,0,0
Alice Carlotta DEGRADI,Italy,Outside Hitter,Women,Bulgaria,2022-07-02,Pool,3,3,0,0,0,0,0,0,0,0,0,0,0,0,0,0,0,0,0,0,0,0,0,0,0,0,0
Marina LUBIAN,Italy,Middle Blocker,Women,Korea,2022-07-01,Pool,3,4,0,0,0,0,0,0,0,0,0,0,0,0,0,0,0,0,0,0,0,0,0,0,0,0,0
Alessia GENNARI,Italy,Outside Hitter,Women,Korea,2022-07-01,Pool,3,4,0,0,0,0,0,0,0,0,0,0,0,0,0,0,0,0,0,0,1,0,1,0,0,0,0
Sara BONIFACIO,Italy,Middle Blocker,Women,Korea,2022-07-01,Pool,3,4,5,5,1,8,14,0,3,5,8,0,1,10,11,0,0,0,0,0,4,0,4,0,0,0,0
Ofelia MALINOV,Italy,Setter,Women,Korea,2022-07-01,Pool,3,4,3,1,1,3,5,2,2,2,6,0,2,9,11,0,0,0,0,4,2,1,7,13,1,85,99
Monica DE GENNARO,Italy,Libero,Women,Korea,2022-07-01,Pool,3,4,0,0,0,0,0,0,0,0,0,0,0,0,0,0,0,0,0,0,0,0,0,0,0,0,0
Eleonora FERSINO,Italy,Libero,Women,Korea,2022-07-01,Pool,3,4,0,0,0,0,0,0,0,0,0,0,0,0,0,9,1,13,23,22,1,2,25,0,1,3,4
Alessia ORRO,Italy,Setter,Women,Korea,2022-07-01,Pool,3,4,0,0,0,0,0,0,0,0,0,0,0,6,6,0,0,0,0,1,0,0,1,1,0,12,13
Cristina CHIRICHELLA,Italy,Middle Blocker,Women,Korea,2022-07-01,Pool,3,4,8,7,0,5,12,0,5,4,9,1,0,12,13,0,0,0,0,4,0,1,5,0,0,0,0
Anna DANESI,Italy,Middle Blocker,Women,Korea,2022-07-01,Pool,3,4,0,0,0,0,0,0,0,0,0,0,0,0,0,0,0,0,0,0,0,0,0,0,0,0,0
Elena PIETRINI,Italy,Outside Hitter,Women,Korea,2022-07-01,Pool,3,4,0,0,0,0,0,0,0,0,0,0,0,0,0,0,0,0,0,0,0,0,0,0,0,0,0
Sylvia Chinelo NWAKALOR,Italy,Opposite Spiker,Women,Korea,2022-07-01,Pool,3,4,21,17,6,13,36,4,6,1,11,0,1,20,21,0,0,0,0,11,0,1,12,0,0,3,3
Miryam Fatime SYLLA,Italy,Outside Hitter,Women,Korea,2022-07-01,Pool,3,4,17,13,5,16,34,4,2,2,8,0,2,11,13,3,0,17,20,9,1,1,11,1,0,3,4
Paola Ogechi EGONU,Italy,Opposite Spiker,Women,Korea,2022-07-01,Pool,3,4,0,0,0,0,0,0,0,0,0,0,0,0,0,0,0,0,0,0,0,0,0,0,0,0,0
Alice Carlotta DEGRADI,Italy,Outside Hitter,Women,Korea,2022-07-01,Pool,3,4,15,12,7,6,25,1,2,3,6,2,4,16,22,2,0,20,22,5,4,2,11,0,0,3,3
Marina LUBIAN,Italy,Middle Blocker,Women,Poland,2022-06-29,Pool,3,4,0,0,0,0,0,0,1,0,1,0,1,2,3,0,0,0,0,0,0,0,0,0,0,0,0
Alessia GENNARI,Italy,Outside Hitter,Women,Poland,2022-06-29,Pool,3,4,6,5,2,12,19,1,4,2,7,0,2,12,14,3,0,18,21,16,2,4,22,1,0,0,1
Sara BONIFACIO,Italy,Middle Blocker,Women,Poland,2022-06-29,Pool,3,4,0,0,0,0,0,0,0,0,0,0,0,0,0,0,0,0,0,0,0,0,0,0,0,0,0
Ofelia MALINOV,Italy,Setter,Women,Poland,2022-06-29,Pool,3,4,1,1,1,0,2,0,4,0,4,0,3,7,10,0,0,1,1,0,2,0,2,76,0,0,76
Monica DE GENNARO,Italy,Libero,Women,Poland,2022-06-29,Pool,3,4,0,0,0,0,0,0,0,0,0,0,0,0,0,5,0,9,14,13,3,4,20,7,0,0,7
Eleonora FERSINO,Italy,Libero,Women,Poland,2022-06-29,Pool,3,4,0,0,0,0,0,0,0,0,0,0,0,0,0,0,0,0,0,0,0,0,0,0,0,0,0
Alessia ORRO,Italy,Setter,Women,Poland,2022-06-29,Pool,3,4,3,1,0,1,2,1,1,2,4,1,0,13,14,0,0,0,0,3,1,1,5,35,2,0,37
Cristina CHIRICHELLA,Italy,Middle Blocker,Women,Poland,2022-06-29,Pool,3,4,8,7,1,3,11,1,3,3,7,0,2,12,14,0,0,1,1,0,1,0,1,0,0,0,0
Anna DANESI,Italy,Middle Blocker,Women,Poland,2022-06-29,Pool,3,4,13,6,2,4,12,7,1,5,13,0,2,9,11,0,0,1,1,3,0,2,5,1,1,0,2
Elena PIETRINI,Italy,Outside Hitter,Women,Poland,2022-06-29,Pool,3,4,0,0,0,0,0,0,0,0,0,0,0,0,0,0,0,0,0,0,0,0,0,0,0,0,0
Sylvia Chinelo NWAKALOR,Italy,Opposite Spiker,Women,Poland,2022-06-29,Pool,3,4,0,0,1,1,2,0,0,1,1,0,0,0,0,0,0,0,0,1,0,0,1,0,0,0,0
Miryam Fatime SYLLA,Italy,Outside Hitter,Women,Poland,2022-06-29,Pool,3,4,1,0,0,0,0,0,0,0,0,1,0,2,3,0,1,0,1,0,0,0,0,0,0,0,0
Paola Ogechi EGONU,Italy,Opposite Spiker,Women,Poland,2022-06-29,Pool,3,4,29,26,5,21,52,2,1,3,6,1,6,7,14,0,0,0,0,6,0,2,8,1,1,0,2
Alice Carlotta DEGRADI,Italy,Outside Hitter,Women,Poland,2022-06-29,Pool,3,4,19,16,7,13,36,2,4,1,7,1,2,16,19,6,3,33,42,9,2,0,11,2,0,1,3
Marina LUBIAN,Italy,Middle Blocker,Women,Brazil,2022-06-18,Pool,3,4,9,7,0,4,11,1,1,5,7,1,2,15,18,0,0,0,0,5,1,0,6,0,0,0,0
Francesca BOSIO,Italy,Setter,Women,Brazil,2022-06-18,Pool,3,4,0,0,0,0,0,0,0,0,0,0,0,1,1,0,0,0,0,0,0,0,0,2,0,6,8
Sara BONIFACIO,Italy,Middle Blocker,Women,Brazil,2022-06-18,Pool,3,4,10,3,1,4,8,7,3,1,11,0,1,11,12,0,0,0,0,1,0,1,2,0,0,0,0
Ofelia MALINOV,Italy,Setter,Women,Brazil,2022-06-18,Pool,3,4,4,0,0,1,1,4,1,4,9,0,0,14,14,0,0,0,0,3,1,0,4,21,0,45,66
Monica DE GENNARO,Italy,Libero,Women,Brazil,2022-06-18,Pool,3,4,0,0,0,0,0,0,0,0,0,0,0,0,0,7,0,5,12,4,3,0,7,0,0,6,6
Eleonora FERSINO,Italy,Libero,Women,Brazil,2022-06-18,Pool,3,4,0,0,0,0,0,0,0,0,0,0,0,0,0,3,0,3,6,1,1,0,2,0,0,0,0
Caterina Chiara BOSETTI,Italy,Outside Hitter,Women,Brazil,2022-06-18,Pool,3,4,7,6,5,0,11,1,1,1,3,0,2,13,15,6,3,5,14,7,0,0,7,0,0,4,4
Cristina CHIRICHELLA,Italy,Middle Blocker,Women,Brazil,2022-06-18,Pool,3,4,0,0,0,0,0,0,0,0,0,0,0,0,0,0,0,0,0,0,0,0,0,0,0,0,0
Anna DANESI,Italy,Middle Blocker,Women,Brazil,2022-06-18,Pool,3,4,0,0,0,0,0,0,0,0,0,0,0,0,0,0,0,0,0,0,0,0,0,0,0,0,0
Anastasia GUERRA,Italy,Outside Hitter,Women,Brazil,2022-06-18,Pool,3,4,1,1,0,2,3,0,1,0,1,0,0,1,1,0,0,2,2,1,0,0,1,0,0,1,1
Sylvia Chinelo NWAKALOR,Italy,Opposite Spiker,Women,Brazil,2022-06-18,Pool,3,4,0,0,0,0,0,0,0,0,0,0,0,0,0,0,0,0,0,0,0,0,0,0,0,0,0
Miryam Fatime SYLLA,Italy,Outside Hitter,Women,Brazil,2022-06-18,Pool,3,4,0,0,0,0,0,0,0,0,0,0,0,0,0,0,0,0,0,0,0,0,0,0,0,0,0
Paola Ogechi EGONU,Italy,Opposite Spiker,Women,Brazil,2022-06-18,Pool,3,4,22,20,5,13,38,2,4,2,8,0,3,11,14,0,0,0,0,3,2,0,5,0,0,0,0
Alice Carlotta DEGRADI,Italy,Outside Hitter,Women,Brazil,2022-06-18,Pool,3,4,10,10,3,6,19,0,3,1,4,0,4,9,13,5,2,20,27,4,1,1,6,0,0,1,1
Marina LUBIAN,Italy,Middle Blocker,Women,Germany,2022-06-17,Pool,3,3,1,0,0,0,0,0,0,0,0,1,1,3,5,0,0,0,0,0,0,0,0,0,0,0,0
Francesca BOSIO,Italy,Setter,Women,Germany,2022-06-17,Pool,3,3,0,0,0,0,0,0,0,0,0,0,0,1,1,0,0,0,0,0,0,0,0,0,0,1,1
Sara BONIFACIO,Italy,Middle Blocker,Women,Germany,2022-06-17,Pool,3,3,0,0,0,0,0,0,0,0,0,0,0,0,0,0,0,0,0,0,0,0,0,0,0,0,0
Ofelia MALINOV,Italy,Setter,Women,Germany,2022-06-17,Pool,3,3,5,3,0,2,5,2,2,6,10,0,0,15,15,0,0,0,0,1,2,0,3,28,1,60,89
Monica DE GENNARO,Italy,Libero,Women,Germany,2022-06-17,Pool,3,3,0,0,0,0,0,0,0,0,0,0,0,0,0,6,0,4,10,14,0,1,15,0,0,5,5
Eleonora FERSINO,Italy,Libero,Women,Germany,2022-06-17,Pool,3,3,0,0,0,0,0,0,0,0,0,0,0,0,0,1,0,2,3,1,0,0,1,0,0,0,0
Caterina Chiara BOSETTI,Italy,Outside Hitter,Women,Germany,2022-06-17,Pool,3,3,11,11,2,2,15,0,0,3,3,0,0,13,13,8,2,7,17,5,1,0,6,0,0,1,1
Cristina CHIRICHELLA,Italy,Middle Blocker,Women,Germany,2022-06-17,Pool,3,3,9,6,3,5,14,3,3,4,10,0,0,11,11,0,0,1,1,2,1,0,3,0,0,1,1
Anna DANESI,Italy,Middle Blocker,Women,Germany,2022-06-17,Pool,3,3,7,4,2,3,9,3,2,4,9,0,2,5,7,0,0,0,0,1,1,0,2,0,0,1,1
Anastasia GUERRA,Italy,Outside Hitter,Women,Germany,2022-06-17,Pool,3,3,0,0,0,0,0,0,0,0,0,0,0,0,0,0,0,0,0,0,0,0,0,0,0,0,0
Sylvia Chinelo NWAKALOR,Italy,Opposite Spiker,Women,Germany,2022-06-17,Pool,3,3,0,0,0,0,0,0,0,0,0,0,0,0,0,0,0,0,0,0,0,0,0,0,0,0,0
Miryam Fatime SYLLA,Italy,Outside Hitter,Women,Germany,2022-06-17,Pool,3,3,0,0,0,0,0,0,0,0,0,0,0,0,0,0,0,0,0,0,0,0,0,0,0,0,0
Paola Ogechi EGONU,Italy,Opposite Spiker,Women,Germany,2022-06-17,Pool,3,3,22,22,8,11,41,0,2,1,3,0,3,8,11,0,0,0,0,3,2,1,6,0,0,2,2
Alice Carlotta DEGRADI,Italy,Outside Hitter,Women,Germany,2022-06-17,Pool,3,3,8,7,5,7,19,0,1,4,5,1,2,9,12,7,3,20,30,4,0,0,4,0,0,1,1
Marina LUBIAN,Italy,Middle Blocker,Women,Dominican Republic,2022-06-16,Pool,3,5,0,0,0,0,0,0,0,0,0,0,2,5,7,0,0,0,0,0,1,0,1,0,0,1,1
Francesca BOSIO,Italy,Setter,Women,Dominican Republic,2022-06-16,Pool,3,5,1,0,0,1,1,1,1,1,3,0,0,11,11,0,0,0,0,1,0,0,1,18,1,29,48
Sara BONIFACIO,Italy,Middle Blocker,Women,Dominican Republic,2022-06-16,Pool,3,5,8,6,1,1,8,2,3,2,7,0,0,7,7,0,0,0,0,0,1,0,1,0,0,0,0
Ofelia MALINOV,Italy,Setter,Women,Dominican Republic,2022-06-16,Pool,3,5,2,2,0,1,3,0,3,4,7,0,0,10,10,0,0,0,0,5,0,0,5,28,0,50,78
Monica DE GENNARO,Italy,Libero,Women,Dominican Republic,2022-06-16,Pool,3,5,0,0,0,0,0,0,0,0,0,0,0,0,0,9,1,4,14,14,3,0,17,0,0,13,13
Eleonora FERSINO,Italy,Libero,Women,Dominican Republic,2022-06-16,Pool,3,5,0,0,0,0,0,0,0,0,0,0,0,0,0,1,0,1,2,0,1,0,1,0,0,0,0
Caterina Chiara BOSETTI,Italy,Outside Hitter,Women,Dominican Republic,2022-06-16,Pool,3,5,6,4,2,6,12,2,1,0,3,0,0,9,9,4,1,7,12,0,0,0,0,0,0,2,2
Cristina CHIRICHELLA,Italy,Middle Blocker,Women,Dominican Republic,2022-06-16,Pool,3,5,5,4,2,8,14,1,9,2,12,0,0,15,15,0,0,0,0,3,1,0,4,0,0,0,0
Anna DANESI,Italy,Middle Blocker,Women,Dominican Republic,2022-06-16,Pool,3,5,3,1,0,3,4,2,2,1,5,0,0,5,5,0,0,0,0,0,0,0,0,0,0,1,1
Anastasia GUERRA,Italy,Outside Hitter,Women,Dominican Republic,2022-06-16,Pool,3,5,17,17,4,9,30,0,1,1,2,0,4,5,9,11,1,14,26,13,2,0,15,0,0,2,2
Sylvia Chinelo NWAKALOR,Italy,Opposite Spiker,Women,Dominican Republic,2022-06-16,Pool,3,5,11,9,6,18,33,2,4,0,6,0,1,12,13,0,0,0,0,1,1,0,2,0,0,0,0
Miryam Fatime SYLLA,Italy,Outside Hitter,Women,Dominican Republic,2022-06-16,Pool,3,5,0,0,0,0,0,0,0,0,0,0,0,0,0,0,0,0,0,0,0,0,0,0,0,0,0
Paola Ogechi EGONU,Italy,Opposite Spiker,Women,Dominican Republic,2022-06-16,Pool,3,5,8,6,4,7,17,1,2,1,4,1,2,1,4,0,0,0,0,3,0,1,4,0,0,0,0
Alice Carlotta DEGRADI,Italy,Outside Hitter,Women,Dominican Republic,2022-06-16,Pool,3,5,11,9,4,15,28,1,1,1,3,1,3,7,11,12,1,21,34,3,1,2,6,0,0,0,0
Marina LUBIAN,Italy,Middle Blocker,Women,Serbia,2022-06-15,Pool,3,4,1,1,0,1,2,0,0,1,1,0,0,2,2,0,0,0,0,0,0,1,1,0,0,0,0
Francesca BOSIO,Italy,Setter,Women,Serbia,2022-06-15,Pool,3,4,0,0,0,0,0,0,0,0,0,0,0,0,0,0,0,0,0,0,0,0,0,0,0,0,0
Sara BONIFACIO,Italy,Middle Blocker,Women,Serbia,2022-06-15,Pool,3,4,0,0,0,0,0,0,0,0,0,0,0,0,0,0,0,0,0,0,0,0,0,0,0,0,0
Ofelia MALINOV,Italy,Setter,Women,Serbia,2022-06-15,Pool,3,4,5,2,0,1,3,3,0,8,11,0,0,14,14,0,0,0,0,7,0,2,9,0,0,70,70
Monica DE GENNARO,Italy,Libero,Women,Serbia,2022-06-15,Pool,3,4,0,0,0,0,0,0,0,0,0,0,0,0,0,4,0,5,9,13,0,1,14,0,0,2,2
Eleonora FERSINO,Italy,Libero,Women,Serbia,2022-06-15,Pool,3,4,0,0,0,0,0,0,0,0,0,0,0,0,0,0,0,0,0,1,0,0,1,0,0,0,0
Caterina Chiara BOSETTI,Italy,Outside Hitter,Women,Serbia,2022-06-15,Pool,3,4,12,7,6,8,21,1,0,3,4,4,3,16,23,7,2,20,29,8,1,2,11,0,0,0,0
Cristina CHIRICHELLA,Italy,Middle Blocker,Women,Serbia,2022-06-15,Pool,3,4,6,4,2,5,11,2,0,8,10,0,1,14,15,1,0,0,1,6,0,1,7,0,0,0,0
Anna DANESI,Italy,Middle Blocker,Women,Serbia,2022-06-15,Pool,3,4,7,3,1,5,9,3,0,10,13,1,0,14,15,1,0,0,1,3,0,0,3,0,1,1,2
Anastasia GUERRA,Italy,Outside Hitter,Women,Serbia,2022-06-15,Pool,3,4,0,0,0,0,0,0,0,0,0,0,0,0,0,0,0,0,0,0,0,0,0,0,0,0,0
Sylvia Chinelo NWAKALOR,Italy,Opposite Spiker,Women,Serbia,2022-06-15,Pool,3,4,0,0,0,0,0,0,0,0,0,0,0,0,0,0,0,0,0,0,0,0,0,0,0,0,0
Miryam Fatime SYLLA,Italy,Outside Hitter,Women,Serbia,2022-06-15,Pool,3,4,0,0,0,0,0,0,0,0,0,0,0,0,0,0,0,0,0,0,0,0,0,0,0,0,0
Paola Ogechi EGONU,Italy,Opposite Spiker,Women,Serbia,2022-06-15,Pool,3,4,23,19,4,18,41,2,0,7,9,2,3,10,15,0,0,0,0,5,0,5,10,0,0,1,1
Alice Carlotta DEGRADI,Italy,Outside Hitter,Women,Serbia,2022-06-15,Pool,3,4,16,14,4,5,23,2,0,1,3,0,5,6,11,11,0,13,24,3,0,2,5,0,0,0,0
Marina LUBIAN,Italy,Middle Blocker,Women,China,2022-06-04,Pool,1,4,2,0,2,3,5,0,2,5,7,2,1,9,12,0,0,1,1,1,1,0,2,0,0,1,1
Francesca BOSIO,Italy,Setter,Women,China,2022-06-04,Pool,1,4,0,0,0,0,0,0,0,0,0,0,0,3,3,0,0,0,0,0,0,0,0,1,0,4,5
Alessia GENNARI,Italy,Outside Hitter,Women,China,2022-06-04,Pool,1,4,0,0,0,0,0,0,0,0,0,0,0,0,0,0,0,0,0,0,0,0,0,0,0,0,0
Sara BONIFACIO,Italy,Middle Blocker,Women,China,2022-06-04,Pool,1,4,10,9,1,1,11,1,2,5,8,0,0,9,9,0,0,0,0,1,0,2,3,1,0,1,2
Ofelia MALINOV,Italy,Setter,Women,China,2022-06-04,Pool,1,4,4,3,0,2,5,0,1,5,6,1,3,9,13,0,0,0,0,11,2,1,14,55,0,45,100
Monica DE GENNARO,Italy,Libero,Women,China,2022-06-04,Pool,1,4,0,0,0,0,0,0,0,0,0,0,0,0,0,7,0,15,22,13,3,3,19,3,0,8,11
Eleonora FERSINO,Italy,Libero,Women,China,2022-06-04,Pool,1,4,0,0,0,0,0,0,0,0,0,0,0,0,0,0,0,0,0,0,0,0,0,0,0,0,0
Cristina CHIRICHELLA,Italy,Middle Blocker,Women,China,2022-06-04,Pool,1,4,3,2,3,3,8,1,3,2,6,0,0,6,6,0,0,0,0,0,0,0,0,0,0,2,2
Sylvia Chinelo NWAKALOR,Italy,Opposite Spiker,Women,China,2022-06-04,Pool,1,4,19,18,9,13,40,1,4,2,7,0,0,10,10,0,0,0,0,3,0,2,5,1,0,2,3
Sofia D'ODORICO,Italy,Outside Hitter,Women,China,2022-06-04,Pool,1,4,0,0,0,0,0,0,0,0,0,0,0,0,0,0,0,0,0,0,0,0,0,0,0,0,0
Alice Carlotta DEGRADI,Italy,Outside Hitter,Women,China,2022-06-04,Pool,1,4,23,21,8,11,40,1,2,3,6,1,5,5,11,5,3,19,27,15,5,1,21,0,0,1,1
Nkemdilim Ruth Terry ENWEONWU,Italy,Opposite Spiker,Women,China,2022-06-04,Pool,1,4,0,0,1,2,3,0,0,0,0,0,0,0,0,0,0,0,0,1,0,1,2,0,0,0,0
Elena PERINELLI,Italy,Outside Hitter,Women,China,2022-06-04,Pool,1,4,6,6,6,8,20,0,1,0,1,0,2,12,14,10,2,27,39,3,4,2,9,1,0,3,4
Alessia MAZZARO,Italy,Middle Blocker,Women,China,2022-06-04,Pool,1,4,0,0,0,0,0,0,1,0,1,0,0,1,1,0,0,0,0,0,0,0,0,0,0,0,0
Marina LUBIAN,Italy,Middle Blocker,Women,Netherlands,2022-06-03,Pool,3,3,10,6,2,2,10,2,0,5,7,2,2,11,15,0,0,0,0,3,0,0,3,0,0,2,2
Francesca BOSIO,Italy,Setter,Women,Netherlands,2022-06-03,Pool,3,3,2,0,0,1,1,2,2,3,7,0,1,9,10,0,0,0,0,11,1,2,14,27,1,45,73
Alessia GENNARI,Italy,Outside Hitter,Women,Netherlands,2022-06-03,Pool,3,3,11,10,0,12,22,1,3,1,5,0,1,8,9,7,1,13,21,4,2,0,6,0,0,1,1
Sara BONIFACIO,Italy,Middle Blocker,Women,Netherlands,2022-06-03,Pool,3,3,0,0,0,0,0,0,0,0,0,0,0,0,0,0,0,0,0,0,0,0,0,0,0,0,0
Ofelia MALINOV,Italy,Setter,Women,Netherlands,2022-06-03,Pool,3,3,0,0,0,0,0,0,0,0,0,0,0,0,0,0,0,0,0,0,0,0,0,0,0,0,0
Monica DE GENNARO,Italy,Libero,Women,Netherlands,2022-06-03,Pool,3,3,0,0,0,0,0,0,0,0,0,0,0,0,0,0,0,9,9,14,2,0,16,1,0,10,11
Eleonora FERSINO,Italy,Libero,Women,Netherlands,2022-06-03,Pool,3,3,0,0,0,0,0,0,0,0,0,0,0,0,0,1,0,1,2,1,0,1,2,0,0,0,0
Cristina CHIRICHELLA,Italy,Middle Blocker,Women,Netherlands,2022-06-03,Pool,3,3,0,0,0,0,0,0,0,0,0,0,0,0,0,0,0,0,0,0,0,0,0,0,0,0,0
Sylvia Chinelo NWAKALOR,Italy,Opposite Spiker,Women,Netherlands,2022-06-03,Pool,3,3,16,15,4,5,24,1,1,1,3,0,0,8,8,0,0,0,0,4,0,3,7,0,0,0,0
Sofia D'ODORICO,Italy,Outside Hitter,Women,Netherlands,2022-06-03,Pool,3,3,0,0,0,0,0,0,0,0,0,0,0,0,0,0,0,0,0,0,0,0,0,0,0,0,0
Alice Carlotta DEGRADI,Italy,Outside Hitter,Women,Netherlands,2022-06-03,Pool,3,3,14,13,3,8,24,1,3,0,4,0,4,14,18,2,1,11,14,7,2,2,11,1,0,1,2
Nkemdilim Ruth Terry ENWEONWU,Italy,Opposite Spiker,Women,Netherlands,2022-06-03,Pool,3,3,0,0,0,0,0,0,0,0,0,0,0,0,0,0,0,0,0,0,0,0,0,0,0,0,0
Elena PERINELLI,Italy,Outside Hitter,Women,Netherlands,2022-06-03,Pool,3,3,0,0,0,0,0,0,0,0,0,0,0,0,0,0,0,0,0,0,0,0,0,0,0,0,0
Alessia MAZZARO,Italy,Middle Blocker,Women,Netherlands,2022-06-03,Pool,3,3,10,6,1,7,14,3,0,4,7,1,0,12,13,0,0,1,1,2,0,0,2,0,0,3,3
Marina LUBIAN,Italy,Middle Blocker,Women,Belgium,2022-06-02,Pool,3,4,0,0,0,0,0,0,0,0,0,0,1,4,5,0,0,0,0,2,0,0,2,0,0,1,1
Francesca BOSIO,Italy,Setter,Women,Belgium,2022-06-02,Pool,3,4,0,0,0,0,0,0,0,0,0,0,1,1,2,0,0,0,0,0,1,0,1,0,0,1,1
Alessia GENNARI,Italy,Outside Hitter,Women,Belgium,2022-06-02,Pool,3,4,9,8,2,15,25,0,3,2,5,1,1,10,12,4,1,12,17,4,3,0,7,0,0,1,1
Sara BONIFACIO,Italy,Middle Blocker,Women,Belgium,2022-06-02,Pool,3,4,5,4,1,3,8,1,2,4,7,0,1,14,15,0,0,0,0,0,0,0,0,0,0,1,1
Ofelia MALINOV,Italy,Setter,Women,Belgium,2022-06-02,Pool,3,4,2,0,0,1,1,2,2,4,8,0,1,12,13,0,1,0,1,7,2,1,10,13,3,81,97
Monica DE GENNARO,Italy,Libero,Women,Belgium,2022-06-02,Pool,3,4,0,0,0,0,0,0,0,0,0,0,0,0,0,4,0,8,12,10,3,0,13,0,0,15,15
Eleonora FERSINO,Italy,Libero,Women,Belgium,2022-06-02,Pool,3,4,0,0,0,0,0,0,0,0,0,0,0,0,0,0,0,0,0,0,0,0,0,0,0,0,0
Cristina CHIRICHELLA,Italy,Middle Blocker,Women,Belgium,2022-06-02,Pool,3,4,9,5,1,2,8,3,7,8,18,1,1,8,10,1,0,0,1,1,3,0,4,0,0,0,0
Sylvia Chinelo NWAKALOR,Italy,Opposite Spiker,Women,Belgium,2022-06-02,Pool,3,4,29,26,9,16,51,2,2,4,8,1,1,16,18,0,0,0,0,7,2,1,10,1,0,1,2
Sofia D'ODORICO,Italy,Outside Hitter,Women,Belgium,2022-06-02,Pool,3,4,0,0,1,1,2,0,0,0,0,0,0,0,0,0,0,1,1,0,0,0,0,0,0,0,0
Alice Carlotta DEGRADI,Italy,Outside Hitter,Women,Belgium,2022-06-02,Pool,3,4,1,1,2,2,5,0,1,0,1,0,2,0,2,2,0,5,7,1,0,0,1,0,0,0,0
Nkemdilim Ruth Terry ENWEONWU,Italy,Opposite Spiker,Women,Belgium,2022-06-02,Pool,3,4,0,0,0,0,0,0,0,0,0,0,1,0,1,0,0,1,1,1,0,0,1,0,0,0,0
Elena PERINELLI,Italy,Outside Hitter,Women,Belgium,2022-06-02,Pool,3,4,15,12,1,14,27,1,4,3,8,2,1,14,17,11,2,25,38,6,3,0,9,0,0,1,1
Alessia MAZZARO,Italy,Middle Blocker,Women,Belgium,2022-06-02,Pool,3,4,0,0,0,1,1,0,0,1,1,0,0,0,0,0,0,0,0,0,0,0,0,0,0,0,0
Marina LUBIAN,Italy,Middle Blocker,Women,Türkiye,2022-05-31,Pool,0,3,0,0,0,0,0,0,0,0,0,0,1,4,5,0,0,0,0,1,0,0,1,0,0,0,0
Francesca BOSIO,Italy,Setter,Women,Türkiye,2022-05-31,Pool,0,3,0,0,0,0,0,0,0,0,0,0,0,2,2,0,0,0,0,0,0,0,0,1,0,2,3
Alessia GENNARI,Italy,Outside Hitter,Women,Türkiye,2022-05-31,Pool,0,3,0,0,0,0,0,0,0,0,0,0,0,0,0,0,0,1,1,0,0,0,0,0,0,0,0
Sara BONIFACIO,Italy,Middle Blocker,Women,Türkiye,2022-05-31,Pool,0,3,7,5,1,5,11,2,5,5,12,0,0,7,7,0,0,0,0,1,1,0,2,0,0,1,1
Ofelia MALINOV,Italy,Setter,Women,Türkiye,2022-05-31,Pool,0,3,3,2,0,2,4,1,0,1,2,0,1,8,9,1,1,0,2,5,2,0,7,13,1,61,75
Monica DE GENNARO,Italy,Libero,Women,Türkiye,2022-05-31,Pool,0,3,0,0,0,0,0,0,0,0,0,0,0,0,0,3,0,9,12,6,2,2,10,1,0,8,9
Eleonora FERSINO,Italy,Libero,Women,Türkiye,2022-05-31,Pool,0,3,0,0,0,0,0,0,0,0,0,0,0,0,0,0,0,0,0,0,0,0,0,0,0,0,0
Cristina CHIRICHELLA,Italy,Middle Blocker,Women,Türkiye,2022-05-31,Pool,0,3,4,2,3,2,7,1,4,2,7,1,2,7,10,0,0,0,0,2,1,0,3,0,0,0,0
Sylvia Chinelo NWAKALOR,Italy,Opposite Spiker,Women,Türkiye,2022-05-31,Pool,0,3,15,14,9,17,40,1,4,1,6,0,0,9,9,0,0,0,0,2,1,1,4,0,0,1,1
Sofia D'ODORICO,Italy,Outside Hitter,Women,Türkiye,2022-05-31,Pool,0,3,0,0,0,0,0,0,0,0,0,0,0,0,0,0,1,0,1,1,0,0,1,0,0,0,0
Alice Carlotta DEGRADI,Italy,Outside Hitter,Women,Türkiye,2022-05-31,Pool,0,3,5,5,1,6,12,0,4,2,6,0,2,4,6,12,2,25,39,4,1,1,6,1,0,1,2
Nkemdilim Ruth Terry ENWEONWU,Italy,Opposite Spiker,Women,Türkiye,2022-05-31,Pool,0,3,1,1,1,0,2,0,0,0,0,0,1,1,2,0,0,2,2,0,0,0,0,0,0,0,0
Elena PERINELLI,Italy,Outside Hitter,Women,Türkiye,2022-05-31,Pool,0,3,9,8,0,11,19,1,4,1,6,0,1,7,8,1,0,8,9,4,2,1,7,0,0,1,1
Alessia MAZZARO,Italy,Middle Blocker,Women,Türkiye,2022-05-31,Pool,0,3,0,0,0,1,1,0,0,0,0,0,0,2,2,0,0,0,0,0,0,0,0,0,0,1,1
Akane MORIYA,Japan,Libero,Women,Brazil,2022-07-13,Quarterfinals,1,4,0,0,0,0,0,0,0,0,0,0,0,0,0,0,0,0,0,0,0,0,0,0,0,0,0
Mami UCHISETO,Japan,Outside Hitter,Women,Brazil,2022-07-13,Quarterfinals,1,4,0,0,0,0,0,0,0,0,0,0,0,0,0,0,0,0,0,0,0,0,0,0,0,0,0
Sarina KOGA,Japan,Outside Hitter,Women,Brazil,2022-07-13,Quarterfinals,1,4,13,12,6,25,43,1,1,1,3,0,1,8,9,11,1,31,43,5,3,2,10,0,0,1,1
Mayu ISHIKAWA,Japan,Outside Hitter,Women,Brazil,2022-07-13,Quarterfinals,1,4,8,6,2,4,12,0,0,1,1,2,1,6,9,6,0,5,11,4,3,1,8,0,0,1,1
Haruyo SHIMAMURA,Japan,Middle Blocker,Women,Brazil,2022-07-13,Quarterfinals,1,4,8,6,1,9,16,1,3,6,10,1,1,16,18,0,0,0,0,4,1,0,5,0,0,3,3
Manami KOJIMA,Japan,Libero,Women,Brazil,2022-07-13,Quarterfinals,1,4,0,0,0,0,0,0,0,0,0,0,0,0,0,2,2,19,23,6,7,8,21,0,0,5,5
Arisa INOUE,Japan,Outside Hitter,Women,Brazil,2022-07-13,Quarterfinals,1,4,5,4,1,5,10,0,1,0,1,1,1,6,8,0,0,0,0,4,3,3,10,0,0,0,0
Kotona HAYASHI,Japan,Outside Hitter,Women,Brazil,2022-07-13,Quarterfinals,1,4,16,14,5,13,32,1,3,1,5,1,2,10,13,4,0,11,15,9,1,6,16,0,0,5,5
Nichika YAMADA,Japan,Middle Blocker,Women,Brazil,2022-07-13,Quarterfinals,1,4,2,2,1,3,6,0,0,4,4,0,0,2,2,0,0,0,0,1,0,1,2,0,0,0,0
Tamaki MATSUI,Japan,Setter,Women,Brazil,2022-07-13,Quarterfinals,1,4,3,3,0,0,3,0,1,5,6,0,0,8,8,0,0,0,0,6,5,5,16,32,1,55,88
Erina OGAWA,Japan,Middle Blocker,Women,Brazil,2022-07-13,Quarterfinals,1,4,5,3,4,4,11,2,6,2,10,0,1,13,14,0,0,0,0,3,2,1,6,0,0,2,2
Asuka HAMAMATSU,Japan,Middle Blocker,Women,Brazil,2022-07-13,Quarterfinals,1,4,0,0,0,0,0,0,0,0,0,0,0,0,0,0,0,0,0,0,0,0,0,0,0,0,0
Nanami SEKI,Japan,Setter,Women,Brazil,2022-07-13,Quarterfinals,1,4,0,0,0,0,0,0,1,1,2,0,0,4,4,0,0,0,0,1,0,0,1,12,0,27,39
Yoshino SATO,Japan,Outside Hitter,Women,Brazil,2022-07-13,Quarterfinals,1,4,9,9,4,10,23,0,1,2,3,0,3,5,8,0,0,0,0,3,3,3,9,0,0,1,1
Akane MORIYA,Japan,Libero,Women,Belgium,2022-07-03,Pool,2,5,0,0,0,0,0,0,0,0,0,0,0,0,0,0,0,0,0,0,0,0,0,0,0,0,0
Mami UCHISETO,Japan,Outside Hitter,Women,Belgium,2022-07-03,Pool,2,5,8,5,2,7,14,1,0,0,1,2,1,8,11,10,1,1,12,6,1,0,7,0,0,1,1
Sarina KOGA,Japan,Outside Hitter,Women,Belgium,2022-07-03,Pool,2,5,25,24,6,33,63,0,3,0,3,1,1,13,15,9,0,6,15,9,0,0,9,0,0,5,5
Mayu ISHIKAWA,Japan,Outside Hitter,Women,Belgium,2022-07-03,Pool,2,5,0,0,0,0,0,0,0,0,0,0,1,7,8,0,0,0,0,0,1,0,1,0,0,0,0
Haruyo SHIMAMURA,Japan,Middle Blocker,Women,Belgium,2022-07-03,Pool,2,5,5,4,3,8,15,1,6,3,10,0,0,10,10,0,0,1,1,3,0,0,3,0,0,3,3
Manami KOJIMA,Japan,Libero,Women,Belgium,2022-07-03,Pool,2,5,0,0,0,0,0,0,0,0,0,0,0,0,0,15,0,13,28,21,1,0,22,0,0,14,14
Arisa INOUE,Japan,Outside Hitter,Women,Belgium,2022-07-03,Pool,2,5,7,7,3,19,29,0,1,1,2,0,0,8,8,0,0,0,0,8,0,1,9,0,0,2,2
Kotona HAYASHI,Japan,Outside Hitter,Women,Belgium,2022-07-03,Pool,2,5,17,16,3,11,30,0,5,2,7,1,1,16,18,16,1,7,24,20,1,0,21,0,0,7,7
Nichika YAMADA,Japan,Middle Blocker,Women,Belgium,2022-07-03,Pool,2,5,0,0,0,0,0,0,0,0,0,0,0,0,0,0,0,0,0,0,0,0,0,0,0,0,0
Tamaki MATSUI,Japan,Setter,Women,Belgium,2022-07-03,Pool,2,5,3,2,0,2,4,0,1,0,1,1,0,11,12,0,0,0,0,10,0,0,10,8,0,73,81
Erina OGAWA,Japan,Middle Blocker,Women,Belgium,2022-07-03,Pool,2,5,0,0,0,0,0,0,0,0,0,0,0,0,0,0,0,0,0,0,0,0,0,0,0,0,0
Airi MIYABE,Japan,Outside Hitter,Women,Belgium,2022-07-03,Pool,2,5,0,0,0,0,0,0,0,0,0,0,0,0,0,0,0,0,0,0,0,0,0,0,0,0,0
Asuka HAMAMATSU,Japan,Middle Blocker,Women,Belgium,2022-07-03,Pool,2,5,5,5,1,4,10,0,4,0,4,0,1,7,8,0,1,0,1,0,1,0,1,0,1,0,1
Nanami SEKI,Japan,Setter,Women,Belgium,2022-07-03,Pool,2,5,1,1,0,1,2,0,1,0,1,0,1,5,6,0,0,0,0,4,0,0,4,4,1,53,58
Akane MORIYA,Japan,Libero,Women,Serbia,2022-07-02,Pool,1,4,0,0,0,0,0,0,0,0,0,0,0,0,0,0,0,0,0,0,0,0,0,0,0,0,0
Mami UCHISETO,Japan,Outside Hitter,Women,Serbia,2022-07-02,Pool,1,4,3,3,2,4,9,0,0,0,0,0,1,1,2,5,0,5,10,2,0,0,2,0,0,2,2
Sarina KOGA,Japan,Outside Hitter,Women,Serbia,2022-07-02,Pool,1,4,14,13,5,31,49,1,1,2,4,0,0,16,16,8,1,11,20,11,1,0,12,0,0,3,3
Mayu ISHIKAWA,Japan,Outside Hitter,Women,Serbia,2022-07-02,Pool,1,4,9,8,1,19,28,0,3,0,3,1,0,8,9,4,0,1,5,9,2,0,11,0,0,0,0
Haruyo SHIMAMURA,Japan,Middle Blocker,Women,Serbia,2022-07-02,Pool,1,4,12,10,2,9,21,0,3,0,3,2,0,12,14,0,0,0,0,2,1,1,4,0,0,1,1
Manami KOJIMA,Japan,Libero,Women,Serbia,2022-07-02,Pool,1,4,0,0,0,0,0,0,0,0,0,0,0,0,0,28,1,17,46,25,4,0,29,0,0,13,13
Arisa INOUE,Japan,Outside Hitter,Women,Serbia,2022-07-02,Pool,1,4,5,3,4,16,23,1,1,0,2,1,0,7,8,0,0,0,0,12,1,0,13,0,0,1,1
Kotona HAYASHI,Japan,Outside Hitter,Women,Serbia,2022-07-02,Pool,1,4,17,15,6,23,44,1,6,3,10,1,2,11,14,4,0,2,6,18,2,0,20,0,0,8,8
Nichika YAMADA,Japan,Middle Blocker,Women,Serbia,2022-07-02,Pool,1,4,0,0,0,2,2,0,2,3,5,0,2,2,4,0,0,0,0,0,0,0,0,0,0,1,1
Tamaki MATSUI,Japan,Setter,Women,Serbia,2022-07-02,Pool,1,4,1,1,0,0,1,0,1,0,1,0,0,4,4,0,0,0,0,3,1,0,4,0,1,34,35
Erina OGAWA,Japan,Middle Blocker,Women,Serbia,2022-07-02,Pool,1,4,0,0,1,3,4,0,1,0,1,0,0,3,3,0,0,0,0,2,0,0,2,0,0,0,0
Airi MIYABE,Japan,Outside Hitter,Women,Serbia,2022-07-02,Pool,1,4,0,0,0,0,0,0,0,0,0,0,0,0,0,0,0,0,0,0,0,0,0,0,0,0,0
Asuka HAMAMATSU,Japan,Middle Blocker,Women,Serbia,2022-07-02,Pool,1,4,1,1,1,6,8,0,3,1,4,0,0,4,4,0,0,0,0,0,0,0,0,0,0,2,2
Nanami SEKI,Japan,Setter,Women,Serbia,2022-07-02,Pool,1,4,1,1,0,3,4,0,3,0,3,0,1,8,9,0,0,0,0,10,2,0,12,7,2,128,137
Akane MORIYA,Japan,Libero,Women,Türkiye,2022-07-01,Pool,1,4,0,0,0,0,0,0,0,0,0,0,0,0,0,6,1,8,15,7,1,0,8,0,0,7,7
Mami UCHISETO,Japan,Outside Hitter,Women,Türkiye,2022-07-01,Pool,1,4,9,8,2,4,14,0,0,1,1,1,1,6,8,10,1,7,18,6,0,0,6,0,0,4,4
Sarina KOGA,Japan,Outside Hitter,Women,Türkiye,2022-07-01,Pool,1,4,0,0,0,0,0,0,0,0,0,0,0,0,0,0,0,0,0,0,0,0,0,0,0,0,0
Mayu ISHIKAWA,Japan,Outside Hitter,Women,Türkiye,2022-07-01,Pool,1,4,19,19,8,18,45,0,2,1,3,0,3,12,15,13,0,5,18,6,1,0,7,0,0,5,5
Haruyo SHIMAMURA,Japan,Middle Blocker,Women,Türkiye,2022-07-01,Pool,1,4,3,2,2,5,9,1,2,1,4,0,0,5,5,2,0,1,3,2,1,0,3,0,0,3,3
Manami KOJIMA,Japan,Libero,Women,Türkiye,2022-07-01,Pool,1,4,0,0,0,0,0,0,0,0,0,0,0,0,0,4,0,7,11,7,4,0,11,0,0,9,9
Arisa INOUE,Japan,Outside Hitter,Women,Türkiye,2022-07-01,Pool,1,4,5,4,4,8,16,0,1,1,2,1,1,5,7,6,0,5,11,4,1,0,5,0,0,4,4
Kotona HAYASHI,Japan,Outside Hitter,Women,Türkiye,2022-07-01,Pool,1,4,12,12,5,8,25,0,1,0,1,0,0,12,12,4,0,3,7,6,0,0,6,0,0,1,1
Nichika YAMADA,Japan,Middle Blocker,Women,Türkiye,2022-07-01,Pool,1,4,1,0,1,4,5,0,0,2,2,1,1,4,6,0,0,1,1,0,0,0,0,0,0,0,0
Tamaki MATSUI,Japan,Setter,Women,Türkiye,2022-07-01,Pool,1,4,0,0,0,0,0,0,1,0,1,0,0,7,7,0,0,0,0,4,0,0,4,0,0,24,24
Erina OGAWA,Japan,Middle Blocker,Women,Türkiye,2022-07-01,Pool,1,4,2,2,1,5,8,0,3,1,4,0,0,9,9,0,0,0,0,1,0,0,1,0,1,0,1
Airi MIYABE,Japan,Outside Hitter,Women,Türkiye,2022-07-01,Pool,1,4,4,2,4,10,16,2,0,0,2,0,1,4,5,0,0,0,0,1,0,0,1,0,0,1,1
Asuka HAMAMATSU,Japan,Middle Blocker,Women,Türkiye,2022-07-01,Pool,1,4,3,1,1,2,4,2,0,0,2,0,0,2,2,0,0,0,0,0,0,0,0,0,0,1,1
Nanami SEKI,Japan,Setter,Women,Türkiye,2022-07-01,Pool,1,4,1,0,0,1,1,0,1,3,4,1,0,6,7,0,0,0,0,10,4,1,15,2,0,94,96
Akane MORIYA,Japan,Libero,Women,Netherlands,2022-06-29,Pool,2,5,0,0,0,0,0,0,0,0,0,0,0,0,0,11,0,9,20,12,3,0,15,0,0,3,3
Mami UCHISETO,Japan,Outside Hitter,Women,Netherlands,2022-06-29,Pool,2,5,4,4,1,10,15,0,1,0,1,0,1,7,8,10,2,10,22,0,0,0,0,0,0,0,0
Sarina KOGA,Japan,Outside Hitter,Women,Netherlands,2022-06-29,Pool,2,5,31,31,3,35,69,0,1,2,3,0,0,15,15,18,0,11,29,7,3,0,10,0,0,0,0
Mayu ISHIKAWA,Japan,Outside Hitter,Women,Netherlands,2022-06-29,Pool,2,5,10,10,3,4,17,0,0,1,1,0,3,4,7,3,1,9,13,5,0,0,5,0,0,0,0
Haruyo SHIMAMURA,Japan,Middle Blocker,Women,Netherlands,2022-06-29,Pool,2,5,6,5,1,3,9,1,3,3,7,0,0,7,7,0,0,0,0,1,0,0,1,0,0,0,0
Manami KOJIMA,Japan,Libero,Women,Netherlands,2022-06-29,Pool,2,5,0,0,0,0,0,0,0,0,0,0,0,0,0,5,0,4,9,6,2,0,8,0,0,2,2
Arisa INOUE,Japan,Outside Hitter,Women,Netherlands,2022-06-29,Pool,2,5,8,7,5,14,26,0,2,1,3,1,1,8,10,0,0,0,0,5,1,0,6,0,0,1,1
Kotona HAYASHI,Japan,Outside Hitter,Women,Netherlands,2022-06-29,Pool,2,5,3,3,2,3,8,0,0,0,0,0,0,4,4,3,0,4,7,2,0,0,2,0,0,0,0
Nichika YAMADA,Japan,Middle Blocker,Women,Netherlands,2022-06-29,Pool,2,5,9,6,1,2,9,1,4,0,5,2,1,12,15,0,0,0,0,0,0,0,0,0,0,1,1
Tamaki MATSUI,Japan,Setter,Women,Netherlands,2022-06-29,Pool,2,5,0,0,0,2,2,0,0,1,1,0,0,6,6,0,0,0,0,3,2,0,5,8,0,55,63
Erina OGAWA,Japan,Middle Blocker,Women,Netherlands,2022-06-29,Pool,2,5,1,1,2,2,5,0,0,0,0,0,0,6,6,0,0,0,0,1,0,0,1,0,0,1,1
Airi MIYABE,Japan,Outside Hitter,Women,Netherlands,2022-06-29,Pool,2,5,7,6,4,7,17,0,1,0,1,1,0,5,6,0,0,0,0,2,0,1,3,0,0,2,2
Asuka HAMAMATSU,Japan,Middle Blocker,Women,Netherlands,2022-06-29,Pool,2,5,3,3,1,4,8,0,0,0,0,0,1,1,2,0,0,2,2,0,0,0,0,0,0,0,0
Nanami SEKI,Japan,Setter,Women,Netherlands,2022-06-29,Pool,2,5,2,1,0,0,1,0,2,0,2,1,1,15,17,0,0,0,0,4,4,0,8,16,0,99,115
Akane MORIYA,Japan,Libero,Women,China,2022-06-19,Pool,3,4,0,0,0,0,0,0,0,0,0,0,0,0,0,0,0,0,0,0,0,0,0,0,0,0,0
Mami UCHISETO,Japan,Outside Hitter,Women,China,2022-06-19,Pool,3,4,0,0,0,0,0,0,0,0,0,0,0,0,0,0,0,0,0,0,0,0,0,0,0,0,0
Sarina KOGA,Japan,Outside Hitter,Women,China,2022-06-19,Pool,3,4,22,17,3,23,43,4,2,2,8,1,1,10,12,5,3,23,31,15,3,0,18,0,0,1,1
Mayu ISHIKAWA,Japan,Outside Hitter,Women,China,2022-06-19,Pool,3,4,0,0,0,0,0,0,0,0,0,0,1,2,3,0,0,0,0,0,0,0,0,0,0,0,0
Haruyo SHIMAMURA,Japan,Middle Blocker,Women,China,2022-06-19,Pool,3,4,7,5,2,4,11,1,3,3,7,1,1,9,11,0,0,1,1,0,0,0,0,0,0,1,1
Haruka MIYASHITA,Japan,Setter,Women,China,2022-06-19,Pool,3,4,0,0,0,0,0,0,0,0,0,0,0,0,0,0,0,0,0,0,0,0,0,0,0,0,0
Manami KOJIMA,Japan,Libero,Women,China,2022-06-19,Pool,3,4,0,0,0,0,0,0,0,0,0,0,0,0,0,2,0,14,16,12,4,2,18,0,0,17,17
Arisa INOUE,Japan,Outside Hitter,Women,China,2022-06-19,Pool,3,4,15,12,7,27,46,1,1,1,3,2,2,18,22,0,0,0,0,6,2,2,10,0,0,2,2
Kotona HAYASHI,Japan,Outside Hitter,Women,China,2022-06-19,Pool,3,4,19,18,4,6,28,0,4,7,11,1,1,9,11,8,1,14,23,12,5,0,17,0,0,4,4
Mami YOKOTA,Japan,Middle Blocker,Women,China,2022-06-19,Pool,3,4,5,2,0,3,5,3,2,3,8,0,0,16,16,0,0,1,1,4,0,0,4,0,0,1,1
Tamaki MATSUI,Japan,Setter,Women,China,2022-06-19,Pool,3,4,2,1,0,2,3,0,1,1,2,1,1,13,15,0,0,0,0,12,2,0,14,20,1,60,81
Erina OGAWA,Japan,Middle Blocker,Women,China,2022-06-19,Pool,3,4,0,0,0,0,0,0,0,0,0,0,0,0,0,0,0,0,0,0,0,0,0,0,0,0,0
Nanami SEKI,Japan,Setter,Women,China,2022-06-19,Pool,3,4,0,0,0,0,0,0,0,0,0,0,0,1,1,0,0,0,0,0,1,0,1,3,0,17,20
Yoshino SATO,Japan,Outside Hitter,Women,China,2022-06-19,Pool,3,4,1,0,0,0,0,0,0,0,0,1,1,0,2,0,0,0,0,0,0,0,0,0,0,0,0
Akane MORIYA,Japan,Libero,Women,Thailand,2022-06-17,Pool,3,3,0,0,0,0,0,0,0,0,0,0,0,0,0,0,0,0,0,0,0,0,0,0,0,0,0
Mami UCHISETO,Japan,Outside Hitter,Women,Thailand,2022-06-17,Pool,3,3,0,0,0,0,0,0,0,0,0,0,0,0,0,0,0,0,0,0,0,0,0,0,0,0,0
Sarina KOGA,Japan,Outside Hitter,Women,Thailand,2022-06-17,Pool,3,3,21,18,5,17,40,3,2,3,8,0,1,10,11,3,0,9,12,11,2,3,16,0,0,1,1
Mayu ISHIKAWA,Japan,Outside Hitter,Women,Thailand,2022-06-17,Pool,3,3,0,0,0,0,0,0,0,0,0,0,0,8,8,0,0,0,0,2,0,0,2,0,0,0,0
Haruyo SHIMAMURA,Japan,Middle Blocker,Women,Thailand,2022-06-17,Pool,3,3,4,4,1,13,18,0,3,7,10,0,0,8,8,1,0,0,1,4,0,0,4,0,0,1,1
Haruka MIYASHITA,Japan,Setter,Women,Thailand,2022-06-17,Pool,3,3,0,0,0,0,0,0,0,0,0,0,0,0,0,0,0,0,0,0,0,0,0,0,0,0,0
Manami KOJIMA,Japan,Libero,Women,Thailand,2022-06-17,Pool,3,3,0,0,0,0,0,0,0,0,0,0,0,0,0,4,0,14,18,20,3,0,23,1,0,8,9
Arisa INOUE,Japan,Outside Hitter,Women,Thailand,2022-06-17,Pool,3,3,18,17,1,19,37,1,1,8,10,0,1,10,11,0,0,0,0,14,2,0,16,0,0,0,0
Kotona HAYASHI,Japan,Outside Hitter,Women,Thailand,2022-06-17,Pool,3,3,7,6,4,13,23,1,0,3,4,0,1,8,9,9,0,7,16,9,2,0,11,1,0,1,2
Mami YOKOTA,Japan,Middle Blocker,Women,Thailand,2022-06-17,Pool,3,3,7,6,0,3,9,1,1,5,7,0,2,6,8,0,0,0,0,2,0,0,2,0,0,2,2
Tamaki MATSUI,Japan,Setter,Women,Thailand,2022-06-17,Pool,3,3,0,0,0,0,0,0,0,0,0,0,0,0,0,0,0,0,0,0,0,0,0,0,0,0,0
Erina OGAWA,Japan,Middle Blocker,Women,Thailand,2022-06-17,Pool,3,3,0,0,0,0,0,0,0,0,0,0,0,0,0,0,0,0,0,0,0,0,0,0,0,0,0
Nanami SEKI,Japan,Setter,Women,Thailand,2022-06-17,Pool,3,3,0,0,0,0,0,0,0,7,7,0,1,14,15,0,0,0,0,6,0,0,6,31,0,79,110
Yoshino SATO,Japan,Outside Hitter,Women,Thailand,2022-06-17,Pool,3,3,0,0,0,0,0,0,0,0,0,0,1,2,3,0,0,0,0,0,0,0,0,0,0,0,0
Akane MORIYA,Japan,Libero,Women,Bulgaria,2022-06-16,Pool,3,3,0,0,0,0,0,0,0,0,0,0,0,0,0,5,0,7,12,18,6,1,25,1,0,3,4
Mami UCHISETO,Japan,Outside Hitter,Women,Bulgaria,2022-06-16,Pool,3,3,9,9,1,4,14,0,0,1,1,0,2,7,9,7,0,17,24,8,0,0,8,0,0,2,2
Sarina KOGA,Japan,Outside Hitter,Women,Bulgaria,2022-06-16,Pool,3,3,18,17,2,12,31,0,1,4,5,1,0,14,15,4,0,12,16,9,1,0,10,0,0,2,2
Mayu ISHIKAWA,Japan,Outside Hitter,Women,Bulgaria,2022-06-16,Pool,3,3,2,0,4,4,8,0,1,1,2,2,1,2,5,1,0,1,2,0,1,0,1,0,0,1,1
Haruyo SHIMAMURA,Japan,Middle Blocker,Women,Bulgaria,2022-06-16,Pool,3,3,5,3,0,10,13,2,2,4,8,0,1,9,10,0,0,1,1,2,1,1,4,0,0,1,1
Haruka MIYASHITA,Japan,Setter,Women,Bulgaria,2022-06-16,Pool,3,3,0,0,0,0,0,0,0,0,0,0,0,2,2,0,0,0,0,1,0,0,1,0,0,1,1
Manami KOJIMA,Japan,Libero,Women,Bulgaria,2022-06-16,Pool,3,3,0,0,0,0,0,0,0,0,0,0,0,0,0,0,0,0,0,0,0,0,0,0,0,0,0
Arisa INOUE,Japan,Outside Hitter,Women,Bulgaria,2022-06-16,Pool,3,3,16,13,0,18,31,3,0,1,4,0,1,9,10,0,0,0,0,4,2,1,7,0,0,1,1
Kotona HAYASHI,Japan,Outside Hitter,Women,Bulgaria,2022-06-16,Pool,3,3,0,0,0,0,0,0,0,0,0,0,0,0,0,0,0,0,0,0,0,0,0,0,0,0,0
Mami YOKOTA,Japan,Middle Blocker,Women,Bulgaria,2022-06-16,Pool,3,3,0,0,0,2,2,0,4,5,9,0,1,5,6,0,0,1,1,2,0,1,3,0,0,3,3
Tamaki MATSUI,Japan,Setter,Women,Bulgaria,2022-06-16,Pool,3,3,1,1,0,0,1,0,0,0,0,0,0,1,1,0,0,0,0,1,0,1,2,2,0,8,10
Erina OGAWA,Japan,Middle Blocker,Women,Bulgaria,2022-06-16,Pool,3,3,3,3,0,1,4,0,0,2,2,0,0,3,3,0,0,0,0,0,1,0,1,0,0,0,0
Nanami SEKI,Japan,Setter,Women,Bulgaria,2022-06-16,Pool,3,3,0,0,0,0,0,0,1,2,3,0,1,6,7,0,0,0,0,6,3,1,10,29,2,52,83
Yoshino SATO,Japan,Outside Hitter,Women,Bulgaria,2022-06-16,Pool,3,3,1,0,0,0,0,0,0,0,0,1,1,3,5,0,0,0,0,0,0,0,0,0,0,0,0
Akane MORIYA,Japan,Libero,Women,Poland,2022-06-14,Pool,3,3,0,0,0,0,0,0,0,0,0,0,0,0,0,0,0,0,0,0,0,0,0,0,0,0,0
Mami UCHISETO,Japan,Outside Hitter,Women,Poland,2022-06-14,Pool,3,3,0,0,0,0,0,0,0,0,0,0,0,0,0,0,0,0,0,0,0,0,0,0,0,0,0
Sarina KOGA,Japan,Outside Hitter,Women,Poland,2022-06-14,Pool,3,3,19,16,3,12,31,2,1,2,5,1,0,15,16,3,0,9,12,6,1,1,8,0,0,0,0
Mayu ISHIKAWA,Japan,Outside Hitter,Women,Poland,2022-06-14,Pool,3,3,0,0,0,0,0,0,0,0,0,0,1,2,3,0,0,0,0,0,0,0,0,0,0,0,0
Haruyo SHIMAMURA,Japan,Middle Blocker,Women,Poland,2022-06-14,Pool,3,3,10,9,1,6,16,0,3,0,3,1,0,11,12,0,0,1,1,3,0,1,4,0,0,1,1
Haruka MIYASHITA,Japan,Setter,Women,Poland,2022-06-14,Pool,3,3,0,0,0,0,0,0,0,0,0,0,0,0,0,0,0,0,0,0,0,0,0,0,0,0,0
Manami KOJIMA,Japan,Libero,Women,Poland,2022-06-14,Pool,3,3,0,0,0,0,0,0,0,0,0,0,0,0,0,6,0,9,15,7,5,1,13,0,0,2,2
Arisa INOUE,Japan,Outside Hitter,Women,Poland,2022-06-14,Pool,3,3,17,16,4,19,39,1,2,3,6,0,3,8,11,0,0,0,0,2,1,0,3,0,0,0,0
Kotona HAYASHI,Japan,Outside Hitter,Women,Poland,2022-06-14,Pool,3,3,7,5,2,4,11,1,1,0,2,1,2,6,9,12,1,16,29,12,4,1,17,0,0,0,0
Mami YOKOTA,Japan,Middle Blocker,Women,Poland,2022-06-14,Pool,3,3,4,3,1,3,7,0,1,7,8,1,2,9,12,0,0,2,2,2,1,0,3,0,0,0,0
Tamaki MATSUI,Japan,Setter,Women,Poland,2022-06-14,Pool,3,3,0,0,0,0,0,0,0,0,0,0,0,1,1,0,0,0,0,0,0,0,0,0,0,0,0
Erina OGAWA,Japan,Middle Blocker,Women,Poland,2022-06-14,Pool,3,3,0,0,0,0,0,0,0,0,0,0,0,0,0,0,0,0,0,0,0,0,0,0,0,0,0
Nanami SEKI,Japan,Setter,Women,Poland,2022-06-14,Pool,3,3,0,0,0,0,0,0,1,2,3,0,2,7,9,0,0,0,0,1,1,1,3,25,0,75,100
Yoshino SATO,Japan,Outside Hitter,Women,Poland,2022-06-14,Pool,3,3,0,0,0,0,0,0,0,0,0,0,0,0,0,0,0,0,0,0,0,0,0,0,0,0,0
Akane MORIYA,Japan,Libero,Women,United States,2022-06-05,Pool,3,3,0,0,0,0,0,0,0,0,0,0,0,0,0,0,0,0,0,0,0,0,0,0,0,0,0
Mami UCHISETO,Japan,Outside Hitter,Women,United States,2022-06-05,Pool,3,3,0,0,0,0,0,0,0,0,0,0,0,0,0,0,0,0,0,0,0,0,0,0,0,0,0
Sarina KOGA,Japan,Outside Hitter,Women,United States,2022-06-05,Pool,3,3,19,17,4,21,42,2,3,2,7,0,2,10,12,18,0,3,21,10,1,0,11,0,0,0,0
Mayu ISHIKAWA,Japan,Outside Hitter,Women,United States,2022-06-05,Pool,3,3,0,0,0,0,0,0,0,0,0,0,0,2,2,0,0,0,0,1,0,0,1,0,0,0,0
Haruyo SHIMAMURA,Japan,Middle Blocker,Women,United States,2022-06-05,Pool,3,3,7,4,1,5,10,3,7,1,11,0,0,8,8,4,0,0,4,3,0,0,3,0,0,3,3
Manami KOJIMA,Japan,Libero,Women,United States,2022-06-05,Pool,3,3,0,0,0,0,0,0,0,0,0,0,0,0,0,11,0,8,19,16,4,2,22,0,0,9,9
Arisa INOUE,Japan,Outside Hitter,Women,United States,2022-06-05,Pool,3,3,19,17,2,24,43,1,3,3,7,1,0,10,11,1,0,0,1,16,1,0,17,0,0,1,1
Fuyumi Hawi OKUMU OBA,Japan,Outside Hitter,Women,United States,2022-06-05,Pool,3,3,0,0,0,0,0,0,0,0,0,0,0,0,0,0,0,0,0,0,0,0,0,0,0,0,0
Kotona HAYASHI,Japan,Outside Hitter,Women,United States,2022-06-05,Pool,3,3,5,5,2,6,13,0,3,4,7,0,0,12,12,7,0,1,8,14,1,0,15,0,0,2,2
Nichika YAMADA,Japan,Middle Blocker,Women,United States,2022-06-05,Pool,3,3,0,0,0,0,0,0,0,0,0,0,0,0,0,0,0,0,0,0,0,0,0,0,0,0,0
Tamaki MATSUI,Japan,Setter,Women,United States,2022-06-05,Pool,3,3,0,0,0,0,0,0,0,0,0,0,0,0,0,0,0,0,0,0,0,0,0,0,0,0,0
Erina OGAWA,Japan,Middle Blocker,Women,United States,2022-06-05,Pool,3,3,5,3,0,8,11,0,4,1,5,2,3,12,17,3,0,0,3,3,0,0,3,0,0,1,1
Nanami SEKI,Japan,Setter,Women,United States,2022-06-05,Pool,3,3,2,1,0,2,3,0,2,3,5,1,1,9,11,0,0,0,0,10,0,0,10,19,0,79,98
Yoshino SATO,Japan,Outside Hitter,Women,United States,2022-06-05,Pool,3,3,0,0,0,0,0,0,0,0,0,0,0,1,1,0,0,0,0,0,0,0,0,0,0,0,0
Akane MORIYA,Japan,Libero,Women,Dominican Republic,2022-06-04,Pool,3,4,0,0,0,0,0,0,0,0,0,0,0,0,0,0,0,0,0,0,0,0,0,0,0,0,0
Mami UCHISETO,Japan,Outside Hitter,Women,Dominican Republic,2022-06-04,Pool,3,4,2,2,2,7,11,0,0,1,1,0,0,6,6,6,0,1,7,3,0,0,3,0,0,1,1
Sarina KOGA,Japan,Outside Hitter,Women,Dominican Republic,2022-06-04,Pool,3,4,19,17,8,26,51,2,1,4,7,0,1,13,14,14,1,4,19,8,1,0,9,0,0,4,4
Mayu ISHIKAWA,Japan,Outside Hitter,Women,Dominican Republic,2022-06-04,Pool,3,4,0,0,0,0,0,0,0,0,0,0,1,0,1,0,0,0,0,0,0,0,0,0,0,0,0
Haruyo SHIMAMURA,Japan,Middle Blocker,Women,Dominican Republic,2022-06-04,Pool,3,4,2,1,1,2,4,1,2,4,7,0,1,7,8,0,0,0,0,2,0,0,2,0,0,2,2
Manami KOJIMA,Japan,Libero,Women,Dominican Republic,2022-06-04,Pool,3,4,0,0,0,0,0,0,0,0,0,0,0,0,0,19,1,6,26,27,2,0,29,0,0,14,14
Arisa INOUE,Japan,Outside Hitter,Women,Dominican Republic,2022-06-04,Pool,3,4,26,22,2,17,41,3,0,2,5,1,2,9,12,0,0,0,0,15,3,1,19,0,0,3,3
Fuyumi Hawi OKUMU OBA,Japan,Outside Hitter,Women,Dominican Republic,2022-06-04,Pool,3,4,2,2,1,1,4,0,0,0,0,0,0,0,0,0,0,0,0,0,0,0,0,0,0,1,1
Kotona HAYASHI,Japan,Outside Hitter,Women,Dominican Republic,2022-06-04,Pool,3,4,6,5,2,9,16,0,1,4,5,1,1,14,16,10,1,1,12,12,0,0,12,0,0,0,0
Nichika YAMADA,Japan,Middle Blocker,Women,Dominican Republic,2022-06-04,Pool,3,4,1,1,0,2,3,0,3,2,5,0,1,7,8,0,0,0,0,1,0,0,1,0,0,1,1
Tamaki MATSUI,Japan,Setter,Women,Dominican Republic,2022-06-04,Pool,3,4,0,0,0,0,0,0,0,1,1,0,0,2,2,0,0,0,0,3,2,1,6,10,1,24,35
Erina OGAWA,Japan,Middle Blocker,Women,Dominican Republic,2022-06-04,Pool,3,4,9,7,2,6,15,1,0,7,8,1,1,7,9,1,0,0,1,9,1,0,10,0,0,2,2
Nanami SEKI,Japan,Setter,Women,Dominican Republic,2022-06-04,Pool,3,4,3,3,0,0,3,0,1,6,7,0,0,16,16,0,0,0,0,13,1,0,14,23,0,54,77
Yoshino SATO,Japan,Outside Hitter,Women,Dominican Republic,2022-06-04,Pool,3,4,0,0,0,0,0,0,0,0,0,0,1,1,2,0,0,0,0,0,0,0,0,0,0,0,0
Akane MORIYA,Japan,Libero,Women,Germany,2022-06-02,Pool,3,5,0,0,0,0,0,0,0,0,0,0,0,0,0,0,0,0,0,0,0,0,0,0,0,0,0
Mami UCHISETO,Japan,Outside Hitter,Women,Germany,2022-06-02,Pool,3,5,8,6,0,17,23,0,3,4,7,2,0,15,17,25,2,6,33,16,1,0,17,0,0,2,2
Sarina KOGA,Japan,Outside Hitter,Women,Germany,2022-06-02,Pool,3,5,33,33,9,34,76,0,2,3,5,0,2,18,20,19,1,6,26,13,1,0,14,0,0,4,4
Mayu ISHIKAWA,Japan,Outside Hitter,Women,Germany,2022-06-02,Pool,3,5,7,7,5,10,22,0,2,2,4,0,1,12,13,1,0,2,3,11,4,0,15,0,0,1,1
Haruyo SHIMAMURA,Japan,Middle Blocker,Women,Germany,2022-06-02,Pool,3,5,0,0,0,0,0,0,0,0,0,0,0,0,0,0,0,0,0,0,0,0,0,0,0,0,0
Manami KOJIMA,Japan,Libero,Women,Germany,2022-06-02,Pool,3,5,0,0,0,0,0,0,0,0,0,0,0,0,0,16,1,11,28,29,5,4,38,0,0,12,12
Arisa INOUE,Japan,Outside Hitter,Women,Germany,2022-06-02,Pool,3,5,13,13,1,15,29,0,0,3,3,0,1,14,15,0,0,0,0,10,1,1,12,0,0,7,7
Fuyumi Hawi OKUMU OBA,Japan,Outside Hitter,Women,Germany,2022-06-02,Pool,3,5,0,0,0,0,0,0,0,0,0,0,0,0,0,0,0,0,0,0,0,0,0,0,0,0,0
Kotona HAYASHI,Japan,Outside Hitter,Women,Germany,2022-06-02,Pool,3,5,0,0,0,0,0,0,0,0,0,0,0,1,1,0,0,0,0,0,0,0,0,0,0,0,0
Nichika YAMADA,Japan,Middle Blocker,Women,Germany,2022-06-02,Pool,3,5,5,4,1,8,13,1,2,5,8,0,3,9,12,0,0,0,0,5,0,0,5,0,0,2,2
Tamaki MATSUI,Japan,Setter,Women,Germany,2022-06-02,Pool,3,5,0,0,0,1,1,0,1,2,3,0,0,6,6,0,1,0,1,4,1,0,5,24,0,46,70
Erina OGAWA,Japan,Middle Blocker,Women,Germany,2022-06-02,Pool,3,5,13,11,3,8,22,0,6,3,9,2,1,9,12,2,1,0,3,5,0,0,5,0,0,1,1
Nanami SEKI,Japan,Setter,Women,Germany,2022-06-02,Pool,3,5,0,0,0,0,0,0,1,0,1,0,1,7,8,0,0,0,0,10,0,0,10,25,1,57,83
Yoshino SATO,Japan,Outside Hitter,Women,Germany,2022-06-02,Pool,3,5,0,0,0,0,0,0,0,0,0,0,0,8,8,0,0,0,0,2,1,1,4,0,0,1,1
Akane MORIYA,Japan,Libero,Women,Korea,2022-06-02,Pool,3,3,0,0,0,0,0,0,0,0,0,0,0,0,0,0,0,0,0,0,0,0,0,0,0,0,0
Mami UCHISETO,Japan,Outside Hitter,Women,Korea,2022-06-02,Pool,3,3,4,4,2,6,12,0,0,2,2,0,0,9,9,5,0,2,7,7,0,0,7,0,0,3,3
Sarina KOGA,Japan,Outside Hitter,Women,Korea,2022-06-02,Pool,3,3,22,19,1,14,34,3,2,1,6,0,1,13,14,7,0,0,7,14,0,0,14,0,0,3,3
Mayu ISHIKAWA,Japan,Outside Hitter,Women,Korea,2022-06-02,Pool,3,3,14,10,3,12,25,2,1,1,4,2,1,15,18,12,0,5,17,21,1,0,22,0,0,2,2
Haruyo SHIMAMURA,Japan,Middle Blocker,Women,Korea,2022-06-02,Pool,3,3,0,0,0,0,0,0,0,0,0,0,0,0,0,0,0,0,0,0,0,0,0,0,0,0,0
Manami KOJIMA,Japan,Libero,Women,Korea,2022-06-02,Pool,3,3,0,0,0,0,0,0,0,0,0,0,0,0,0,3,2,0,5,6,2,0,8,0,0,12,12
Arisa INOUE,Japan,Outside Hitter,Women,Korea,2022-06-02,Pool,3,3,0,0,0,0,0,0,0,0,0,0,0,0,0,0,0,0,0,0,0,0,0,0,0,1,1
Fuyumi Hawi OKUMU OBA,Japan,Outside Hitter,Women,Korea,2022-06-02,Pool,3,3,0,0,0,0,0,0,0,0,0,0,0,0,0,0,0,0,0,0,0,0,0,0,0,0,0
Kotona HAYASHI,Japan,Outside Hitter,Women,Korea,2022-06-02,Pool,3,3,0,0,0,0,0,0,0,0,0,0,0,2,2,0,0,0,0,0,0,0,0,0,0,0,0
Nichika YAMADA,Japan,Middle Blocker,Women,Korea,2022-06-02,Pool,3,3,5,5,0,7,12,0,2,4,6,0,2,7,9,0,0,0,0,4,1,0,5,0,0,2,2
Tamaki MATSUI,Japan,Setter,Women,Korea,2022-06-02,Pool,3,3,2,2,0,1,3,0,1,0,1,0,0,8,8,0,0,1,1,16,2,1,19,30,0,48,78
Erina OGAWA,Japan,Middle Blocker,Women,Korea,2022-06-02,Pool,3,3,7,7,2,8,17,0,2,3,5,0,0,10,10,0,0,0,0,4,0,0,4,0,0,2,2
Nanami SEKI,Japan,Setter,Women,Korea,2022-06-02,Pool,3,3,0,0,0,0,0,0,0,0,0,0,0,0,0,0,0,0,0,0,0,0,0,0,0,0,0
Yoshino SATO,Japan,Outside Hitter,Women,Korea,2022-06-02,Pool,3,3,2,2,3,5,10,0,1,1,2,0,1,3,4,1,0,0,1,3,1,0,4,0,0,1,1
Hye Seon YEUM,Korea,Setter,Women,China,2022-07-03,Pool,1,4,0,0,1,2,3,0,2,2,4,0,2,13,15,0,0,0,0,12,1,1,14,10,1,122,133
Dahye HAN,Korea,Libero,Women,China,2022-07-03,Pool,1,4,0,0,0,0,0,0,0,0,0,0,0,0,0,5,1,19,25,17,2,2,21,0,0,4,4
Sohwi KANG,Korea,Outside Hitter,Women,China,2022-07-03,Pool,1,4,11,9,3,20,32,1,2,1,4,1,1,14,16,6,3,15,24,3,4,0,7,0,0,0,0
Juah LEE,Korea,Middle Blocker,Women,China,2022-07-03,Pool,1,4,10,6,3,8,17,2,4,3,9,2,1,16,19,0,0,1,1,2,0,0,2,0,0,0,0
Yerim GO,Korea,Outside Hitter,Women,China,2022-07-03,Pool,1,4,0,0,0,0,0,0,0,0,0,0,0,0,0,0,0,0,0,0,0,0,0,0,0,0,0
Hyemin PARK,Korea,Outside Hitter,Women,China,2022-07-03,Pool,1,4,0,0,0,0,0,0,0,0,0,0,0,0,0,0,0,0,0,0,0,0,0,0,0,0,0
Dahyeon LEE,Korea,Middle Blocker,Women,China,2022-07-03,Pool,1,4,11,9,2,9,20,1,5,3,9,1,1,8,10,0,0,0,0,2,1,1,4,0,0,0,0
Jeongah PARK,Korea,Outside Hitter,Women,China,2022-07-03,Pool,1,4,11,11,10,21,42,0,3,0,3,0,1,10,11,0,0,1,1,4,0,4,8,0,0,2,2
Minkyoung HWANG,Korea,Outside Hitter,Women,China,2022-07-03,Pool,1,4,0,0,0,0,0,0,0,0,0,0,0,0,0,0,0,0,0,0,0,0,0,0,0,0,0
Hanbi LEE,Korea,Outside Hitter,Women,China,2022-07-03,Pool,1,4,12,12,6,14,32,0,2,2,4,0,2,9,11,7,0,27,34,7,2,2,11,0,0,2,2
Haejin PARK,Korea,Setter,Women,China,2022-07-03,Pool,1,4,0,0,0,0,0,0,0,0,0,0,0,0,0,0,0,0,0,0,0,0,0,0,0,0,0
Jeongmin CHOI,Korea,Libero,Women,China,2022-07-03,Pool,1,4,0,0,0,0,0,0,0,0,0,0,0,0,0,0,0,0,0,0,0,0,0,0,0,0,0
Heejin KIM,Korea,Opposite Spiker,Women,China,2022-07-03,Pool,1,4,0,0,0,0,0,0,0,0,0,0,0,0,0,0,0,0,0,0,0,0,0,0,0,0,0
Hyejin AN,Korea,Setter,Women,China,2022-07-03,Pool,1,4,0,0,0,0,0,0,0,0,0,0,0,0,0,0,0,0,0,0,0,0,0,0,0,0,0
Hye Seon YEUM,Korea,Setter,Women,Italy,2022-07-01,Pool,1,4,1,0,0,0,0,0,0,2,2,1,2,10,13,0,0,1,1,6,2,1,9,7,1,91,99
Dahye HAN,Korea,Libero,Women,Italy,2022-07-01,Pool,1,4,0,0,0,0,0,0,0,0,0,0,0,0,0,7,0,15,22,15,3,6,24,1,0,5,6
Sohwi KANG,Korea,Outside Hitter,Women,Italy,2022-07-01,Pool,1,4,5,5,6,15,26,0,0,1,1,0,2,7,9,7,1,24,32,10,2,2,14,0,0,0,0
Juah LEE,Korea,Middle Blocker,Women,Italy,2022-07-01,Pool,1,4,7,4,4,15,23,3,3,2,8,0,2,7,9,0,0,0,0,2,0,1,3,0,0,0,0
Yerim GO,Korea,Outside Hitter,Women,Italy,2022-07-01,Pool,1,4,0,0,0,3,3,0,1,0,1,0,0,2,2,2,0,4,6,1,0,0,1,0,0,0,0
Hyemin PARK,Korea,Outside Hitter,Women,Italy,2022-07-01,Pool,1,4,0,0,0,0,0,0,0,0,0,0,0,0,0,0,0,1,1,0,0,0,0,0,0,0,0
Dahyeon LEE,Korea,Middle Blocker,Women,Italy,2022-07-01,Pool,1,4,9,7,3,9,19,2,6,3,11,0,1,9,10,1,1,1,3,2,1,1,4,0,0,2,2
Jeongah PARK,Korea,Outside Hitter,Women,Italy,2022-07-01,Pool,1,4,13,12,8,20,40,1,2,3,6,0,1,15,16,0,0,2,2,0,1,1,2,1,1,1,3
Minkyoung HWANG,Korea,Outside Hitter,Women,Italy,2022-07-01,Pool,1,4,0,0,0,0,0,0,0,0,0,0,0,0,0,0,0,0,0,0,0,0,0,0,0,0,0
Hanbi LEE,Korea,Outside Hitter,Women,Italy,2022-07-01,Pool,1,4,14,14,3,10,27,0,2,1,3,0,3,8,11,4,0,15,19,4,0,2,6,0,1,0,1
Haejin PARK,Korea,Setter,Women,Italy,2022-07-01,Pool,1,4,0,0,0,0,0,0,0,0,0,0,0,0,0,0,1,0,1,0,0,0,0,0,0,0,0
Jeongmin CHOI,Korea,Libero,Women,Italy,2022-07-01,Pool,1,4,0,0,0,0,0,0,0,0,0,0,0,0,0,0,0,0,0,0,0,0,0,0,0,0,0
Heejin KIM,Korea,Opposite Spiker,Women,Italy,2022-07-01,Pool,1,4,0,0,0,0,0,0,0,0,0,0,0,0,0,0,0,0,0,0,0,0,0,0,0,0,0
Hyejin AN,Korea,Setter,Women,Italy,2022-07-01,Pool,1,4,0,0,0,1,1,0,0,0,0,0,1,6,7,0,0,0,0,0,0,0,0,2,1,29,32
Hye Seon YEUM,Korea,Setter,Women,Brazil,2022-06-30,Pool,0,3,1,0,0,0,0,0,0,0,0,1,2,6,9,0,0,1,1,2,1,2,5,55,0,2,57
Dahye HAN,Korea,Libero,Women,Brazil,2022-06-30,Pool,0,3,0,0,0,0,0,0,0,0,0,0,0,0,0,7,0,15,22,9,1,2,12,1,0,1,2
Sohwi KANG,Korea,Outside Hitter,Women,Brazil,2022-06-30,Pool,0,3,6,4,3,14,21,2,0,0,2,0,2,7,9,5,2,12,19,4,2,2,8,5,0,0,5
Juah LEE,Korea,Middle Blocker,Women,Brazil,2022-06-30,Pool,0,3,8,7,5,6,18,1,6,2,9,0,1,5,6,0,0,1,1,0,0,1,1,0,0,0,0
Yerim GO,Korea,Outside Hitter,Women,Brazil,2022-06-30,Pool,0,3,0,0,2,2,4,0,2,0,2,0,1,2,3,1,2,19,22,5,0,2,7,1,1,1,3
Hyemin PARK,Korea,Outside Hitter,Women,Brazil,2022-06-30,Pool,0,3,0,0,0,0,0,0,0,0,0,0,0,0,0,0,0,0,0,0,0,0,0,0,0,0,0
Dahyeon LEE,Korea,Middle Blocker,Women,Brazil,2022-06-30,Pool,0,3,8,6,5,8,19,1,4,0,5,1,0,10,11,0,0,0,0,2,0,1,3,0,0,0,0
Jeongah PARK,Korea,Outside Hitter,Women,Brazil,2022-06-30,Pool,0,3,14,12,6,14,32,1,2,0,3,1,2,5,8,0,0,0,0,3,1,3,7,0,1,0,1
Minkyoung HWANG,Korea,Outside Hitter,Women,Brazil,2022-06-30,Pool,0,3,0,0,0,0,0,0,0,0,0,0,0,0,0,0,0,0,0,0,0,0,0,0,0,0,0
Hanbi LEE,Korea,Outside Hitter,Women,Brazil,2022-06-30,Pool,0,3,0,0,1,1,2,0,0,0,0,0,0,2,2,1,0,4,5,1,0,0,1,0,0,0,0
Haejin PARK,Korea,Setter,Women,Brazil,2022-06-30,Pool,0,3,0,0,0,0,0,0,0,0,0,0,0,0,0,0,0,0,0,0,0,0,0,0,0,0,0
Jeongmin CHOI,Korea,Libero,Women,Brazil,2022-06-30,Pool,0,3,0,0,0,0,0,0,0,0,0,0,0,0,0,0,0,0,0,0,0,0,0,0,0,0,0
Heejin KIM,Korea,Opposite Spiker,Women,Brazil,2022-06-30,Pool,0,3,0,0,0,0,0,0,0,0,0,0,0,0,0,0,0,0,0,0,0,0,0,0,0,0,0
Hyejin AN,Korea,Setter,Women,Brazil,2022-06-30,Pool,0,3,0,0,0,0,0,0,0,0,0,0,0,3,3,0,0,0,0,0,0,0,0,22,0,0,22
Hye Seon YEUM,Korea,Setter,Women,Thailand,2022-06-29,Pool,0,3,1,0,1,0,1,0,0,1,1,1,1,6,8,0,0,0,0,3,0,1,4,45,1,2,48
Dahye HAN,Korea,Libero,Women,Thailand,2022-06-29,Pool,0,3,0,0,0,0,0,0,0,0,0,0,0,0,0,9,0,20,29,7,0,2,9,9,1,0,10
Sohwi KANG,Korea,Outside Hitter,Women,Thailand,2022-06-29,Pool,0,3,6,5,8,7,20,1,1,1,3,0,3,6,9,4,0,17,21,6,0,3,9,2,0,0,2
Juah LEE,Korea,Middle Blocker,Women,Thailand,2022-06-29,Pool,0,3,8,6,2,5,13,2,3,0,5,0,1,12,13,0,0,0,0,2,1,0,3,1,0,0,1
Yerim GO,Korea,Outside Hitter,Women,Thailand,2022-06-29,Pool,0,3,0,0,0,0,0,0,0,0,0,0,0,0,0,0,0,0,0,0,0,0,0,0,0,0,0
Hyemin PARK,Korea,Outside Hitter,Women,Thailand,2022-06-29,Pool,0,3,0,0,3,5,8,0,0,1,1,0,0,1,1,0,0,2,2,0,0,0,0,0,0,0,0
Dahyeon LEE,Korea,Middle Blocker,Women,Thailand,2022-06-29,Pool,0,3,7,5,3,4,12,2,4,1,7,0,0,5,5,0,0,0,0,2,0,0,2,0,0,0,0
Jeongah PARK,Korea,Outside Hitter,Women,Thailand,2022-06-29,Pool,0,3,12,11,3,14,28,1,0,0,1,0,1,4,5,4,1,10,15,4,0,0,4,0,0,0,0
Minkyoung HWANG,Korea,Outside Hitter,Women,Thailand,2022-06-29,Pool,0,3,0,0,0,0,0,0,0,0,0,0,0,0,0,0,0,0,0,0,0,0,0,0,0,0,0
Hanbi LEE,Korea,Outside Hitter,Women,Thailand,2022-06-29,Pool,0,3,3,3,2,10,15,0,1,1,2,0,1,2,3,1,0,0,1,1,0,0,1,0,0,0,0
Haejin PARK,Korea,Setter,Women,Thailand,2022-06-29,Pool,0,3,0,0,0,0,0,0,0,0,0,0,0,0,0,0,0,0,0,0,0,0,0,0,0,0,0
Jeongmin CHOI,Korea,Libero,Women,Thailand,2022-06-29,Pool,0,3,0,0,0,0,0,0,0,0,0,0,0,0,0,0,0,0,0,0,0,0,0,0,0,0,0
Heejin KIM,Korea,Opposite Spiker,Women,Thailand,2022-06-29,Pool,0,3,3,3,5,8,16,0,3,1,4,0,1,3,4,0,0,0,0,0,0,0,0,0,0,0,0
Hyejin AN,Korea,Setter,Women,Thailand,2022-06-29,Pool,0,3,0,0,0,0,0,0,0,0,0,0,0,3,3,0,0,0,0,1,0,0,1,47,1,0,48
Hye Seon YEUM,Korea,Setter,Women,Türkiye,2022-06-19,Pool,1,4,1,0,0,2,2,0,7,4,11,1,1,14,16,0,0,0,0,4,0,1,5,23,1,91,115
Dahye HAN,Korea,Libero,Women,Türkiye,2022-06-19,Pool,1,4,0,0,0,0,0,0,0,0,0,0,0,0,0,7,0,12,19,11,1,1,13,0,0,5,5
Sohwi KANG,Korea,Outside Hitter,Women,Türkiye,2022-06-19,Pool,1,4,13,11,8,16,35,2,2,1,5,0,2,8,10,13,1,15,29,3,0,0,3,0,0,3,3
Hoyoung JUNG,Korea,Middle Blocker,Women,Türkiye,2022-06-19,Pool,1,4,10,7,4,2,13,2,1,1,4,1,1,14,16,0,0,1,1,1,1,0,2,0,0,0,0
Yerim GO,Korea,Outside Hitter,Women,Türkiye,2022-06-19,Pool,1,4,0,0,0,0,0,0,0,0,0,0,0,1,1,0,0,0,0,0,0,0,0,0,0,0,0
Hyemin PARK,Korea,Outside Hitter,Women,Türkiye,2022-06-19,Pool,1,4,0,0,0,0,0,0,0,0,0,0,0,2,2,1,2,4,7,0,0,0,0,0,0,0,0
Dahyeon LEE,Korea,Middle Blocker,Women,Türkiye,2022-06-19,Pool,1,4,6,4,4,2,10,1,2,5,8,1,0,8,9,0,0,0,0,2,0,0,2,0,0,0,0
Jeongah PARK,Korea,Outside Hitter,Women,Türkiye,2022-06-19,Pool,1,4,10,10,7,20,37,0,3,0,3,0,0,9,9,4,1,21,26,2,4,0,6,0,0,3,3
Minkyoung HWANG,Korea,Outside Hitter,Women,Türkiye,2022-06-19,Pool,1,4,0,0,0,0,0,0,0,0,0,0,0,1,1,1,2,2,5,0,0,0,0,0,0,0,0
Hanbi LEE,Korea,Outside Hitter,Women,Türkiye,2022-06-19,Pool,1,4,0,0,0,0,0,0,0,0,0,0,0,0,0,0,0,0,0,0,0,0,0,0,0,0,0
Jeongmin CHOI,Korea,Libero,Women,Türkiye,2022-06-19,Pool,1,4,0,0,0,0,0,0,0,0,0,0,0,0,0,0,0,0,0,0,0,0,0,0,0,0,0
Heejin KIM,Korea,Opposite Spiker,Women,Türkiye,2022-06-19,Pool,1,4,11,10,6,13,29,1,4,3,8,0,1,8,9,0,0,0,0,4,3,1,8,0,0,1,1
Hye Seon YEUM,Korea,Setter,Women,Netherlands,2022-06-19,Pool,0,3,3,0,0,1,1,0,2,0,2,3,3,8,14,0,0,0,0,3,3,1,7,25,2,62,89
Dahye HAN,Korea,Libero,Women,Netherlands,2022-06-19,Pool,0,3,0,0,0,0,0,0,0,0,0,0,0,0,0,6,0,10,16,8,5,0,13,0,0,3,3
Seonwoo LEE,Korea,Outside Hitter,Women,Netherlands,2022-06-19,Pool,0,3,2,2,2,3,7,0,1,0,1,0,1,0,1,1,0,0,1,1,0,0,1,0,0,1,1
Sohwi KANG,Korea,Outside Hitter,Women,Netherlands,2022-06-19,Pool,0,3,7,7,3,6,16,0,3,2,5,0,3,5,8,9,0,9,18,8,1,3,12,0,0,3,3
Hoyoung JUNG,Korea,Middle Blocker,Women,Netherlands,2022-06-19,Pool,0,3,4,3,1,3,7,1,5,3,9,0,0,5,5,0,0,0,0,1,0,0,1,0,0,0,0
Yerim GO,Korea,Outside Hitter,Women,Netherlands,2022-06-19,Pool,0,3,2,2,0,2,4,0,0,0,0,0,1,3,4,3,1,1,5,0,0,1,1,0,0,2,2
Hyemin PARK,Korea,Outside Hitter,Women,Netherlands,2022-06-19,Pool,0,3,0,0,0,0,0,0,0,0,0,0,0,0,0,0,0,0,0,0,0,0,0,0,0,0,0
Dahyeon LEE,Korea,Middle Blocker,Women,Netherlands,2022-06-19,Pool,0,3,3,2,0,2,4,1,4,2,7,0,1,3,4,0,0,0,0,1,0,0,1,0,0,0,0
Jeongah PARK,Korea,Outside Hitter,Women,Netherlands,2022-06-19,Pool,0,3,9,8,3,13,24,1,0,0,1,0,2,5,7,2,0,13,15,2,1,0,3,0,0,0,0
Minkyoung HWANG,Korea,Outside Hitter,Women,Netherlands,2022-06-19,Pool,0,3,0,0,1,4,5,0,0,0,0,0,0,2,2,3,1,7,11,0,0,0,0,0,0,0,0
Hanbi LEE,Korea,Outside Hitter,Women,Netherlands,2022-06-19,Pool,0,3,0,0,0,0,0,0,0,0,0,0,0,0,0,0,0,0,0,0,0,0,0,0,0,0,0
Jeongmin CHOI,Korea,Libero,Women,Netherlands,2022-06-19,Pool,0,3,0,0,0,0,0,0,0,0,0,0,0,0,0,0,0,0,0,0,0,0,0,0,0,0,0
Heejin KIM,Korea,Opposite Spiker,Women,Netherlands,2022-06-19,Pool,0,3,12,10,1,14,25,2,1,1,4,0,1,6,7,0,0,0,0,3,0,1,4,0,0,0,0
Hye Seon YEUM,Korea,Setter,Women,Serbia,2022-06-16,Pool,0,3,3,3,0,2,5,0,0,2,2,0,2,11,13,0,0,0,0,5,2,5,12,25,2,94,121
Dahye HAN,Korea,Libero,Women,Serbia,2022-06-16,Pool,0,3,0,0,0,0,0,0,0,0,0,0,0,0,0,5,0,6,11,8,4,2,14,0,0,8,8
Seonwoo LEE,Korea,Outside Hitter,Women,Serbia,2022-06-16,Pool,0,3,9,6,13,15,34,3,2,1,6,0,4,6,10,3,0,3,6,4,1,1,6,0,0,0,0
Sohwi KANG,Korea,Outside Hitter,Women,Serbia,2022-06-16,Pool,0,3,2,1,0,3,4,0,0,1,1,1,1,1,3,0,0,0,0,0,0,0,0,0,0,1,1
Hoyoung JUNG,Korea,Middle Blocker,Women,Serbia,2022-06-16,Pool,0,3,8,7,1,4,12,1,5,10,16,0,1,14,15,0,0,0,0,1,0,0,1,0,0,2,2
Juah LEE,Korea,Middle Blocker,Women,Serbia,2022-06-16,Pool,0,3,0,0,0,0,0,0,0,0,0,0,0,4,4,0,0,0,0,0,0,0,0,0,0,0,0
Yerim GO,Korea,Outside Hitter,Women,Serbia,2022-06-16,Pool,0,3,17,16,6,13,35,0,2,1,3,1,1,9,11,9,2,15,26,7,2,1,10,0,0,2,2
Hyemin PARK,Korea,Outside Hitter,Women,Serbia,2022-06-16,Pool,0,3,0,0,0,0,0,0,0,0,0,0,0,0,0,0,0,0,0,0,0,0,0,0,0,0,0
Dahyeon LEE,Korea,Middle Blocker,Women,Serbia,2022-06-16,Pool,0,3,9,7,0,6,13,1,7,1,9,1,0,14,15,0,0,0,0,3,0,0,3,0,0,0,0
Jeongah PARK,Korea,Outside Hitter,Women,Serbia,2022-06-16,Pool,0,3,0,0,0,0,0,0,0,0,0,0,0,0,0,0,0,0,0,0,0,0,0,0,0,0,0
Minkyoung HWANG,Korea,Outside Hitter,Women,Serbia,2022-06-16,Pool,0,3,13,12,7,17,36,1,2,0,3,0,4,9,13,16,0,19,35,6,2,0,8,0,0,1,1
Hanbi LEE,Korea,Outside Hitter,Women,Serbia,2022-06-16,Pool,0,3,0,0,0,0,0,0,0,0,0,0,0,0,0,0,0,0,0,0,0,0,0,0,0,0,0
Jeongmin CHOI,Korea,Libero,Women,Serbia,2022-06-16,Pool,0,3,0,0,0,0,0,0,0,0,0,0,0,0,0,0,0,0,0,0,0,0,0,0,0,0,0
Heejin KIM,Korea,Opposite Spiker,Women,Serbia,2022-06-16,Pool,0,3,0,0,0,0,0,0,0,0,0,0,0,0,0,0,0,0,0,0,0,0,0,0,0,0,0
Hye Seon YEUM,Korea,Setter,Women,Dominican Republic,2022-06-15,Pool,0,3,1,0,0,1,1,0,2,0,2,1,3,9,13,0,0,0,0,5,0,0,5,23,1,59,83
Dahye HAN,Korea,Libero,Women,Dominican Republic,2022-06-15,Pool,0,3,0,0,0,0,0,0,0,0,0,0,0,0,0,13,0,10,23,7,4,0,11,0,0,8,8
Seonwoo LEE,Korea,Outside Hitter,Women,Dominican Republic,2022-06-15,Pool,0,3,2,2,0,4,6,0,0,0,0,0,2,1,3,1,0,4,5,0,0,0,0,0,0,0,0
Sohwi KANG,Korea,Outside Hitter,Women,Dominican Republic,2022-06-15,Pool,0,3,5,3,2,6,11,2,0,0,2,0,3,3,6,2,1,13,16,1,0,0,1,0,0,1,1
Hoyoung JUNG,Korea,Middle Blocker,Women,Dominican Republic,2022-06-15,Pool,0,3,10,5,0,6,11,5,2,1,8,0,3,2,5,0,0,0,0,1,0,0,1,0,0,3,3
Juah LEE,Korea,Middle Blocker,Women,Dominican Republic,2022-06-15,Pool,0,3,5,4,0,2,6,1,5,1,7,0,2,4,6,1,0,0,1,0,0,0,0,0,0,1,1
Yerim GO,Korea,Outside Hitter,Women,Dominican Republic,2022-06-15,Pool,0,3,0,0,0,0,0,0,0,0,0,0,0,0,0,0,0,0,0,0,0,0,0,0,0,0,0
Hyemin PARK,Korea,Outside Hitter,Women,Dominican Republic,2022-06-15,Pool,0,3,0,0,0,0,0,0,0,0,0,0,0,0,0,0,0,0,0,0,0,0,0,0,0,0,0
Dahyeon LEE,Korea,Middle Blocker,Women,Dominican Republic,2022-06-15,Pool,0,3,0,0,0,0,0,0,0,0,0,0,0,0,0,0,0,0,0,0,0,0,0,0,0,0,0
Jeongah PARK,Korea,Outside Hitter,Women,Dominican Republic,2022-06-15,Pool,0,3,3,3,1,17,21,0,1,0,1,0,1,5,6,3,1,8,12,1,1,1,3,0,0,1,1
Minkyoung HWANG,Korea,Outside Hitter,Women,Dominican Republic,2022-06-15,Pool,0,3,3,3,0,2,5,0,0,0,0,0,1,4,5,4,0,2,6,1,0,0,1,0,0,0,0
Hanbi LEE,Korea,Outside Hitter,Women,Dominican Republic,2022-06-15,Pool,0,3,0,0,0,0,0,0,0,0,0,0,0,0,0,0,0,0,0,0,0,0,0,0,0,0,0
Heejin KIM,Korea,Opposite Spiker,Women,Dominican Republic,2022-06-15,Pool,0,3,8,8,8,16,32,0,1,2,3,0,5,4,9,0,0,0,0,3,0,0,3,0,0,0,0
Hye Seon YEUM,Korea,Setter,Women,Canada,2022-06-05,Pool,0,3,1,1,0,0,1,0,0,0,0,0,0,6,6,0,0,0,0,4,2,0,6,2,0,55,57
Dahye HAN,Korea,Libero,Women,Canada,2022-06-05,Pool,0,3,0,0,0,0,0,0,0,0,0,0,0,0,0,9,1,0,10,13,2,0,15,0,0,1,1
Ran NOH,Korea,Libero,Women,Canada,2022-06-05,Pool,0,3,0,0,0,0,0,0,0,0,0,0,0,0,0,4,0,2,6,3,0,0,3,0,0,1,1
Seonwoo LEE,Korea,Outside Hitter,Women,Canada,2022-06-05,Pool,0,3,7,7,5,6,18,0,2,0,2,0,2,2,4,0,0,0,0,3,0,0,3,0,0,0,0
Sohwi KANG,Korea,Outside Hitter,Women,Canada,2022-06-05,Pool,0,3,7,6,4,9,19,0,3,3,6,1,1,5,7,7,0,7,14,6,0,0,6,0,0,3,3
Hoyoung JUNG,Korea,Middle Blocker,Women,Canada,2022-06-05,Pool,0,3,0,0,1,3,4,0,5,2,7,0,0,8,8,0,1,0,1,4,0,1,5,0,1,2,3
Juah LEE,Korea,Middle Blocker,Women,Canada,2022-06-05,Pool,0,3,0,0,0,2,2,0,1,2,3,0,0,7,7,0,0,0,0,1,0,0,1,0,0,1,1
Yerim GO,Korea,Outside Hitter,Women,Canada,2022-06-05,Pool,0,3,0,0,0,0,0,0,0,0,0,0,0,0,0,0,0,0,0,0,0,0,0,0,0,0,0
Dahyeon LEE,Korea,Middle Blocker,Women,Canada,2022-06-05,Pool,0,3,3,1,2,1,4,0,0,1,1,2,0,2,4,0,0,1,1,0,0,0,0,0,0,1,1
Jeongah PARK,Korea,Outside Hitter,Women,Canada,2022-06-05,Pool,0,3,5,4,3,12,19,1,1,0,2,0,1,5,6,7,2,13,22,2,2,0,4,0,0,0,0
Minkyoung HWANG,Korea,Outside Hitter,Women,Canada,2022-06-05,Pool,0,3,3,2,0,1,3,0,0,0,0,1,0,2,3,4,0,3,7,3,0,1,4,0,0,0,0
Hanbi LEE,Korea,Outside Hitter,Women,Canada,2022-06-05,Pool,0,3,2,2,4,6,12,0,0,0,0,0,0,1,1,2,0,1,3,0,0,0,0,0,0,0,0
Haejin PARK,Korea,Setter,Women,Canada,2022-06-05,Pool,0,3,0,0,0,1,1,0,0,1,1,0,0,0,0,0,0,0,0,1,0,1,2,2,0,21,23
Heejin KIM,Korea,Opposite Spiker,Women,Canada,2022-06-05,Pool,0,3,5,4,2,5,11,1,1,1,3,0,1,4,5,0,0,0,0,5,1,1,7,0,0,0,0
Hye Seon YEUM,Korea,Setter,Women,Poland,2022-06-04,Pool,0,3,0,0,0,0,0,0,0,0,0,0,2,3,5,0,1,0,1,10,2,0,12,7,1,48,56
Dahye HAN,Korea,Libero,Women,Poland,2022-06-04,Pool,0,3,0,0,0,0,0,0,0,0,0,0,0,0,0,0,0,0,0,0,0,0,0,0,0,0,0
Ran NOH,Korea,Libero,Women,Poland,2022-06-04,Pool,0,3,0,0,0,0,0,0,0,0,0,0,0,0,0,12,0,3,15,14,3,2,19,0,0,12,12
Seonwoo LEE,Korea,Outside Hitter,Women,Poland,2022-06-04,Pool,0,3,4,4,7,6,17,0,0,1,1,0,1,2,3,2,1,3,6,2,0,0,2,0,0,0,0
Sohwi KANG,Korea,Outside Hitter,Women,Poland,2022-06-04,Pool,0,3,0,0,0,0,0,0,0,0,0,0,0,0,0,0,0,0,0,0,0,0,0,0,0,0,0
Hoyoung JUNG,Korea,Middle Blocker,Women,Poland,2022-06-04,Pool,0,3,3,2,0,4,6,1,2,2,5,0,1,9,10,0,0,0,0,0,0,0,0,0,0,1,1
Juah LEE,Korea,Middle Blocker,Women,Poland,2022-06-04,Pool,0,3,7,4,3,2,9,3,0,1,4,0,1,5,6,0,0,1,1,0,0,0,0,0,0,0,0
Yerim GO,Korea,Outside Hitter,Women,Poland,2022-06-04,Pool,0,3,0,0,1,1,2,0,0,0,0,0,0,0,0,0,0,0,0,0,1,0,1,0,0,0,0
Dahyeon LEE,Korea,Middle Blocker,Women,Poland,2022-06-04,Pool,0,3,0,0,0,0,0,0,0,0,0,0,0,0,0,0,0,0,0,0,0,0,0,0,0,0,0
Jeongah PARK,Korea,Outside Hitter,Women,Poland,2022-06-04,Pool,0,3,0,0,1,1,2,0,0,0,0,0,0,0,0,3,0,1,4,0,1,0,1,0,0,0,0
Minkyoung HWANG,Korea,Outside Hitter,Women,Poland,2022-06-04,Pool,0,3,2,2,3,5,10,0,1,1,2,0,0,5,5,13,2,5,20,1,0,0,1,0,0,4,4
Hanbi LEE,Korea,Outside Hitter,Women,Poland,2022-06-04,Pool,0,3,5,4,7,6,17,1,0,0,1,0,1,7,8,9,0,7,16,6,2,0,8,0,0,0,0
Haejin PARK,Korea,Setter,Women,Poland,2022-06-04,Pool,0,3,0,0,0,0,0,0,0,0,0,0,0,0,0,0,0,0,0,0,0,0,0,0,1,16,17
Heejin KIM,Korea,Opposite Spiker,Women,Poland,2022-06-04,Pool,0,3,10,9,4,17,30,0,2,0,2,1,2,5,8,0,0,1,1,5,0,1,6,0,0,0,0
Hye Seon YEUM,Korea,Setter,Women,Germany,2022-06-03,Pool,0,3,1,0,0,0,0,0,0,0,0,1,1,10,12,1,0,0,1,6,0,0,6,12,1,58,71
Dahye HAN,Korea,Libero,Women,Germany,2022-06-03,Pool,0,3,0,0,0,0,0,0,0,0,0,0,0,0,0,0,0,0,0,0,0,0,0,0,0,0,0
Ran NOH,Korea,Libero,Women,Germany,2022-06-03,Pool,0,3,0,0,0,0,0,0,0,0,0,0,0,0,0,6,0,7,13,10,2,0,12,0,0,4,4
Seonwoo LEE,Korea,Outside Hitter,Women,Germany,2022-06-03,Pool,0,3,12,7,6,13,26,0,2,5,7,5,3,4,12,0,0,0,0,0,2,0,2,0,0,0,0
Sohwi KANG,Korea,Outside Hitter,Women,Germany,2022-06-03,Pool,0,3,13,12,2,14,28,0,3,5,8,1,1,8,10,5,2,4,11,4,0,0,4,0,0,3,3
Hoyoung JUNG,Korea,Middle Blocker,Women,Germany,2022-06-03,Pool,0,3,6,6,1,5,12,0,3,5,8,0,0,4,4,0,0,0,0,2,1,0,3,0,0,1,1
Juah LEE,Korea,Middle Blocker,Women,Germany,2022-06-03,Pool,0,3,0,0,0,0,0,0,0,0,0,0,0,0,0,0,0,0,0,0,0,0,0,0,0,0,0
Yerim GO,Korea,Outside Hitter,Women,Germany,2022-06-03,Pool,0,3,0,0,0,0,0,0,0,0,0,0,0,0,0,0,0,0,0,0,0,0,0,0,0,0,0
Dahyeon LEE,Korea,Middle Blocker,Women,Germany,2022-06-03,Pool,0,3,4,2,1,6,9,2,1,0,3,0,1,5,6,1,0,1,2,4,0,0,4,0,0,1,1
Jeongah PARK,Korea,Outside Hitter,Women,Germany,2022-06-03,Pool,0,3,5,5,5,8,18,0,2,2,4,0,1,6,7,20,1,8,29,11,2,0,13,0,0,2,2
Minkyoung HWANG,Korea,Outside Hitter,Women,Germany,2022-06-03,Pool,0,3,0,0,0,0,0,0,0,0,0,0,1,1,2,0,0,0,0,0,0,0,0,0,0,0,0
Hanbi LEE,Korea,Outside Hitter,Women,Germany,2022-06-03,Pool,0,3,1,1,0,1,2,0,1,0,1,0,0,1,1,6,1,4,11,1,0,0,1,0,0,0,0
Haejin PARK,Korea,Setter,Women,Germany,2022-06-03,Pool,0,3,0,0,0,0,0,0,0,0,0,0,0,0,0,0,0,0,0,0,0,0,0,1,1,14,16
Heejin KIM,Korea,Opposite Spiker,Women,Germany,2022-06-03,Pool,0,3,1,1,0,4,5,0,1,2,3,0,0,0,0,0,1,0,1,0,0,0,0,0,0,0,0
Hye Seon YEUM,Korea,Setter,Women,Japan,2022-06-02,Pool,0,3,0,0,0,2,2,0,0,2,2,0,1,8,9,0,0,0,0,6,5,0,11,18,1,62,81
Dahye HAN,Korea,Libero,Women,Japan,2022-06-02,Pool,0,3,0,0,0,0,0,0,0,0,0,0,0,0,0,0,0,0,0,0,0,0,0,0,0,0,0
Ran NOH,Korea,Libero,Women,Japan,2022-06-02,Pool,0,3,0,0,0,0,0,0,0,0,0,0,0,0,0,7,0,4,11,17,5,1,23,0,0,7,7
Seonwoo LEE,Korea,Outside Hitter,Women,Japan,2022-06-02,Pool,0,3,4,2,4,8,14,0,1,1,2,2,1,2,5,0,0,0,0,2,0,0,2,0,0,0,0
Sohwi KANG,Korea,Outside Hitter,Women,Japan,2022-06-02,Pool,0,3,11,9,3,13,25,2,0,0,2,0,1,6,7,18,0,9,27,7,3,0,10,0,0,3,3
Hoyoung JUNG,Korea,Middle Blocker,Women,Japan,2022-06-02,Pool,0,3,4,2,1,8,11,2,1,4,7,0,0,5,5,0,0,0,0,3,0,0,3,0,0,1,1
Juah LEE,Korea,Middle Blocker,Women,Japan,2022-06-02,Pool,0,3,0,0,0,0,0,0,0,0,0,0,0,1,1,0,0,0,0,0,0,0,0,0,0,0,0
Yerim GO,Korea,Outside Hitter,Women,Japan,2022-06-02,Pool,0,3,0,0,0,0,0,0,0,0,0,0,0,0,0,0,0,0,0,0,0,0,0,0,0,0,0
Dahyeon LEE,Korea,Middle Blocker,Women,Japan,2022-06-02,Pool,0,3,5,4,0,6,10,1,2,3,6,0,0,4,4,0,0,0,0,0,0,1,1,0,0,2,2
Jeongah PARK,Korea,Outside Hitter,Women,Japan,2022-06-02,Pool,0,3,7,6,2,15,23,1,0,0,1,0,3,5,8,14,2,12,28,6,4,0,10,0,0,2,2
Minkyoung HWANG,Korea,Outside Hitter,Women,Japan,2022-06-02,Pool,0,3,1,0,0,5,5,1,0,2,3,0,0,2,2,1,0,2,3,3,0,0,3,0,0,1,1
Hanbi LEE,Korea,Outside Hitter,Women,Japan,2022-06-02,Pool,0,3,0,0,0,0,0,0,0,0,0,0,0,0,0,0,0,0,0,0,0,0,0,0,0,0,0
Haejin PARK,Korea,Setter,Women,Japan,2022-06-02,Pool,0,3,0,0,0,0,0,0,0,0,0,0,0,0,0,0,0,0,0,0,0,0,0,0,1,8,9
Heejin KIM,Korea,Opposite Spiker,Women,Japan,2022-06-02,Pool,0,3,4,3,5,9,17,1,2,1,4,0,1,3,4,0,0,0,0,2,1,0,3,0,0,1,1
Fleur SAVELKOEL,Netherlands,Outside Hitter,Women,Canada,2022-07-03,Pool,3,4,18,14,5,18,37,1,3,0,4,3,2,15,20,12,0,9,21,8,3,0,11,0,0,5,5
Celeste PLAK,Netherlands,Opposite Spiker,Women,Canada,2022-07-03,Pool,3,4,19,16,7,19,42,2,2,1,5,1,0,9,10,0,0,0,0,13,1,0,14,0,0,3,3
Jolien KNOLLEMA,Netherlands,Outside Hitter,Women,Canada,2022-07-03,Pool,3,4,0,0,0,0,0,0,0,0,0,0,0,0,0,0,0,0,0,0,0,0,0,0,0,0,0
Juliet LOHUIS,Netherlands,Middle Blocker,Women,Canada,2022-07-03,Pool,3,4,6,4,2,10,16,1,5,3,9,1,2,8,11,0,0,0,0,2,0,0,2,0,0,2,2
Demi KOREVAAR,Netherlands,Middle Blocker,Women,Canada,2022-07-03,Pool,3,4,0,0,0,0,0,0,0,0,0,0,0,0,0,0,0,0,0,0,0,0,0,0,0,0,0
Myrthe SCHOOT,Netherlands,Libero,Women,Canada,2022-07-03,Pool,3,4,0,0,0,0,0,0,0,0,0,0,0,0,0,11,0,6,17,22,2,1,25,0,1,13,14
Anne BUIJS,Netherlands,Outside Hitter,Women,Canada,2022-07-03,Pool,3,4,14,12,5,21,38,1,2,1,4,1,0,18,19,21,2,20,43,18,4,1,23,0,0,6,6
Britt BONGAERTS,Netherlands,Setter,Women,Canada,2022-07-03,Pool,3,4,2,1,0,2,3,0,1,1,2,1,0,17,18,0,0,0,0,11,4,0,15,3,1,134,138
Laura DIJKEMA,Netherlands,Setter,Women,Canada,2022-07-03,Pool,3,4,0,0,0,0,0,0,0,0,0,0,0,0,0,0,0,0,0,0,0,0,0,0,0,1,1
Indy BAIJENS,Netherlands,Middle Blocker,Women,Canada,2022-07-03,Pool,3,4,0,0,0,0,0,0,0,0,0,0,0,0,0,0,0,0,0,0,0,0,0,0,0,0,0
Marrit JASPER,Netherlands,Outside Hitter,Women,Canada,2022-07-03,Pool,3,4,0,0,0,0,0,0,0,0,0,0,0,0,0,1,0,2,3,4,0,0,4,0,0,1,1
Eline TIMMERMAN,Netherlands,Middle Blocker,Women,Canada,2022-07-03,Pool,3,4,11,5,1,6,12,6,6,1,13,0,1,17,18,0,0,0,0,3,2,0,5,0,0,2,2
Florien REESINK,Netherlands,Libero,Women,Canada,2022-07-03,Pool,3,4,0,0,0,0,0,0,0,0,0,0,0,0,0,0,0,0,0,0,0,0,0,0,0,0,0
Elles DAMBRINK,Netherlands,Opposite Spiker,Women,Canada,2022-07-03,Pool,3,4,2,2,1,4,7,0,1,0,1,0,1,2,3,0,0,0,0,1,0,0,1,0,1,0,1
Fleur SAVELKOEL,Netherlands,Outside Hitter,Women,Belgium,2022-07-01,Pool,3,4,18,15,4,20,39,3,2,0,5,0,0,15,15,13,1,19,33,15,0,0,15,0,0,4,4
Celeste PLAK,Netherlands,Opposite Spiker,Women,Belgium,2022-07-01,Pool,3,4,2,2,3,5,10,0,2,0,2,0,1,3,4,0,0,1,1,2,0,0,2,0,0,1,1
Jolien KNOLLEMA,Netherlands,Outside Hitter,Women,Belgium,2022-07-01,Pool,3,4,0,0,0,0,0,0,0,0,0,0,0,0,0,0,0,0,0,0,0,0,0,0,0,0,0
Juliet LOHUIS,Netherlands,Middle Blocker,Women,Belgium,2022-07-01,Pool,3,4,19,14,1,5,20,2,3,3,8,3,0,13,16,0,0,0,0,4,0,0,4,0,0,2,2
Demi KOREVAAR,Netherlands,Middle Blocker,Women,Belgium,2022-07-01,Pool,3,4,0,0,0,0,0,0,0,0,0,0,0,0,0,0,0,0,0,0,0,0,0,0,0,0,0
Myrthe SCHOOT,Netherlands,Libero,Women,Belgium,2022-07-01,Pool,3,4,0,0,0,0,0,0,0,0,0,0,0,0,0,8,0,9,17,23,3,0,26,0,1,8,9
Anne BUIJS,Netherlands,Outside Hitter,Women,Belgium,2022-07-01,Pool,3,4,11,11,4,23,38,0,3,4,7,0,0,14,14,13,0,9,22,11,1,0,12,0,0,3,3
Britt BONGAERTS,Netherlands,Setter,Women,Belgium,2022-07-01,Pool,3,4,2,2,0,2,4,0,5,1,6,0,0,16,16,0,0,0,0,15,0,0,15,8,1,119,128
Laura DIJKEMA,Netherlands,Setter,Women,Belgium,2022-07-01,Pool,3,4,0,0,0,0,0,0,0,0,0,0,0,3,3,0,0,0,0,1,0,0,1,0,0,3,3
Indy BAIJENS,Netherlands,Middle Blocker,Women,Belgium,2022-07-01,Pool,3,4,0,0,0,0,0,0,0,0,0,0,0,0,0,0,0,0,0,0,0,0,0,0,0,0,0
Marrit JASPER,Netherlands,Outside Hitter,Women,Belgium,2022-07-01,Pool,3,4,4,2,2,4,8,2,0,0,2,0,1,1,2,5,0,1,6,1,2,0,3,0,0,0,0
Eline TIMMERMAN,Netherlands,Middle Blocker,Women,Belgium,2022-07-01,Pool,3,4,10,5,2,6,13,4,7,8,19,1,2,15,18,0,0,0,0,5,1,0,6,0,0,2,2
Florien REESINK,Netherlands,Libero,Women,Belgium,2022-07-01,Pool,3,4,0,0,0,0,0,0,0,0,0,0,0,0,0,0,0,0,0,0,0,0,0,0,0,0,0
Elles DAMBRINK,Netherlands,Opposite Spiker,Women,Belgium,2022-07-01,Pool,3,4,12,8,3,9,20,3,2,2,7,1,2,5,8,0,0,0,0,7,1,0,8,0,0,5,5
Fleur SAVELKOEL,Netherlands,Outside Hitter,Women,Türkiye,2022-06-30,Pool,0,3,0,0,0,0,0,0,0,0,0,0,0,0,0,0,0,0,0,0,0,0,0,0,0,0,0
Celeste PLAK,Netherlands,Opposite Spiker,Women,Türkiye,2022-06-30,Pool,0,3,10,7,3,13,23,3,2,1,6,0,1,7,8,0,0,0,0,1,1,1,3,0,0,1,1
Jolien KNOLLEMA,Netherlands,Outside Hitter,Women,Türkiye,2022-06-30,Pool,0,3,0,0,1,1,2,0,0,0,0,0,0,0,0,2,0,1,3,0,0,0,0,0,0,0,0
Juliet LOHUIS,Netherlands,Middle Blocker,Women,Türkiye,2022-06-30,Pool,0,3,5,5,0,2,7,0,0,1,1,0,0,5,5,0,0,0,0,0,1,0,1,0,0,0,0
Demi KOREVAAR,Netherlands,Middle Blocker,Women,Türkiye,2022-06-30,Pool,0,3,0,0,0,0,0,0,0,0,0,0,0,0,0,0,0,0,0,0,0,0,0,0,0,0,0
Myrthe SCHOOT,Netherlands,Libero,Women,Türkiye,2022-06-30,Pool,0,3,0,0,0,0,0,0,0,0,0,0,0,0,0,9,1,4,14,8,3,0,11,0,0,10,10
Anne BUIJS,Netherlands,Outside Hitter,Women,Türkiye,2022-06-30,Pool,0,3,7,7,2,16,25,0,0,0,0,0,1,10,11,14,3,22,39,4,1,0,5,0,0,0,0
Britt BONGAERTS,Netherlands,Setter,Women,Türkiye,2022-06-30,Pool,0,3,0,0,0,1,1,0,0,0,0,0,1,8,9,0,0,0,0,2,1,0,3,4,0,77,81
Laura DIJKEMA,Netherlands,Setter,Women,Türkiye,2022-06-30,Pool,0,3,0,0,0,0,0,0,1,0,1,0,0,0,0,0,0,0,0,4,1,0,5,0,1,12,13
Indy BAIJENS,Netherlands,Middle Blocker,Women,Türkiye,2022-06-30,Pool,0,3,3,2,2,4,8,1,0,0,1,0,2,2,4,0,0,0,0,1,0,0,1,0,0,0,0
Marrit JASPER,Netherlands,Outside Hitter,Women,Türkiye,2022-06-30,Pool,0,3,6,5,3,13,21,1,4,0,5,0,0,10,10,5,0,5,10,2,1,0,3,0,0,0,0
Eline TIMMERMAN,Netherlands,Middle Blocker,Women,Türkiye,2022-06-30,Pool,0,3,8,5,1,4,10,3,5,1,9,0,1,6,7,1,0,1,2,2,0,0,2,0,1,0,1
Florien REESINK,Netherlands,Libero,Women,Türkiye,2022-06-30,Pool,0,3,0,0,0,0,0,0,0,0,0,0,0,0,0,0,0,0,0,0,0,0,0,0,0,0,0
Elles DAMBRINK,Netherlands,Opposite Spiker,Women,Türkiye,2022-06-30,Pool,0,3,0,0,0,4,4,0,0,0,0,0,1,1,2,0,0,0,0,0,0,0,0,0,0,0,0
Fleur SAVELKOEL,Netherlands,Outside Hitter,Women,Japan,2022-06-29,Pool,3,5,20,17,3,20,40,3,2,1,6,0,2,21,23,6,1,9,16,8,3,0,11,0,0,2,2
Celeste PLAK,Netherlands,Opposite Spiker,Women,Japan,2022-06-29,Pool,3,5,16,16,4,19,39,0,0,1,1,0,0,17,17,2,0,0,2,9,1,1,11,0,0,1,1
Jolien KNOLLEMA,Netherlands,Outside Hitter,Women,Japan,2022-06-29,Pool,3,5,0,0,0,0,0,0,0,0,0,0,0,0,0,0,0,0,0,0,0,0,0,0,0,0,0
Juliet LOHUIS,Netherlands,Middle Blocker,Women,Japan,2022-06-29,Pool,3,5,16,9,0,7,16,4,4,4,12,3,2,13,18,1,0,0,1,1,0,0,1,0,0,2,2
Demi KOREVAAR,Netherlands,Middle Blocker,Women,Japan,2022-06-29,Pool,3,5,0,0,0,0,0,0,0,0,0,0,0,0,0,0,0,0,0,0,0,0,0,0,0,0,0
Myrthe SCHOOT,Netherlands,Libero,Women,Japan,2022-06-29,Pool,3,5,0,0,0,0,0,0,0,0,0,0,0,0,0,10,1,6,17,18,3,0,21,0,0,6,6
Anne BUIJS,Netherlands,Outside Hitter,Women,Japan,2022-06-29,Pool,3,5,22,19,4,21,44,3,2,3,8,0,1,16,17,33,2,18,53,10,3,0,13,0,0,1,1
Britt BONGAERTS,Netherlands,Setter,Women,Japan,2022-06-29,Pool,3,5,3,2,0,1,3,1,3,0,4,0,1,9,10,0,0,0,0,1,1,0,2,24,0,114,138
Laura DIJKEMA,Netherlands,Setter,Women,Japan,2022-06-29,Pool,3,5,0,0,0,0,0,0,0,0,0,0,0,6,6,0,0,0,0,0,0,0,0,1,0,12,13
Indy BAIJENS,Netherlands,Middle Blocker,Women,Japan,2022-06-29,Pool,3,5,0,0,0,0,0,0,0,0,0,0,0,0,0,0,0,0,0,0,0,0,0,0,0,0,0
Marrit JASPER,Netherlands,Outside Hitter,Women,Japan,2022-06-29,Pool,3,5,0,0,0,0,0,0,0,0,0,0,0,0,0,1,0,2,3,1,1,0,2,0,0,0,0
Eline TIMMERMAN,Netherlands,Middle Blocker,Women,Japan,2022-06-29,Pool,3,5,16,12,1,7,20,3,4,1,8,1,2,17,20,1,1,1,3,1,1,0,2,0,0,1,1
Florien REESINK,Netherlands,Libero,Women,Japan,2022-06-29,Pool,3,5,0,0,0,0,0,0,0,0,0,0,0,0,0,0,0,0,0,0,0,0,0,0,0,0,0
Elles DAMBRINK,Netherlands,Opposite Spiker,Women,Japan,2022-06-29,Pool,3,5,2,0,0,1,1,2,0,2,4,0,0,0,0,0,0,0,0,0,0,0,0,0,0,1,1
Fleur SAVELKOEL,Netherlands,Outside Hitter,Women,Korea,2022-06-19,Pool,3,3,5,4,1,5,10,1,0,1,2,0,3,7,10,2,1,8,11,7,1,1,9,0,0,1,1
Celeste PLAK,Netherlands,Opposite Spiker,Women,Korea,2022-06-19,Pool,3,3,15,14,2,7,23,1,2,3,6,0,0,12,12,0,0,2,2,5,2,0,7,0,0,0,0
Jolien KNOLLEMA,Netherlands,Outside Hitter,Women,Korea,2022-06-19,Pool,3,3,0,0,0,0,0,0,0,0,0,0,0,0,0,0,0,0,0,0,0,0,0,0,0,0,0
Juliet LOHUIS,Netherlands,Middle Blocker,Women,Korea,2022-06-19,Pool,3,3,10,7,1,5,13,2,1,1,4,1,0,12,13,0,0,0,0,6,0,0,6,0,0,1,1
Myrthe SCHOOT,Netherlands,Libero,Women,Korea,2022-06-19,Pool,3,3,0,0,0,0,0,0,0,0,0,0,0,0,0,9,1,8,18,10,3,0,13,0,0,2,2
Anne BUIJS,Netherlands,Outside Hitter,Women,Korea,2022-06-19,Pool,3,3,15,15,1,10,26,0,1,3,4,0,0,12,12,4,0,2,6,7,2,0,9,0,0,1,1
Britt BONGAERTS,Netherlands,Setter,Women,Korea,2022-06-19,Pool,3,3,1,0,0,0,0,0,1,3,4,1,2,11,14,0,1,0,1,5,0,1,6,23,1,53,77
Laura DIJKEMA,Netherlands,Setter,Women,Korea,2022-06-19,Pool,3,3,0,0,0,0,0,0,0,0,0,0,0,0,0,0,0,0,0,0,0,0,0,0,0,0,0
Indy BAIJENS,Netherlands,Middle Blocker,Women,Korea,2022-06-19,Pool,3,3,0,0,0,0,0,0,0,0,0,0,0,0,0,0,0,0,0,0,0,0,0,0,0,0,0
Marrit JASPER,Netherlands,Outside Hitter,Women,Korea,2022-06-19,Pool,3,3,0,0,0,0,0,0,0,0,0,0,0,1,1,0,0,0,0,0,0,0,0,0,0,0,0
Nika DAALDEROP,Netherlands,Outside Hitter,Women,Korea,2022-06-19,Pool,3,3,0,0,0,0,0,0,0,0,0,0,0,0,0,0,0,0,0,0,0,0,0,0,0,0,0
Eline TIMMERMAN,Netherlands,Middle Blocker,Women,Korea,2022-06-19,Pool,3,3,9,7,0,3,10,2,6,3,11,0,2,9,11,2,0,0,2,1,0,0,1,0,0,2,2
Florien REESINK,Netherlands,Libero,Women,Korea,2022-06-19,Pool,3,3,0,0,0,0,0,0,0,0,0,0,0,0,0,0,0,0,0,0,0,0,0,0,0,0,0
Elles DAMBRINK,Netherlands,Opposite Spiker,Women,Korea,2022-06-19,Pool,3,3,0,0,0,0,0,0,0,0,0,0,0,0,0,0,0,0,0,0,0,0,0,0,0,0,0
Fleur SAVELKOEL,Netherlands,Outside Hitter,Women,Dominican Republic,2022-06-18,Pool,2,5,13,12,5,13,30,1,0,0,1,0,1,5,6,10,0,11,21,3,2,1,6,0,0,2,2
Celeste PLAK,Netherlands,Opposite Spiker,Women,Dominican Republic,2022-06-18,Pool,2,5,10,10,2,8,20,0,1,0,1,0,0,3,3,0,0,0,0,3,1,1,5,0,0,0,0
Jolien KNOLLEMA,Netherlands,Outside Hitter,Women,Dominican Republic,2022-06-18,Pool,2,5,6,6,3,8,17,0,3,1,4,0,0,6,6,1,0,8,9,3,0,0,3,0,0,0,0
Juliet LOHUIS,Netherlands,Middle Blocker,Women,Dominican Republic,2022-06-18,Pool,2,5,5,5,0,10,15,0,5,2,7,0,1,18,19,1,0,0,1,6,0,0,6,0,0,1,1
Myrthe SCHOOT,Netherlands,Libero,Women,Dominican Republic,2022-06-18,Pool,2,5,0,0,0,0,0,0,0,0,0,0,0,0,0,13,2,10,25,11,3,2,16,0,0,7,7
Anne BUIJS,Netherlands,Outside Hitter,Women,Dominican Republic,2022-06-18,Pool,2,5,19,19,5,23,47,0,2,3,5,0,1,13,14,17,0,13,30,8,0,2,10,0,0,0,0
Britt BONGAERTS,Netherlands,Setter,Women,Dominican Republic,2022-06-18,Pool,2,5,1,1,2,2,5,0,2,3,5,0,1,14,15,0,0,0,0,8,3,2,13,44,1,100,145
Laura DIJKEMA,Netherlands,Setter,Women,Dominican Republic,2022-06-18,Pool,2,5,0,0,0,0,0,0,0,0,0,0,0,0,0,0,0,0,0,2,0,0,2,5,0,9,14
Indy BAIJENS,Netherlands,Middle Blocker,Women,Dominican Republic,2022-06-18,Pool,2,5,0,0,0,0,0,0,0,0,0,0,0,0,0,0,0,0,0,0,0,0,0,0,0,0,0
Marrit JASPER,Netherlands,Outside Hitter,Women,Dominican Republic,2022-06-18,Pool,2,5,0,0,0,0,0,0,0,0,0,0,0,2,2,0,1,2,3,0,0,0,0,0,0,0,0
Nika DAALDEROP,Netherlands,Outside Hitter,Women,Dominican Republic,2022-06-18,Pool,2,5,0,0,0,0,0,0,0,0,0,0,0,0,0,0,0,0,0,0,0,0,0,0,0,0,0
Eline TIMMERMAN,Netherlands,Middle Blocker,Women,Dominican Republic,2022-06-18,Pool,2,5,12,6,1,9,16,5,5,6,16,1,0,18,19,3,0,0,3,8,1,1,10,0,0,1,1
Florien REESINK,Netherlands,Libero,Women,Dominican Republic,2022-06-18,Pool,2,5,0,0,0,0,0,0,0,0,0,0,0,0,0,0,0,0,0,0,0,0,0,0,0,0,0
Elles DAMBRINK,Netherlands,Opposite Spiker,Women,Dominican Republic,2022-06-18,Pool,2,5,9,8,2,19,29,0,3,3,6,1,5,9,15,0,0,1,1,6,3,2,11,0,0,1,1
Fleur SAVELKOEL,Netherlands,Outside Hitter,Women,Brazil,2022-06-17,Pool,0,3,0,0,1,2,3,0,1,0,1,0,0,0,0,0,0,0,0,0,0,0,0,0,0,0,0
Celeste PLAK,Netherlands,Opposite Spiker,Women,Brazil,2022-06-17,Pool,0,3,0,0,0,0,0,0,0,0,0,0,0,0,0,0,0,0,0,0,0,0,0,0,0,0,0
Jolien KNOLLEMA,Netherlands,Outside Hitter,Women,Brazil,2022-06-17,Pool,0,3,12,9,3,12,24,2,0,0,2,1,0,3,4,7,1,9,17,4,0,1,5,0,0,0,0
Juliet LOHUIS,Netherlands,Middle Blocker,Women,Brazil,2022-06-17,Pool,0,3,6,3,1,4,8,3,5,3,11,0,2,4,6,0,0,0,0,0,0,0,0,0,0,0,0
Myrthe SCHOOT,Netherlands,Libero,Women,Brazil,2022-06-17,Pool,0,3,0,0,0,0,0,0,0,0,0,0,0,0,0,5,0,3,8,8,2,2,12,0,0,9,9
Anne BUIJS,Netherlands,Outside Hitter,Women,Brazil,2022-06-17,Pool,0,3,7,7,5,23,35,0,1,1,2,0,1,6,7,15,1,17,33,1,7,2,10,0,0,0,0
Britt BONGAERTS,Netherlands,Setter,Women,Brazil,2022-06-17,Pool,0,3,2,1,1,0,2,0,1,1,2,1,0,7,8,0,0,0,0,1,2,1,4,11,1,37,49
Laura DIJKEMA,Netherlands,Setter,Women,Brazil,2022-06-17,Pool,0,3,0,0,0,0,0,0,0,0,0,0,1,6,7,0,0,0,0,2,2,1,5,14,1,30,45
Indy BAIJENS,Netherlands,Middle Blocker,Women,Brazil,2022-06-17,Pool,0,3,0,0,0,0,0,0,0,0,0,0,0,0,0,0,0,0,0,0,0,0,0,0,0,0,0
Marrit JASPER,Netherlands,Outside Hitter,Women,Brazil,2022-06-17,Pool,0,3,0,0,0,0,0,0,0,0,0,0,0,6,6,2,0,4,6,4,0,0,4,0,0,0,0
Nika DAALDEROP,Netherlands,Outside Hitter,Women,Brazil,2022-06-17,Pool,0,3,0,0,0,0,0,0,0,0,0,0,0,0,0,0,0,0,0,0,0,0,0,0,0,0,0
Eline TIMMERMAN,Netherlands,Middle Blocker,Women,Brazil,2022-06-17,Pool,0,3,7,5,1,3,9,1,3,1,5,1,2,8,11,0,0,0,0,1,0,0,1,0,0,1,1
Florien REESINK,Netherlands,Libero,Women,Brazil,2022-06-17,Pool,0,3,0,0,0,0,0,0,0,0,0,0,0,0,0,0,0,1,1,1,2,1,4,0,0,1,1
Elles DAMBRINK,Netherlands,Opposite Spiker,Women,Brazil,2022-06-17,Pool,0,3,2,1,9,9,19,1,3,0,4,0,2,5,7,0,0,1,1,4,0,0,4,0,0,0,0
Fleur SAVELKOEL,Netherlands,Outside Hitter,Women,Germany,2022-06-14,Pool,1,4,13,8,0,8,16,3,0,2,5,2,2,5,9,1,1,9,11,4,0,0,4,0,0,0,0
Celeste PLAK,Netherlands,Opposite Spiker,Women,Germany,2022-06-14,Pool,1,4,0,0,2,1,3,0,0,0,0,0,0,1,1,1,0,0,1,2,0,0,2,0,0,0,0
Jolien KNOLLEMA,Netherlands,Outside Hitter,Women,Germany,2022-06-14,Pool,1,4,0,0,0,0,0,0,0,0,0,0,0,0,0,0,0,0,0,0,0,0,0,0,0,0,0
Juliet LOHUIS,Netherlands,Middle Blocker,Women,Germany,2022-06-14,Pool,1,4,8,3,1,5,9,4,6,3,13,1,2,9,12,0,0,0,0,2,0,0,2,0,0,0,0
Myrthe SCHOOT,Netherlands,Libero,Women,Germany,2022-06-14,Pool,1,4,0,0,0,0,0,0,0,0,0,0,0,0,0,7,0,9,16,8,6,1,15,0,0,0,0
Anne BUIJS,Netherlands,Outside Hitter,Women,Germany,2022-06-14,Pool,1,4,19,18,3,17,38,1,3,2,6,0,0,14,14,12,0,16,28,6,5,1,12,0,0,0,0
Britt BONGAERTS,Netherlands,Setter,Women,Germany,2022-06-14,Pool,1,4,0,0,0,1,1,0,3,3,6,0,0,12,12,0,0,0,0,4,5,0,9,27,0,82,109
Laura DIJKEMA,Netherlands,Setter,Women,Germany,2022-06-14,Pool,1,4,0,0,0,0,0,0,0,0,0,0,0,1,1,0,0,0,0,0,0,0,0,1,0,7,8
Indy BAIJENS,Netherlands,Middle Blocker,Women,Germany,2022-06-14,Pool,1,4,0,0,0,0,0,0,0,0,0,0,0,0,0,0,0,0,0,0,0,0,0,0,0,0,0
Marrit JASPER,Netherlands,Outside Hitter,Women,Germany,2022-06-14,Pool,1,4,2,1,3,5,9,0,0,1,1,1,1,6,8,5,0,10,15,1,2,1,4,0,0,0,0
Nika DAALDEROP,Netherlands,Outside Hitter,Women,Germany,2022-06-14,Pool,1,4,0,0,0,0,0,0,0,0,0,0,0,0,0,0,0,0,0,0,0,0,0,0,0,0,0
Eline TIMMERMAN,Netherlands,Middle Blocker,Women,Germany,2022-06-14,Pool,1,4,7,6,1,6,13,1,10,6,17,0,2,13,15,0,0,1,1,2,1,0,3,0,0,0,0
Florien REESINK,Netherlands,Libero,Women,Germany,2022-06-14,Pool,1,4,1,1,0,0,1,0,0,0,0,0,0,0,0,0,0,0,0,0,0,0,0,0,0,0,0
Elles DAMBRINK,Netherlands,Opposite Spiker,Women,Germany,2022-06-14,Pool,1,4,15,14,3,19,36,0,1,1,2,1,3,11,15,0,0,0,0,1,2,1,4,0,0,0,0
Fleur SAVELKOEL,Netherlands,Outside Hitter,Women,Serbia,2022-06-05,Pool,2,5,5,5,4,8,17,0,1,1,2,0,0,9,9,6,3,20,29,2,2,4,8,0,0,3,3
Celeste PLAK,Netherlands,Opposite Spiker,Women,Serbia,2022-06-05,Pool,2,5,19,17,2,17,36,2,3,0,5,0,3,9,12,3,1,24,28,8,0,1,9,0,0,0,0
Jolien KNOLLEMA,Netherlands,Outside Hitter,Women,Serbia,2022-06-05,Pool,2,5,0,0,2,0,2,0,0,0,0,0,0,0,0,0,0,0,0,0,0,0,0,0,0,0,0
Juliet LOHUIS,Netherlands,Middle Blocker,Women,Serbia,2022-06-05,Pool,2,5,11,8,0,5,13,3,10,15,28,0,0,12,12,0,0,3,3,2,1,2,5,1,0,1,2
Myrthe SCHOOT,Netherlands,Libero,Women,Serbia,2022-06-05,Pool,2,5,0,0,0,0,0,0,0,0,0,0,0,0,0,0,0,15,15,20,3,5,28,1,0,10,11
Sarah VAN AALEN,Netherlands,Setter,Women,Serbia,2022-06-05,Pool,2,5,0,0,0,0,0,0,0,0,0,0,0,0,0,0,0,0,0,0,0,0,0,0,0,0,0
Britt BONGAERTS,Netherlands,Setter,Women,Serbia,2022-06-05,Pool,2,5,3,0,0,4,4,1,1,6,8,2,0,15,17,0,1,0,1,9,5,4,18,64,1,71,136
Indy BAIJENS,Netherlands,Middle Blocker,Women,Serbia,2022-06-05,Pool,2,5,1,1,0,0,1,0,0,0,0,0,0,0,0,0,0,0,0,0,0,0,0,0,0,0,0
Iris VOS,Netherlands,Outside Hitter,Women,Serbia,2022-06-05,Pool,2,5,0,0,0,0,0,0,0,0,0,0,0,0,0,0,0,0,0,0,0,0,0,0,0,0,0
Marrit JASPER,Netherlands,Outside Hitter,Women,Serbia,2022-06-05,Pool,2,5,7,6,7,17,30,1,2,2,5,0,1,19,20,7,0,12,19,11,4,3,18,0,0,3,3
Eline TIMMERMAN,Netherlands,Middle Blocker,Women,Serbia,2022-06-05,Pool,2,5,18,11,3,8,22,5,12,17,34,2,1,14,17,0,0,1,1,4,1,1,6,0,0,3,3
Laura DE ZWART,Netherlands,Middle Blocker,Women,Serbia,2022-06-05,Pool,2,5,0,0,0,0,0,0,0,0,0,0,0,0,0,0,0,0,0,0,0,0,0,0,0,0,0
Florien REESINK,Netherlands,Libero,Women,Serbia,2022-06-05,Pool,2,5,0,0,0,0,0,0,0,0,0,0,0,0,0,0,0,0,0,0,0,0,0,0,0,0,0
Elles DAMBRINK,Netherlands,Opposite Spiker,Women,Serbia,2022-06-05,Pool,2,5,19,17,6,13,36,1,5,3,9,1,3,13,17,0,0,0,0,14,2,2,18,2,0,1,3
Fleur SAVELKOEL,Netherlands,Outside Hitter,Women,Italy,2022-06-03,Pool,0,3,4,3,5,10,18,1,0,1,2,0,0,4,4,1,0,10,11,1,1,0,2,0,0,0,0
Celeste PLAK,Netherlands,Opposite Spiker,Women,Italy,2022-06-03,Pool,0,3,5,4,2,3,9,0,0,0,0,1,0,4,5,0,0,0,0,1,0,1,2,0,0,0,0
Jolien KNOLLEMA,Netherlands,Outside Hitter,Women,Italy,2022-06-03,Pool,0,3,4,3,3,6,12,1,2,1,4,0,0,4,4,2,1,20,23,3,5,1,9,0,0,0,0
Juliet LOHUIS,Netherlands,Middle Blocker,Women,Italy,2022-06-03,Pool,0,3,4,3,1,7,11,0,6,3,9,1,1,5,7,0,0,0,0,0,1,0,1,1,0,0,1
Myrthe SCHOOT,Netherlands,Libero,Women,Italy,2022-06-03,Pool,0,3,0,0,0,0,0,0,0,0,0,0,0,0,0,5,1,14,20,10,7,3,20,1,0,3,4
Sarah VAN AALEN,Netherlands,Setter,Women,Italy,2022-06-03,Pool,0,3,0,0,0,0,0,0,0,0,0,0,0,0,0,0,0,0,0,1,0,0,1,0,0,9,9
Britt BONGAERTS,Netherlands,Setter,Women,Italy,2022-06-03,Pool,0,3,1,0,0,2,2,1,4,5,10,0,0,5,5,0,0,0,0,4,2,3,9,22,0,45,67
Indy BAIJENS,Netherlands,Middle Blocker,Women,Italy,2022-06-03,Pool,0,3,0,0,0,0,0,0,0,0,0,0,0,0,0,0,0,0,0,0,0,0,0,0,0,0,0
Iris VOS,Netherlands,Outside Hitter,Women,Italy,2022-06-03,Pool,0,3,0,0,0,0,0,0,0,0,0,0,0,0,0,0,0,0,0,0,0,0,0,0,0,0,0
Marrit JASPER,Netherlands,Outside Hitter,Women,Italy,2022-06-03,Pool,0,3,2,2,2,4,8,0,0,0,0,0,1,7,8,3,1,6,10,3,0,0,3,0,0,0,0
Eline TIMMERMAN,Netherlands,Middle Blocker,Women,Italy,2022-06-03,Pool,0,3,2,2,1,4,7,0,3,0,3,0,2,7,9,1,0,0,1,1,0,1,2,0,0,1,1
Laura DE ZWART,Netherlands,Middle Blocker,Women,Italy,2022-06-03,Pool,0,3,0,0,0,0,0,0,0,0,0,0,0,0,0,0,0,0,0,0,0,0,0,0,0,0,0
Florien REESINK,Netherlands,Libero,Women,Italy,2022-06-03,Pool,0,3,0,0,0,0,0,0,0,0,0,0,0,0,0,0,0,0,0,0,0,0,0,0,0,0,0
Elles DAMBRINK,Netherlands,Opposite Spiker,Women,Italy,2022-06-03,Pool,0,3,11,11,4,5,20,0,0,1,1,0,0,9,9,0,0,0,0,4,3,2,9,0,0,1,1
Fleur SAVELKOEL,Netherlands,Outside Hitter,Women,Bulgaria,2022-06-02,Pool,2,5,14,10,4,22,36,3,3,1,7,1,0,8,9,15,2,29,46,10,5,7,22,0,0,0,0
Celeste PLAK,Netherlands,Opposite Spiker,Women,Bulgaria,2022-06-02,Pool,2,5,3,3,3,6,12,0,2,0,2,0,0,3,3,0,0,1,1,1,0,0,1,0,0,0,0
Jolien KNOLLEMA,Netherlands,Outside Hitter,Women,Bulgaria,2022-06-02,Pool,2,5,3,3,0,3,6,0,0,1,1,0,0,1,1,1,2,1,4,0,2,0,2,0,0,0,0
Juliet LOHUIS,Netherlands,Middle Blocker,Women,Bulgaria,2022-06-02,Pool,2,5,8,5,1,6,12,3,3,10,16,0,0,13,13,0,0,0,0,3,2,1,6,0,0,6,6
Myrthe SCHOOT,Netherlands,Libero,Women,Bulgaria,2022-06-02,Pool,2,5,0,0,0,0,0,0,0,0,0,0,0,0,0,5,0,12,17,14,5,7,26,0,0,13,13
Sarah VAN AALEN,Netherlands,Setter,Women,Bulgaria,2022-06-02,Pool,2,5,0,0,0,0,0,0,0,2,2,0,0,2,2,0,0,0,0,4,1,1,6,3,0,13,16
Britt BONGAERTS,Netherlands,Setter,Women,Bulgaria,2022-06-02,Pool,2,5,1,1,0,2,3,0,4,9,13,0,1,19,20,0,0,0,0,6,6,7,19,17,1,81,99
Indy BAIJENS,Netherlands,Middle Blocker,Women,Bulgaria,2022-06-02,Pool,2,5,0,0,0,0,0,0,0,0,0,0,0,0,0,0,0,0,0,0,0,0,0,0,0,0,0
Iris VOS,Netherlands,Outside Hitter,Women,Bulgaria,2022-06-02,Pool,2,5,0,0,0,0,0,0,0,0,0,0,0,0,0,0,0,0,0,0,0,0,0,0,0,0,0
Marrit JASPER,Netherlands,Outside Hitter,Women,Bulgaria,2022-06-02,Pool,2,5,10,10,5,12,27,0,1,0,1,0,0,12,12,4,2,12,18,15,9,3,27,0,0,5,5
Eline TIMMERMAN,Netherlands,Middle Blocker,Women,Bulgaria,2022-06-02,Pool,2,5,12,8,0,4,12,3,9,7,19,1,0,11,12,0,0,0,0,3,4,1,8,0,0,2,2
Laura DE ZWART,Netherlands,Middle Blocker,Women,Bulgaria,2022-06-02,Pool,2,5,0,0,0,0,0,0,0,0,0,0,0,0,0,0,0,0,0,0,0,0,0,0,0,0,0
Florien REESINK,Netherlands,Libero,Women,Bulgaria,2022-06-02,Pool,2,5,0,0,0,1,1,0,0,0,0,0,0,0,0,0,0,0,0,1,0,1,2,0,0,0,0
Elles DAMBRINK,Netherlands,Opposite Spiker,Women,Bulgaria,2022-06-02,Pool,2,5,14,13,5,16,34,1,1,4,6,0,4,10,14,0,0,0,0,7,3,3,13,0,0,2,2
Fleur SAVELKOEL,Netherlands,Outside Hitter,Women,China,2022-06-01,Pool,1,4,14,14,7,13,34,0,1,3,4,0,0,17,17,15,1,36,52,7,5,3,15,0,0,1,1
Celeste PLAK,Netherlands,Opposite Spiker,Women,China,2022-06-01,Pool,1,4,24,22,5,17,44,2,1,7,10,0,1,8,9,0,0,0,0,3,6,4,13,0,2,2,4
Jolien KNOLLEMA,Netherlands,Outside Hitter,Women,China,2022-06-01,Pool,1,4,0,0,0,1,1,0,0,0,0,0,0,0,0,0,0,1,1,0,0,0,0,0,0,0,0
Juliet LOHUIS,Netherlands,Middle Blocker,Women,China,2022-06-01,Pool,1,4,12,9,1,3,13,3,2,5,10,0,0,12,12,1,0,1,2,0,0,0,0,0,0,2,2
Myrthe SCHOOT,Netherlands,Libero,Women,China,2022-06-01,Pool,1,4,0,0,0,0,0,0,0,0,0,0,0,0,0,3,1,8,12,9,15,14,38,0,0,5,5
Sarah VAN AALEN,Netherlands,Setter,Women,China,2022-06-01,Pool,1,4,0,0,0,0,0,0,0,0,0,0,0,1,1,0,0,0,0,1,0,0,1,0,0,8,8
Britt BONGAERTS,Netherlands,Setter,Women,China,2022-06-01,Pool,1,4,3,2,1,3,6,1,3,6,10,0,1,12,13,0,0,0,0,5,3,3,11,15,0,96,111
Indy BAIJENS,Netherlands,Middle Blocker,Women,China,2022-06-01,Pool,1,4,0,0,0,0,0,0,0,0,0,0,0,0,0,0,0,0,0,0,0,0,0,0,0,0,0
Iris VOS,Netherlands,Outside Hitter,Women,China,2022-06-01,Pool,1,4,0,0,0,0,0,0,0,0,0,0,0,0,0,0,0,0,0,0,0,0,0,0,0,0,0
Marrit JASPER,Netherlands,Outside Hitter,Women,China,2022-06-01,Pool,1,4,12,11,1,9,21,0,2,5,7,1,0,19,20,4,1,14,19,11,5,9,25,0,0,2,2
Eline TIMMERMAN,Netherlands,Middle Blocker,Women,China,2022-06-01,Pool,1,4,9,6,1,6,13,3,9,6,18,0,0,19,19,0,0,0,0,4,5,4,13,0,0,1,1
Laura DE ZWART,Netherlands,Middle Blocker,Women,China,2022-06-01,Pool,1,4,0,0,0,0,0,0,0,0,0,0,0,0,0,0,0,0,0,0,0,0,0,0,0,0,0
Florien REESINK,Netherlands,Libero,Women,China,2022-06-01,Pool,1,4,0,0,0,1,1,0,0,0,0,0,0,0,0,0,0,0,0,0,0,0,0,0,0,0,0
Elles DAMBRINK,Netherlands,Opposite Spiker,Women,China,2022-06-01,Pool,1,4,5,5,0,3,8,0,0,0,0,0,0,2,2,0,0,0,0,0,1,1,2,0,0,0,0
Maria STENZEL,Poland,Libero,Women,Bulgaria,2022-07-03,Pool,1,4,0,0,0,0,0,0,0,0,0,0,0,0,0,8,0,16,24,6,2,2,10,0,1,2,3
Anna STENCEL,Poland,Middle Blocker,Women,Bulgaria,2022-07-03,Pool,1,4,0,0,1,0,1,0,0,0,0,0,0,0,0,0,0,0,0,0,0,0,0,0,0,0,0
Agnieszka KAKOLEWSKA,Poland,Middle Blocker,Women,Bulgaria,2022-07-03,Pool,1,4,7,3,0,3,6,4,4,2,10,0,2,7,9,0,0,0,0,1,1,0,2,0,0,0,0
Zuzanna GORECKA,Poland,Outside Hitter,Women,Bulgaria,2022-07-03,Pool,1,4,2,2,2,2,6,0,0,1,1,0,1,5,6,4,1,10,15,1,2,1,4,0,0,0,0
Monika FEDUSIO,Poland,Outside Hitter,Women,Bulgaria,2022-07-03,Pool,1,4,9,9,3,8,20,0,2,4,6,0,2,10,12,5,0,23,28,6,0,1,7,0,0,1,1
Martyna LUKASIK,Poland,Outside Hitter,Women,Bulgaria,2022-07-03,Pool,1,4,0,0,0,0,0,0,0,0,0,0,0,0,0,0,0,0,0,0,0,0,0,0,0,0,0
Aleksandra SZCZYGLOWSKA,Poland,Libero,Women,Bulgaria,2022-07-03,Pool,1,4,0,0,0,0,0,0,0,0,0,0,0,0,0,0,0,1,1,1,0,1,2,0,0,2,2
Joanna WOLOSZ,Poland,Setter,Women,Bulgaria,2022-07-03,Pool,1,4,0,0,0,0,0,0,0,0,0,0,0,5,5,0,0,0,0,2,2,0,4,2,0,19,21
Martyna CZYRNIANSKA,Poland,Outside Hitter,Women,Bulgaria,2022-07-03,Pool,1,4,7,5,4,9,18,2,0,0,2,0,0,8,8,0,0,6,6,5,1,0,6,0,0,1,1
Aleksandra GRYKA,Poland,Middle Blocker,Women,Bulgaria,2022-07-03,Pool,1,4,10,9,5,3,17,0,6,2,8,1,2,11,14,0,0,1,1,0,2,0,2,0,0,0,0
Alicja GRABKA,Poland,Setter,Women,Bulgaria,2022-07-03,Pool,1,4,3,0,0,1,1,2,1,4,7,1,1,8,10,0,0,0,0,4,2,3,9,7,0,93,100
Weronika SZLAGOWSKA,Poland,Outside Hitter,Women,Bulgaria,2022-07-03,Pool,1,4,1,1,3,1,5,0,2,0,2,0,0,2,2,0,0,3,3,1,0,0,1,0,0,0,0
Olivia ROZANSKI,Poland,Outside Hitter,Women,Bulgaria,2022-07-03,Pool,1,4,19,19,7,20,46,0,3,1,4,0,2,5,7,2,0,5,7,5,1,0,6,1,0,3,4
Magdalena JURCZYK,Poland,Middle Blocker,Women,Bulgaria,2022-07-03,Pool,1,4,0,0,0,0,0,0,2,1,3,0,0,5,5,0,1,0,1,0,0,0,0,0,0,0,0
Maria STENZEL,Poland,Libero,Women,Dominican Republic,2022-07-02,Pool,2,5,0,0,0,0,0,0,0,0,0,0,0,0,0,18,2,29,49,16,4,4,24,0,0,4,4
Anna STENCEL,Poland,Middle Blocker,Women,Dominican Republic,2022-07-02,Pool,2,5,8,5,1,6,12,2,8,2,12,1,3,18,22,0,0,0,0,3,0,0,3,0,0,0,0
Agnieszka KAKOLEWSKA,Poland,Middle Blocker,Women,Dominican Republic,2022-07-02,Pool,2,5,17,7,3,8,18,8,7,6,21,2,1,15,18,1,0,1,2,3,1,2,6,0,1,1,2
Zuzanna GORECKA,Poland,Outside Hitter,Women,Dominican Republic,2022-07-02,Pool,2,5,1,0,0,1,1,1,0,0,1,0,0,2,2,0,0,2,2,1,2,0,3,0,0,0,0
Monika FEDUSIO,Poland,Outside Hitter,Women,Dominican Republic,2022-07-02,Pool,2,5,1,1,0,0,1,0,0,0,0,0,0,2,2,0,0,0,0,1,0,0,1,0,0,0,0
Martyna LUKASIK,Poland,Outside Hitter,Women,Dominican Republic,2022-07-02,Pool,2,5,0,0,0,0,0,0,0,0,0,0,0,0,0,0,0,0,0,0,0,0,0,0,0,0,0
Aleksandra SZCZYGLOWSKA,Poland,Libero,Women,Dominican Republic,2022-07-02,Pool,2,5,0,0,0,0,0,0,0,0,0,0,0,0,0,0,0,2,2,1,0,0,1,0,0,0,0
Joanna WOLOSZ,Poland,Setter,Women,Dominican Republic,2022-07-02,Pool,2,5,2,0,0,0,0,0,3,3,6,2,0,18,20,0,0,0,0,11,2,1,14,24,0,121,145
Martyna CZYRNIANSKA,Poland,Outside Hitter,Women,Dominican Republic,2022-07-02,Pool,2,5,27,22,8,29,59,2,2,2,6,3,2,27,32,1,1,2,4,6,2,4,12,0,0,2,2
Aleksandra GRYKA,Poland,Middle Blocker,Women,Dominican Republic,2022-07-02,Pool,2,5,0,0,0,0,0,0,0,0,0,0,0,0,0,0,0,0,0,0,0,0,0,0,0,0,0
Alicja GRABKA,Poland,Setter,Women,Dominican Republic,2022-07-02,Pool,2,5,0,0,0,0,0,0,0,0,0,0,1,1,2,0,0,0,0,0,0,0,0,1,0,4,5
Weronika SZLAGOWSKA,Poland,Outside Hitter,Women,Dominican Republic,2022-07-02,Pool,2,5,12,10,4,7,21,2,3,0,5,0,1,8,9,12,1,24,37,6,4,3,13,0,0,0,0
Olivia ROZANSKI,Poland,Outside Hitter,Women,Dominican Republic,2022-07-02,Pool,2,5,21,19,8,24,51,2,9,5,16,0,5,3,8,1,0,2,3,11,2,1,14,0,0,0,0
Magdalena JURCZYK,Poland,Middle Blocker,Women,Dominican Republic,2022-07-02,Pool,2,5,0,0,0,0,0,0,0,0,0,0,0,0,0,0,0,0,0,0,0,0,0,0,0,0,0
Maria STENZEL,Poland,Libero,Women,China,2022-06-30,Pool,0,3,0,0,0,0,0,0,0,0,0,0,0,0,0,9,2,16,27,8,1,4,13,0,0,7,7
Anna STENCEL,Poland,Middle Blocker,Women,China,2022-06-30,Pool,0,3,0,0,3,0,3,0,0,1,1,0,0,0,0,0,0,0,0,0,0,0,0,0,0,0,0
Agnieszka KAKOLEWSKA,Poland,Middle Blocker,Women,China,2022-06-30,Pool,0,3,2,1,3,0,4,1,0,0,1,0,1,4,5,0,0,0,0,0,0,0,0,0,0,2,2
Zuzanna GORECKA,Poland,Outside Hitter,Women,China,2022-06-30,Pool,0,3,4,4,3,6,13,0,0,0,0,0,1,6,7,1,0,13,14,2,1,2,5,0,0,0,0
Monika FEDUSIO,Poland,Outside Hitter,Women,China,2022-06-30,Pool,0,3,1,1,0,1,2,0,0,0,0,0,0,1,1,0,0,1,1,0,0,0,0,0,0,0,0
Martyna LUKASIK,Poland,Outside Hitter,Women,China,2022-06-30,Pool,0,3,0,0,0,0,0,0,0,0,0,0,0,0,0,0,0,0,0,0,0,0,0,0,0,0,0
Aleksandra SZCZYGLOWSKA,Poland,Libero,Women,China,2022-06-30,Pool,0,3,0,0,0,0,0,0,0,0,0,0,0,0,0,0,0,0,0,0,0,0,0,0,0,0,0
Joanna WOLOSZ,Poland,Setter,Women,China,2022-06-30,Pool,0,3,0,0,0,0,0,0,5,0,5,0,0,7,7,0,0,0,0,3,2,5,10,0,2,70,72
Martyna CZYRNIANSKA,Poland,Outside Hitter,Women,China,2022-06-30,Pool,0,3,9,9,6,20,35,0,1,0,1,0,3,4,7,0,0,4,4,7,2,3,12,0,0,0,0
Aleksandra GRYKA,Poland,Middle Blocker,Women,China,2022-06-30,Pool,0,3,1,0,1,0,1,0,0,1,1,1,2,3,6,0,0,0,0,0,0,0,0,0,0,0,0
Alicja GRABKA,Poland,Setter,Women,China,2022-06-30,Pool,0,3,0,0,0,0,0,0,1,0,1,0,0,0,0,0,0,0,0,0,0,0,0,0,0,5,5
Weronika SZLAGOWSKA,Poland,Outside Hitter,Women,China,2022-06-30,Pool,0,3,2,2,2,3,7,0,1,0,1,0,1,2,3,2,1,4,7,1,0,0,1,0,0,0,0
Olivia ROZANSKI,Poland,Outside Hitter,Women,China,2022-06-30,Pool,0,3,9,8,2,12,22,1,3,1,5,0,2,5,7,2,0,10,12,4,2,2,8,0,0,3,3
Magdalena JURCZYK,Poland,Middle Blocker,Women,China,2022-06-30,Pool,0,3,7,5,0,0,5,2,1,0,3,0,1,9,10,0,0,0,0,1,1,0,2,0,0,0,0
Maria STENZEL,Poland,Libero,Women,Italy,2022-06-29,Pool,1,4,0,0,0,0,0,0,0,0,0,0,0,0,0,5,0,20,25,17,3,1,21,7,0,0,7
Anna STENCEL,Poland,Middle Blocker,Women,Italy,2022-06-29,Pool,1,4,6,5,5,4,14,0,7,2,9,1,2,16,19,0,0,0,0,1,1,1,3,0,0,0,0
Agnieszka KAKOLEWSKA,Poland,Middle Blocker,Women,Italy,2022-06-29,Pool,1,4,7,4,2,6,12,2,7,7,16,1,0,10,11,0,2,1,3,1,0,2,3,0,0,0,0
Zuzanna GORECKA,Poland,Outside Hitter,Women,Italy,2022-06-29,Pool,1,4,1,1,0,0,1,0,0,0,0,0,0,3,3,0,1,0,1,2,1,0,3,1,0,0,1
Monika FEDUSIO,Poland,Outside Hitter,Women,Italy,2022-06-29,Pool,1,4,1,1,0,2,3,0,0,1,1,0,0,1,1,0,0,5,5,0,0,1,1,1,0,0,1
Martyna LUKASIK,Poland,Outside Hitter,Women,Italy,2022-06-29,Pool,1,4,0,0,0,0,0,0,0,0,0,0,0,0,0,0,0,0,0,0,0,0,0,0,0,0,0
Aleksandra SZCZYGLOWSKA,Poland,Libero,Women,Italy,2022-06-29,Pool,1,4,0,0,0,0,0,0,0,0,0,0,0,0,0,0,0,0,0,0,0,0,0,0,0,0,0
Joanna WOLOSZ,Poland,Setter,Women,Italy,2022-06-29,Pool,1,4,4,1,0,2,3,2,3,2,7,1,0,15,16,0,0,0,0,5,2,2,9,109,1,2,112
Martyna CZYRNIANSKA,Poland,Outside Hitter,Women,Italy,2022-06-29,Pool,1,4,12,10,8,16,34,2,4,0,6,0,2,9,11,2,0,7,9,7,2,1,10,3,0,0,3
Aleksandra GRYKA,Poland,Middle Blocker,Women,Italy,2022-06-29,Pool,1,4,1,1,0,0,1,0,0,0,0,0,0,0,0,0,0,0,0,0,0,0,0,0,0,0,0
Alicja GRABKA,Poland,Setter,Women,Italy,2022-06-29,Pool,1,4,0,0,0,0,0,0,0,0,0,0,0,0,0,0,0,0,0,0,0,0,0,0,0,0,0
Weronika SZLAGOWSKA,Poland,Outside Hitter,Women,Italy,2022-06-29,Pool,1,4,8,6,4,16,26,1,4,0,5,1,2,14,17,2,0,29,31,1,1,1,3,2,0,1,3
Olivia ROZANSKI,Poland,Outside Hitter,Women,Italy,2022-06-29,Pool,1,4,19,17,6,21,44,2,1,1,4,0,5,8,13,2,1,7,10,11,1,2,14,2,0,0,2
Magdalena JURCZYK,Poland,Middle Blocker,Women,Italy,2022-06-29,Pool,1,4,0,0,0,0,0,0,0,0,0,0,0,1,1,0,0,0,0,1,0,0,1,0,0,0,0
Maria STENZEL,Poland,Libero,Women,Belgium,2022-06-18,Pool,2,5,0,0,0,0,0,0,0,0,0,0,0,0,0,6,1,21,28,27,4,2,33,0,0,12,12
Klaudia ALAGIERSKA,Poland,Middle Blocker,Women,Belgium,2022-06-18,Pool,2,5,7,4,3,4,11,3,4,3,10,0,2,14,16,0,0,0,0,6,2,0,8,0,0,1,1
Kamila WITKOWSKA,Poland,Middle Blocker,Women,Belgium,2022-06-18,Pool,2,5,11,7,0,5,12,3,5,3,11,1,1,12,14,0,0,0,0,2,1,1,4,0,0,3,3
Zuzanna GORECKA,Poland,Outside Hitter,Women,Belgium,2022-06-18,Pool,2,5,0,0,0,0,0,0,0,0,0,0,0,0,0,0,0,0,0,0,0,0,0,0,0,0,0
Monika FEDUSIO,Poland,Outside Hitter,Women,Belgium,2022-06-18,Pool,2,5,0,0,0,0,0,0,0,0,0,0,0,0,0,0,0,0,0,0,0,0,0,0,0,0,0
Martyna LUKASIK,Poland,Outside Hitter,Women,Belgium,2022-06-18,Pool,2,5,25,22,9,17,48,1,2,2,5,2,2,16,20,8,2,12,22,16,2,0,18,1,0,2,3
Aleksandra SZCZYGLOWSKA,Poland,Libero,Women,Belgium,2022-06-18,Pool,2,5,0,0,0,0,0,0,0,0,0,0,0,0,0,0,0,0,0,0,0,0,0,0,0,0,0
Joanna WOLOSZ,Poland,Setter,Women,Belgium,2022-06-18,Pool,2,5,0,0,0,2,2,0,4,8,12,0,1,20,21,0,0,0,0,10,5,1,16,37,2,97,136
Martyna CZYRNIANSKA,Poland,Outside Hitter,Women,Belgium,2022-06-18,Pool,2,5,21,18,2,13,33,0,0,2,2,3,4,9,16,1,0,0,1,4,4,0,8,0,0,0,0
Aleksandra GRYKA,Poland,Middle Blocker,Women,Belgium,2022-06-18,Pool,2,5,0,0,0,0,0,0,0,0,0,0,0,0,0,0,0,0,0,0,0,0,0,0,0,0,0
Weronika SZLAGOWSKA,Poland,Outside Hitter,Women,Belgium,2022-06-18,Pool,2,5,11,9,6,10,25,2,7,7,16,0,3,7,10,11,0,23,34,8,5,0,13,0,0,3,3
Katarzyna WENERSKA,Poland,Setter,Women,Belgium,2022-06-18,Pool,2,5,0,0,0,0,0,0,0,0,0,0,0,0,0,0,0,0,0,0,0,0,0,0,0,0,0
Olivia ROZANSKI,Poland,Outside Hitter,Women,Belgium,2022-06-18,Pool,2,5,13,10,2,20,32,3,1,5,9,0,1,4,5,1,1,7,9,6,1,1,8,0,1,1,2
Magdalena JURCZYK,Poland,Middle Blocker,Women,Belgium,2022-06-18,Pool,2,5,1,1,0,0,1,0,1,1,2,0,0,3,3,0,1,0,1,1,0,0,1,0,0,1,1
Maria STENZEL,Poland,Libero,Women,United States,2022-06-17,Pool,0,3,0,0,0,0,0,0,0,0,0,0,0,0,0,9,0,16,25,9,1,0,10,0,0,10,10
Klaudia ALAGIERSKA,Poland,Middle Blocker,Women,United States,2022-06-17,Pool,0,3,2,1,0,0,1,1,2,1,4,0,0,2,2,0,0,0,0,1,1,0,2,0,0,1,1
Kamila WITKOWSKA,Poland,Middle Blocker,Women,United States,2022-06-17,Pool,0,3,1,1,0,0,1,0,0,0,0,0,0,1,1,0,0,0,0,0,0,0,0,0,0,0,0
Zuzanna GORECKA,Poland,Outside Hitter,Women,United States,2022-06-17,Pool,0,3,6,6,3,14,23,0,6,2,8,0,2,10,12,3,0,3,6,3,1,0,4,0,0,1,1
Monika FEDUSIO,Poland,Outside Hitter,Women,United States,2022-06-17,Pool,0,3,0,0,0,0,0,0,0,0,0,0,0,0,0,0,0,0,0,0,0,0,0,0,0,0,0
Martyna LUKASIK,Poland,Outside Hitter,Women,United States,2022-06-17,Pool,0,3,8,8,2,10,20,0,2,0,2,0,0,6,6,5,0,27,32,4,5,1,10,0,0,0,0
Aleksandra SZCZYGLOWSKA,Poland,Libero,Women,United States,2022-06-17,Pool,0,3,0,0,0,0,0,0,0,0,0,0,0,0,0,0,0,0,0,0,0,0,0,0,0,0,0
Joanna WOLOSZ,Poland,Setter,Women,United States,2022-06-17,Pool,0,3,0,0,0,0,0,0,0,0,0,0,0,0,0,0,0,0,0,1,1,0,2,1,0,2,3
Martyna CZYRNIANSKA,Poland,Outside Hitter,Women,United States,2022-06-17,Pool,0,3,12,10,8,12,30,1,0,2,3,1,2,5,8,0,0,0,0,4,1,0,5,0,1,0,1
Aleksandra GRYKA,Poland,Middle Blocker,Women,United States,2022-06-17,Pool,0,3,2,2,1,7,10,0,1,2,3,0,0,4,4,0,0,0,0,2,0,0,2,0,0,3,3
Weronika SZLAGOWSKA,Poland,Outside Hitter,Women,United States,2022-06-17,Pool,0,3,0,0,0,0,0,0,0,0,0,0,0,0,0,2,1,2,5,0,1,0,1,0,0,0,0
Katarzyna WENERSKA,Poland,Setter,Women,United States,2022-06-17,Pool,0,3,0,0,0,1,1,0,2,1,3,0,2,9,11,0,0,1,1,7,3,1,11,3,0,75,78
Olivia ROZANSKI,Poland,Outside Hitter,Women,United States,2022-06-17,Pool,0,3,5,5,1,2,8,0,0,2,2,0,0,1,1,0,0,0,0,1,0,0,1,0,0,0,0
Magdalena JURCZYK,Poland,Middle Blocker,Women,United States,2022-06-17,Pool,0,3,3,2,0,3,5,1,4,2,7,0,1,5,6,0,0,1,1,1,0,0,1,0,0,2,2
Maria STENZEL,Poland,Libero,Women,Thailand,2022-06-16,Pool,3,5,0,0,0,0,0,0,0,0,0,0,0,0,0,10,3,16,29,27,2,2,31,1,0,16,17
Klaudia ALAGIERSKA,Poland,Middle Blocker,Women,Thailand,2022-06-16,Pool,3,5,13,11,2,7,20,2,4,5,11,0,2,8,10,0,0,0,0,1,0,3,4,1,0,2,3
Kamila WITKOWSKA,Poland,Middle Blocker,Women,Thailand,2022-06-16,Pool,3,5,15,13,3,5,21,2,3,3,8,0,1,22,23,0,0,0,0,4,2,0,6,0,0,0,0
Zuzanna GORECKA,Poland,Outside Hitter,Women,Thailand,2022-06-16,Pool,3,5,2,1,0,1,2,0,0,1,1,1,0,4,5,2,2,8,12,3,1,0,4,0,0,3,3
Monika FEDUSIO,Poland,Outside Hitter,Women,Thailand,2022-06-16,Pool,3,5,0,0,0,0,0,0,0,0,0,0,0,0,0,0,0,0,0,0,0,0,0,0,0,0,0
Martyna LUKASIK,Poland,Outside Hitter,Women,Thailand,2022-06-16,Pool,3,5,0,0,1,1,2,0,1,2,3,0,0,0,0,0,0,0,0,0,0,0,0,0,0,0,0
Aleksandra SZCZYGLOWSKA,Poland,Libero,Women,Thailand,2022-06-16,Pool,3,5,0,0,0,0,0,0,0,0,0,0,0,0,0,0,0,0,0,0,0,0,0,0,0,0,0
Joanna WOLOSZ,Poland,Setter,Women,Thailand,2022-06-16,Pool,3,5,7,2,0,2,4,4,0,6,10,1,1,17,19,0,0,1,1,14,3,1,18,52,1,90,143
Martyna CZYRNIANSKA,Poland,Outside Hitter,Women,Thailand,2022-06-16,Pool,3,5,18,16,3,30,49,0,3,4,7,2,3,16,21,0,0,3,3,11,3,1,15,1,0,2,3
Aleksandra GRYKA,Poland,Middle Blocker,Women,Thailand,2022-06-16,Pool,3,5,0,0,0,0,0,0,0,0,0,0,0,0,0,0,0,0,0,0,0,0,0,0,0,0,0
Weronika SZLAGOWSKA,Poland,Outside Hitter,Women,Thailand,2022-06-16,Pool,3,5,18,13,3,14,30,3,0,0,3,2,6,9,17,9,0,24,33,7,5,1,13,2,0,4,6
Katarzyna WENERSKA,Poland,Setter,Women,Thailand,2022-06-16,Pool,3,5,0,0,0,0,0,0,0,0,0,0,0,3,3,0,0,0,0,1,1,0,2,1,0,7,8
Olivia ROZANSKI,Poland,Outside Hitter,Women,Thailand,2022-06-16,Pool,3,5,20,17,10,28,55,2,4,2,8,1,4,9,14,6,0,7,13,16,0,0,16,0,0,2,2
Magdalena JURCZYK,Poland,Middle Blocker,Women,Thailand,2022-06-16,Pool,3,5,0,0,2,2,4,0,0,0,0,0,0,2,2,0,0,0,0,0,0,0,0,0,0,0,0
Maria STENZEL,Poland,Libero,Women,Japan,2022-06-14,Pool,0,3,0,0,0,0,0,0,0,0,0,0,0,0,0,11,0,7,18,13,3,0,16,1,0,7,8
Klaudia ALAGIERSKA,Poland,Middle Blocker,Women,Japan,2022-06-14,Pool,0,3,2,2,0,0,2,0,0,1,1,0,0,2,2,0,0,1,1,1,0,0,1,0,0,1,1
Kamila WITKOWSKA,Poland,Middle Blocker,Women,Japan,2022-06-14,Pool,0,3,0,0,0,0,0,0,0,0,0,0,0,0,0,0,0,0,0,0,0,0,0,0,0,0,0
Zuzanna GORECKA,Poland,Outside Hitter,Women,Japan,2022-06-14,Pool,0,3,3,3,2,4,9,0,2,1,3,0,1,6,7,3,2,11,16,2,1,0,3,0,0,0,0
Monika FEDUSIO,Poland,Outside Hitter,Women,Japan,2022-06-14,Pool,0,3,1,1,1,2,4,0,0,0,0,0,0,6,6,0,0,4,4,0,3,0,3,0,0,0,0
Martyna LUKASIK,Poland,Outside Hitter,Women,Japan,2022-06-14,Pool,0,3,3,2,1,11,14,0,0,0,0,1,2,6,9,3,0,12,15,1,3,1,5,0,0,0,0
Aleksandra SZCZYGLOWSKA,Poland,Libero,Women,Japan,2022-06-14,Pool,0,3,0,0,0,0,0,0,0,0,0,0,0,0,0,0,0,0,0,0,0,0,0,0,0,0,0
Joanna WOLOSZ,Poland,Setter,Women,Japan,2022-06-14,Pool,0,3,2,2,0,1,3,0,1,6,7,0,1,10,11,0,1,0,1,7,1,0,8,36,0,47,83
Martyna CZYRNIANSKA,Poland,Outside Hitter,Women,Japan,2022-06-14,Pool,0,3,7,6,3,3,12,1,1,1,3,0,1,1,2,0,0,0,0,0,1,0,1,1,0,0,1
Aleksandra GRYKA,Poland,Middle Blocker,Women,Japan,2022-06-14,Pool,0,3,8,7,1,8,16,1,5,5,11,0,0,7,7,0,0,0,0,2,0,0,2,0,0,2,2
Weronika SZLAGOWSKA,Poland,Outside Hitter,Women,Japan,2022-06-14,Pool,0,3,2,2,2,3,7,0,1,0,1,0,0,2,2,0,1,3,4,2,0,0,2,0,0,0,0
Katarzyna WENERSKA,Poland,Setter,Women,Japan,2022-06-14,Pool,0,3,0,0,0,0,0,0,0,0,0,0,0,1,1,0,0,0,0,0,0,0,0,0,0,0,0
Olivia ROZANSKI,Poland,Outside Hitter,Women,Japan,2022-06-14,Pool,0,3,9,8,5,12,25,1,0,2,3,0,1,7,8,0,0,2,2,1,3,0,4,1,0,1,2
Magdalena JURCZYK,Poland,Middle Blocker,Women,Japan,2022-06-14,Pool,0,3,9,8,0,3,11,1,5,5,11,0,0,10,10,1,0,1,2,2,2,0,4,0,0,0,0
Maria STENZEL,Poland,Libero,Women,Germany,2022-06-05,Pool,3,5,0,0,0,0,0,0,0,0,0,0,0,0,0,18,1,12,31,14,3,1,18,0,0,8,8
Klaudia ALAGIERSKA,Poland,Middle Blocker,Women,Germany,2022-06-05,Pool,3,5,0,0,0,0,0,0,0,0,0,0,0,0,0,0,0,0,0,0,0,0,0,0,0,0,0
Agnieszka KAKOLEWSKA,Poland,Middle Blocker,Women,Germany,2022-06-05,Pool,3,5,12,10,2,6,18,0,7,8,15,2,3,20,25,0,0,0,0,1,0,0,1,0,0,3,3
Kamila WITKOWSKA,Poland,Middle Blocker,Women,Germany,2022-06-05,Pool,3,5,3,2,0,2,4,1,1,2,4,0,0,3,3,0,0,0,0,0,0,0,0,0,0,0,0
Zuzanna GORECKA,Poland,Outside Hitter,Women,Germany,2022-06-05,Pool,3,5,11,11,3,14,28,0,4,3,7,0,2,9,11,20,1,6,27,12,4,0,16,0,0,3,3
Monika FEDUSIO,Poland,Outside Hitter,Women,Germany,2022-06-05,Pool,3,5,0,0,2,2,4,0,0,0,0,0,2,0,2,0,0,2,2,1,0,0,1,0,0,0,0
Martyna LUKASIK,Poland,Outside Hitter,Women,Germany,2022-06-05,Pool,3,5,16,13,5,10,28,2,1,4,7,1,1,15,17,23,2,5,30,8,3,2,13,0,0,2,2
Aleksandra SZCZYGLOWSKA,Poland,Libero,Women,Germany,2022-06-05,Pool,3,5,0,0,0,0,0,0,0,0,0,0,0,0,0,0,0,0,0,0,0,0,0,0,0,0,0
Joanna WOLOSZ,Poland,Setter,Women,Germany,2022-06-05,Pool,3,5,4,0,2,2,4,2,3,2,7,2,0,16,18,0,0,1,1,10,3,0,13,30,1,80,111
Aleksandra GRYKA,Poland,Middle Blocker,Women,Germany,2022-06-05,Pool,3,5,10,6,2,5,13,3,2,3,8,1,1,10,12,0,0,1,1,3,1,0,4,0,0,2,2
Alicja GRABKA,Poland,Setter,Women,Germany,2022-06-05,Pool,3,5,0,0,0,0,0,0,0,0,0,0,0,1,1,0,0,0,0,0,0,0,0,0,0,0,0
Weronika SZLAGOWSKA,Poland,Outside Hitter,Women,Germany,2022-06-05,Pool,3,5,2,2,2,4,8,0,0,0,0,0,0,0,0,0,0,0,0,1,0,0,1,0,0,1,1
Katarzyna WENERSKA,Poland,Setter,Women,Germany,2022-06-05,Pool,3,5,0,0,0,0,0,0,0,0,0,0,0,1,1,0,0,0,0,0,0,0,0,0,0,7,7
Olivia ROZANSKI,Poland,Outside Hitter,Women,Germany,2022-06-05,Pool,3,5,22,18,2,23,43,4,3,3,10,0,3,10,13,0,0,0,0,10,1,2,13,0,0,1,1
Maria STENZEL,Poland,Libero,Women,Korea,2022-06-04,Pool,3,3,0,0,0,0,0,0,0,0,0,0,0,0,0,4,0,1,5,4,1,0,5,0,0,2,2
Klaudia ALAGIERSKA,Poland,Middle Blocker,Women,Korea,2022-06-04,Pool,3,3,8,4,1,3,8,3,0,5,8,1,0,15,16,0,0,0,0,2,0,0,2,0,0,4,4
Agnieszka KAKOLEWSKA,Poland,Middle Blocker,Women,Korea,2022-06-04,Pool,3,3,0,0,0,0,0,0,0,0,0,0,0,0,0,0,0,0,0,0,0,0,0,0,0,0,0
Kamila WITKOWSKA,Poland,Middle Blocker,Women,Korea,2022-06-04,Pool,3,3,3,1,0,1,2,2,1,1,4,0,0,1,1,0,0,0,0,1,0,0,1,0,0,0,0
Zuzanna GORECKA,Poland,Outside Hitter,Women,Korea,2022-06-04,Pool,3,3,1,1,0,3,4,0,0,0,0,0,0,2,2,3,0,1,4,7,0,1,8,0,0,1,1
Monika FEDUSIO,Poland,Outside Hitter,Women,Korea,2022-06-04,Pool,3,3,9,7,4,11,22,2,2,1,5,0,2,12,14,6,1,2,9,3,0,0,3,0,0,1,1
Martyna LUKASIK,Poland,Outside Hitter,Women,Korea,2022-06-04,Pool,3,3,1,1,1,0,2,0,0,0,0,0,0,10,10,2,0,2,4,2,0,0,2,0,0,0,0
Aleksandra SZCZYGLOWSKA,Poland,Libero,Women,Korea,2022-06-04,Pool,3,3,0,0,0,0,0,0,0,0,0,0,0,0,0,7,0,0,7,7,0,0,7,0,0,4,4
Joanna WOLOSZ,Poland,Setter,Women,Korea,2022-06-04,Pool,3,3,2,1,0,1,2,0,0,0,0,1,1,4,6,0,0,0,0,4,1,0,5,14,0,22,36
Aleksandra GRYKA,Poland,Middle Blocker,Women,Korea,2022-06-04,Pool,3,3,5,4,1,0,5,1,1,1,3,0,1,2,3,1,0,0,1,2,0,0,2,0,0,2,2
Alicja GRABKA,Poland,Setter,Women,Korea,2022-06-04,Pool,3,3,0,0,0,0,0,0,0,0,0,0,0,0,0,0,0,0,0,0,0,0,0,0,0,0,0
Weronika SZLAGOWSKA,Poland,Outside Hitter,Women,Korea,2022-06-04,Pool,3,3,7,4,1,12,17,1,1,1,3,2,1,8,11,4,0,3,7,3,0,1,4,0,0,1,1
Katarzyna WENERSKA,Poland,Setter,Women,Korea,2022-06-04,Pool,3,3,2,1,0,0,1,1,0,0,1,0,0,3,3,0,0,0,0,1,1,0,2,3,0,17,20
Olivia ROZANSKI,Poland,Outside Hitter,Women,Korea,2022-06-04,Pool,3,3,11,9,0,9,18,2,0,3,5,0,3,3,6,0,0,0,0,4,0,0,4,0,0,1,1
Maria STENZEL,Poland,Libero,Women,Brazil,2022-06-02,Pool,0,3,0,0,0,0,0,0,0,0,0,0,0,0,0,15,2,4,21,12,2,0,14,0,0,11,11
Klaudia ALAGIERSKA,Poland,Middle Blocker,Women,Brazil,2022-06-02,Pool,0,3,0,0,0,0,0,0,0,0,0,0,0,0,0,0,0,0,0,0,0,0,0,0,0,0,0
Agnieszka KAKOLEWSKA,Poland,Middle Blocker,Women,Brazil,2022-06-02,Pool,0,3,9,6,0,3,9,2,3,1,6,1,2,9,12,0,0,0,0,2,0,0,2,0,0,0,0
Kamila WITKOWSKA,Poland,Middle Blocker,Women,Brazil,2022-06-02,Pool,0,3,0,0,0,0,0,0,0,0,0,0,0,0,0,0,0,0,0,0,0,0,0,0,0,0,0
Zuzanna GORECKA,Poland,Outside Hitter,Women,Brazil,2022-06-02,Pool,0,3,11,10,4,9,23,1,2,0,3,0,2,8,10,10,1,8,19,5,0,0,5,0,0,4,4
Monika FEDUSIO,Poland,Outside Hitter,Women,Brazil,2022-06-02,Pool,0,3,0,0,0,0,0,0,0,0,0,0,1,2,3,0,0,0,0,0,0,0,0,0,0,0,0
Martyna LUKASIK,Poland,Outside Hitter,Women,Brazil,2022-06-02,Pool,0,3,10,10,7,8,25,0,1,1,2,0,2,10,12,12,0,11,23,8,3,0,11,0,0,1,1
Aleksandra SZCZYGLOWSKA,Poland,Libero,Women,Brazil,2022-06-02,Pool,0,3,0,0,0,0,0,0,0,0,0,0,0,0,0,0,0,0,0,0,0,0,0,0,0,0,0
Joanna WOLOSZ,Poland,Setter,Women,Brazil,2022-06-02,Pool,0,3,0,0,0,0,0,0,0,0,0,0,0,0,0,0,0,0,0,0,0,0,0,0,0,0,0
Aleksandra GRYKA,Poland,Middle Blocker,Women,Brazil,2022-06-02,Pool,0,3,10,9,2,2,13,0,4,2,6,1,3,5,9,0,0,0,0,5,0,0,5,0,0,2,2
Alicja GRABKA,Poland,Setter,Women,Brazil,2022-06-02,Pool,0,3,3,1,0,1,2,2,0,5,7,0,1,11,12,0,0,0,0,10,1,0,11,18,1,68,87
Weronika SZLAGOWSKA,Poland,Outside Hitter,Women,Brazil,2022-06-02,Pool,0,3,5,4,2,7,13,1,1,2,4,0,0,3,3,2,1,2,5,0,0,0,0,0,0,1,1
Katarzyna WENERSKA,Poland,Setter,Women,Brazil,2022-06-02,Pool,0,3,0,0,0,0,0,0,0,0,0,0,0,0,0,0,0,0,0,0,0,0,0,0,0,0,0
Olivia ROZANSKI,Poland,Outside Hitter,Women,Brazil,2022-06-02,Pool,0,3,9,9,9,8,26,0,4,2,6,0,1,5,6,0,0,0,0,6,2,0,8,0,0,0,0
Maria STENZEL,Poland,Libero,Women,Canada,2022-06-01,Pool,3,4,0,0,0,0,0,0,0,0,0,0,0,0,0,19,0,4,23,23,1,1,25,0,0,13,13
Klaudia ALAGIERSKA,Poland,Middle Blocker,Women,Canada,2022-06-01,Pool,3,4,0,0,1,1,2,0,3,3,6,0,1,7,8,0,0,0,0,1,0,0,1,0,0,1,1
Agnieszka KAKOLEWSKA,Poland,Middle Blocker,Women,Canada,2022-06-01,Pool,3,4,14,9,1,6,16,3,4,6,13,2,2,11,15,0,0,0,0,4,1,0,5,0,0,0,0
Kamila WITKOWSKA,Poland,Middle Blocker,Women,Canada,2022-06-01,Pool,3,4,1,0,1,2,3,1,6,0,7,0,0,4,4,0,0,0,0,0,1,0,1,0,0,0,0
Zuzanna GORECKA,Poland,Outside Hitter,Women,Canada,2022-06-01,Pool,3,4,9,7,5,5,17,1,2,0,3,1,3,16,20,14,2,6,22,12,1,0,13,0,0,1,1
Monika FEDUSIO,Poland,Outside Hitter,Women,Canada,2022-06-01,Pool,3,4,0,0,0,0,0,0,0,0,0,0,0,2,2,0,0,0,0,0,1,0,1,0,0,0,0
Martyna LUKASIK,Poland,Outside Hitter,Women,Canada,2022-06-01,Pool,3,4,17,17,4,15,36,0,5,1,6,0,3,9,12,13,1,11,25,8,1,0,9,0,0,0,0
Aleksandra SZCZYGLOWSKA,Poland,Libero,Women,Canada,2022-06-01,Pool,3,4,0,0,0,0,0,0,0,0,0,0,0,0,0,0,0,0,0,0,0,0,0,0,0,0,0
Joanna WOLOSZ,Poland,Setter,Women,Canada,2022-06-01,Pool,3,4,0,0,0,0,0,0,0,0,0,0,0,0,0,0,0,0,0,0,0,0,0,0,0,0,0
Aleksandra GRYKA,Poland,Middle Blocker,Women,Canada,2022-06-01,Pool,3,4,0,0,0,0,0,0,0,0,0,0,0,0,0,0,0,0,0,0,0,0,0,0,0,0,0
Alicja GRABKA,Poland,Setter,Women,Canada,2022-06-01,Pool,3,4,0,0,0,0,0,0,0,0,0,0,1,3,4,0,0,0,0,1,0,0,1,1,0,14,15
Weronika SZLAGOWSKA,Poland,Outside Hitter,Women,Canada,2022-06-01,Pool,3,4,5,3,2,4,9,2,0,3,5,0,1,1,2,0,0,0,0,0,0,0,0,0,0,0,0
Katarzyna WENERSKA,Poland,Setter,Women,Canada,2022-06-01,Pool,3,4,3,1,0,0,1,0,1,2,3,2,1,14,17,0,0,1,1,6,3,1,10,7,0,82,89
Olivia ROZANSKI,Poland,Outside Hitter,Women,Canada,2022-06-01,Pool,3,4,12,9,10,23,42,2,0,0,2,1,1,8,10,0,0,0,0,6,0,0,6,0,1,0,1
Bianka BUSA,Serbia,Outside Hitter,Women,Türkiye,2022-07-17,Finals (Bronze),3,3,14,12,7,12,31,1,1,3,5,1,0,13,14,8,2,9,19,14,0,0,14,0,0,1,1
Katarina LAZOVIC,Serbia,Outside Hitter,Women,Türkiye,2022-07-17,Finals (Bronze),3,3,0,0,0,0,0,0,0,0,0,0,0,3,3,0,0,0,0,0,0,0,0,0,0,0,0
Bojana DRCA,Serbia,Setter,Women,Türkiye,2022-07-17,Finals (Bronze),3,3,2,0,2,1,3,1,2,2,5,1,0,15,16,0,0,1,1,6,1,1,8,9,2,88,99
Mina POPOVIC,Serbia,Middle Blocker,Women,Türkiye,2022-07-17,Finals (Bronze),3,3,0,0,0,0,0,0,0,0,0,0,0,0,0,0,0,0,0,0,0,0,0,0,0,0,0
Sladjana MIRKOVIC,Serbia,Setter,Women,Türkiye,2022-07-17,Finals (Bronze),3,3,0,0,0,0,0,0,0,0,0,0,0,0,0,0,0,0,0,0,0,0,0,0,0,0,0
Brankica MIHAJLOVIC,Serbia,Outside Hitter,Women,Türkiye,2022-07-17,Finals (Bronze),3,3,0,0,0,0,0,0,0,0,0,0,0,0,0,0,0,0,0,0,0,0,0,0,0,0,0
Teodora PUSIC,Serbia,Libero,Women,Türkiye,2022-07-17,Finals (Bronze),3,3,0,0,0,0,0,0,0,0,0,0,0,0,0,6,0,10,16,7,6,0,13,0,0,10,10
Ana BJELICA,Serbia,Opposite Spiker,Women,Türkiye,2022-07-17,Finals (Bronze),3,3,12,11,6,14,31,1,2,2,5,0,0,10,10,0,0,0,0,8,1,1,10,0,0,4,4
Maja ALEKSIC,Serbia,Middle Blocker,Women,Türkiye,2022-07-17,Finals (Bronze),3,3,8,5,1,2,8,3,2,7,12,0,0,9,9,1,0,0,1,4,1,1,6,0,0,1,1
Jovana STEVANOVIC,Serbia,Middle Blocker,Women,Türkiye,2022-07-17,Finals (Bronze),3,3,9,6,1,6,13,3,8,6,17,0,2,8,10,0,0,0,0,5,2,0,7,0,0,1,1
Bojana MILENKOVIC,Serbia,Outside Hitter,Women,Türkiye,2022-07-17,Finals (Bronze),3,3,0,0,0,0,0,0,0,0,0,0,0,0,0,1,0,2,3,2,0,1,3,0,0,0,0
Jovana KOCIC,Serbia,Middle Blocker,Women,Türkiye,2022-07-17,Finals (Bronze),3,3,0,0,0,0,0,0,0,0,0,0,0,0,0,0,0,0,0,0,0,0,0,0,0,0,0
Sara LOZO,Serbia,Opposite Spiker,Women,Türkiye,2022-07-17,Finals (Bronze),3,3,19,18,2,9,29,1,4,0,5,0,3,11,14,6,1,20,27,5,0,0,5,0,0,2,2
Sanja DJURDJEVIC,Serbia,Libero,Women,Türkiye,2022-07-17,Finals (Bronze),3,3,0,0,0,0,0,0,0,0,0,0,0,0,0,0,0,0,0,0,0,0,0,0,0,0,0
Bianka BUSA,Serbia,Outside Hitter,Women,Brazil,2022-07-16,Semifinals,1,4,2,2,0,4,6,0,0,2,2,0,2,5,7,4,0,3,7,2,1,0,3,0,0,0,0
Katarina LAZOVIC,Serbia,Outside Hitter,Women,Brazil,2022-07-16,Semifinals,1,4,2,1,1,0,2,0,1,0,1,1,0,2,3,0,1,2,3,0,2,0,2,0,0,0,0
Bojana DRCA,Serbia,Setter,Women,Brazil,2022-07-16,Semifinals,1,4,3,1,0,3,4,2,4,6,12,0,0,9,9,0,0,1,1,7,5,4,16,25,2,62,89
Mina POPOVIC,Serbia,Middle Blocker,Women,Brazil,2022-07-16,Semifinals,1,4,1,1,0,0,1,0,0,0,0,0,0,2,2,0,0,0,0,0,1,0,1,0,0,0,0
Sladjana MIRKOVIC,Serbia,Setter,Women,Brazil,2022-07-16,Semifinals,1,4,2,2,0,1,3,0,0,0,0,0,1,4,5,0,0,0,0,1,4,1,6,1,1,11,13
Brankica MIHAJLOVIC,Serbia,Outside Hitter,Women,Brazil,2022-07-16,Semifinals,1,4,5,3,1,6,10,2,2,0,4,0,0,1,1,0,0,0,0,1,0,0,1,0,0,0,0
Teodora PUSIC,Serbia,Libero,Women,Brazil,2022-07-16,Semifinals,1,4,0,0,0,0,0,0,0,0,0,0,0,0,0,6,0,11,17,12,6,3,21,1,0,12,13
Ana BJELICA,Serbia,Opposite Spiker,Women,Brazil,2022-07-16,Semifinals,1,4,17,15,7,18,40,1,0,1,2,1,1,10,12,0,0,0,0,3,1,3,7,0,0,1,1
Maja ALEKSIC,Serbia,Middle Blocker,Women,Brazil,2022-07-16,Semifinals,1,4,8,5,2,2,9,2,5,7,14,1,1,16,18,0,0,0,0,3,1,2,6,0,0,1,1
Jovana STEVANOVIC,Serbia,Middle Blocker,Women,Brazil,2022-07-16,Semifinals,1,4,15,9,2,3,14,4,11,7,22,2,0,11,13,0,0,1,1,3,1,1,5,0,0,3,3
Bojana MILENKOVIC,Serbia,Outside Hitter,Women,Brazil,2022-07-16,Semifinals,1,4,5,4,4,9,17,1,0,0,1,0,0,8,8,5,1,15,21,1,4,2,7,0,0,4,4
Jovana KOCIC,Serbia,Middle Blocker,Women,Brazil,2022-07-16,Semifinals,1,4,0,0,0,0,0,0,0,0,0,0,0,0,0,0,0,0,0,0,0,0,0,0,0,0,0
Sara LOZO,Serbia,Opposite Spiker,Women,Brazil,2022-07-16,Semifinals,1,4,10,10,3,9,22,0,0,0,0,0,1,8,9,10,0,24,34,9,2,1,12,0,0,4,4
Sanja DJURDJEVIC,Serbia,Libero,Women,Brazil,2022-07-16,Semifinals,1,4,0,0,0,0,0,0,0,0,0,0,0,0,0,0,0,0,0,0,0,0,0,0,0,0,0
Bianka BUSA,Serbia,Outside Hitter,Women,United States,2022-07-13,Quarterfinals,3,5,0,0,0,0,0,0,0,0,0,0,0,0,0,0,0,0,0,0,0,0,0,0,0,0,0
Katarina LAZOVIC,Serbia,Outside Hitter,Women,United States,2022-07-13,Quarterfinals,3,5,1,0,0,0,0,0,0,0,0,1,1,7,9,0,0,1,1,0,0,0,0,0,0,0,0
Bojana DRCA,Serbia,Setter,Women,United States,2022-07-13,Quarterfinals,3,5,4,3,0,0,3,1,6,1,8,0,1,14,15,0,0,1,1,11,9,0,20,12,2,91,105
Mina POPOVIC,Serbia,Middle Blocker,Women,United States,2022-07-13,Quarterfinals,3,5,0,0,0,0,0,0,0,0,0,0,0,0,0,0,0,0,0,0,0,0,0,0,0,0,0
Sladjana MIRKOVIC,Serbia,Setter,Women,United States,2022-07-13,Quarterfinals,3,5,0,0,0,0,0,0,0,0,0,0,1,2,3,0,0,0,0,1,2,1,4,1,0,18,19
Brankica MIHAJLOVIC,Serbia,Outside Hitter,Women,United States,2022-07-13,Quarterfinals,3,5,7,7,4,2,13,0,0,0,0,0,0,1,1,0,0,0,0,0,0,0,0,0,0,0,0
Teodora PUSIC,Serbia,Libero,Women,United States,2022-07-13,Quarterfinals,3,5,0,0,0,0,0,0,0,0,0,0,0,0,0,21,2,25,48,15,2,0,17,0,0,5,5
Ana BJELICA,Serbia,Opposite Spiker,Women,United States,2022-07-13,Quarterfinals,3,5,20,17,8,23,48,3,4,1,8,0,1,8,9,0,0,1,1,3,1,0,4,0,0,0,0
Maja ALEKSIC,Serbia,Middle Blocker,Women,United States,2022-07-13,Quarterfinals,3,5,14,12,2,2,16,2,12,7,21,0,2,19,21,1,0,1,2,4,1,1,6,0,0,2,2
Jovana STEVANOVIC,Serbia,Middle Blocker,Women,United States,2022-07-13,Quarterfinals,3,5,9,5,4,3,12,2,8,4,14,2,1,13,16,0,0,0,0,3,2,0,5,0,0,0,0
Bojana MILENKOVIC,Serbia,Outside Hitter,Women,United States,2022-07-13,Quarterfinals,3,5,10,8,5,15,28,2,4,1,7,0,0,12,12,14,1,20,35,9,4,0,13,0,0,2,2
Jovana KOCIC,Serbia,Middle Blocker,Women,United States,2022-07-13,Quarterfinals,3,5,0,0,0,0,0,0,0,0,0,0,0,0,0,0,0,0,0,0,0,0,0,0,0,0,0
Sara LOZO,Serbia,Opposite Spiker,Women,United States,2022-07-13,Quarterfinals,3,5,22,15,9,14,38,4,4,3,11,3,2,18,23,11,0,6,17,10,2,0,12,0,0,2,2
Sanja DJURDJEVIC,Serbia,Libero,Women,United States,2022-07-13,Quarterfinals,3,5,0,0,0,0,0,0,0,0,0,0,0,0,0,0,0,0,0,0,0,0,0,0,0,0,0
Bianka BUSA,Serbia,Outside Hitter,Women,Japan,2022-07-02,Pool,3,4,5,5,2,6,13,0,1,0,1,0,1,10,11,4,0,3,7,7,3,0,10,0,0,0,0
Katarina LAZOVIC,Serbia,Outside Hitter,Women,Japan,2022-07-02,Pool,3,4,22,20,1,26,47,2,2,1,5,0,1,17,18,21,2,16,39,14,4,0,18,0,1,1,2
Ana JAKSIC,Serbia,Setter,Women,Japan,2022-07-02,Pool,3,4,0,0,0,0,0,0,0,0,0,0,0,2,2,0,0,0,0,0,0,0,0,1,0,4,5
Sladjana MIRKOVIC,Serbia,Setter,Women,Japan,2022-07-02,Pool,3,4,3,1,1,7,9,1,1,6,8,1,1,13,15,0,0,0,0,16,1,0,17,9,1,120,130
Teodora PUSIC,Serbia,Libero,Women,Japan,2022-07-02,Pool,3,4,0,0,0,1,1,0,0,0,0,0,0,0,0,6,1,8,15,15,2,0,17,0,0,19,19
Ana BJELICA,Serbia,Opposite Spiker,Women,Japan,2022-07-02,Pool,3,4,0,0,0,0,0,0,0,0,0,0,0,0,0,0,0,0,0,0,0,0,0,0,0,0,0
Maja ALEKSIC,Serbia,Middle Blocker,Women,Japan,2022-07-02,Pool,3,4,17,12,1,6,19,4,6,6,16,1,2,14,17,0,0,2,2,4,0,0,4,0,0,0,0
Jovana STEVANOVIC,Serbia,Middle Blocker,Women,Japan,2022-07-02,Pool,3,4,12,9,0,11,20,3,7,6,16,0,2,7,9,2,0,1,3,5,1,0,6,0,0,3,3
Bojana MILENKOVIC,Serbia,Outside Hitter,Women,Japan,2022-07-02,Pool,3,4,5,5,1,14,20,0,0,1,1,0,1,9,10,6,1,7,14,12,3,0,15,1,0,4,5
Jovana KOCIC,Serbia,Middle Blocker,Women,Japan,2022-07-02,Pool,3,4,0,0,0,0,0,0,0,0,0,0,0,0,0,0,0,0,0,0,0,0,0,0,0,0,0
Jelena DELIC,Serbia,Middle Blocker,Women,Japan,2022-07-02,Pool,3,4,0,0,0,0,0,0,0,0,0,0,0,0,0,0,0,0,0,0,0,0,0,0,0,0,0
Sanja DJURDJEVIC,Serbia,Libero,Women,Japan,2022-07-02,Pool,3,4,0,0,0,0,0,0,0,0,0,0,0,0,0,0,0,0,0,0,0,0,0,0,0,0,0
Jovana MIROSAVLJEVIC,Serbia,Outside Hitter,Women,Japan,2022-07-02,Pool,3,4,8,8,2,8,18,0,0,1,1,0,0,8,8,0,0,0,0,11,3,0,14,0,1,1,2
Mina MIJATOVIC,Serbia,Outside Hitter,Women,Japan,2022-07-02,Pool,3,4,4,4,3,10,17,0,1,3,4,0,1,5,6,0,0,0,0,3,0,1,4,0,0,1,1
Bianka BUSA,Serbia,Outside Hitter,Women,Canada,2022-07-02,Pool,3,4,7,4,7,8,19,1,0,0,1,2,4,10,16,1,1,17,19,2,1,0,3,0,1,1,2
Katarina LAZOVIC,Serbia,Outside Hitter,Women,Canada,2022-07-02,Pool,3,4,6,5,0,5,10,1,0,0,1,0,0,6,6,1,0,3,4,2,0,2,4,0,0,2,2
Ana JAKSIC,Serbia,Setter,Women,Canada,2022-07-02,Pool,3,4,0,0,0,0,0,0,0,0,0,0,0,0,0,0,0,0,0,0,0,0,0,0,0,0,0
Sladjana MIRKOVIC,Serbia,Setter,Women,Canada,2022-07-02,Pool,3,4,5,5,1,2,8,0,0,0,0,0,2,11,13,0,0,3,3,3,0,0,3,2,0,73,75
Teodora PUSIC,Serbia,Libero,Women,Canada,2022-07-02,Pool,3,4,0,0,0,0,0,0,0,0,0,0,0,0,0,4,0,26,30,4,0,0,4,0,0,6,6
Ana BJELICA,Serbia,Opposite Spiker,Women,Canada,2022-07-02,Pool,3,4,27,26,6,30,62,0,0,0,0,1,1,12,14,0,0,0,0,4,0,0,4,0,0,2,2
Maja ALEKSIC,Serbia,Middle Blocker,Women,Canada,2022-07-02,Pool,3,4,4,2,2,4,8,2,3,1,6,0,0,4,4,0,0,0,0,1,0,0,1,0,0,2,2
Jovana STEVANOVIC,Serbia,Middle Blocker,Women,Canada,2022-07-02,Pool,3,4,8,5,2,3,10,3,1,3,7,0,2,6,8,0,0,0,0,0,0,0,0,0,0,1,1
Bojana MILENKOVIC,Serbia,Outside Hitter,Women,Canada,2022-07-02,Pool,3,4,13,9,6,12,27,2,2,2,6,2,1,20,23,3,0,15,18,4,0,0,4,0,0,3,3
Jovana KOCIC,Serbia,Middle Blocker,Women,Canada,2022-07-02,Pool,3,4,0,0,0,0,0,0,0,0,0,0,0,4,4,0,0,0,0,2,0,0,2,0,0,0,0
Jelena DELIC,Serbia,Middle Blocker,Women,Canada,2022-07-02,Pool,3,4,0,0,0,0,0,0,0,0,0,0,0,0,0,0,0,0,0,0,0,0,0,0,0,0,0
Sanja DJURDJEVIC,Serbia,Libero,Women,Canada,2022-07-02,Pool,3,4,0,0,0,0,0,0,0,0,0,0,0,0,0,0,0,0,0,0,0,0,0,0,0,0,0
Jovana MIROSAVLJEVIC,Serbia,Outside Hitter,Women,Canada,2022-07-02,Pool,3,4,0,0,0,0,0,0,0,0,0,0,1,5,6,0,0,0,0,0,0,0,0,0,0,0,0
Mina MIJATOVIC,Serbia,Outside Hitter,Women,Canada,2022-07-02,Pool,3,4,0,0,0,0,0,0,0,0,0,0,0,0,0,0,0,0,0,0,0,0,0,0,0,0,0
Bianka BUSA,Serbia,Outside Hitter,Women,United States,2022-07-01,Pool,0,3,14,12,3,11,26,0,1,3,4,2,1,9,12,14,3,16,33,6,0,0,6,0,0,0,0
Katarina LAZOVIC,Serbia,Outside Hitter,Women,United States,2022-07-01,Pool,0,3,2,2,2,6,10,0,0,1,1,0,0,3,3,2,1,3,6,4,0,0,4,0,0,0,0
Ana JAKSIC,Serbia,Setter,Women,United States,2022-07-01,Pool,0,3,0,0,0,0,0,0,0,0,0,0,1,0,1,0,0,0,0,1,1,0,2,0,0,13,13
Sladjana MIRKOVIC,Serbia,Setter,Women,United States,2022-07-01,Pool,0,3,1,1,1,4,6,0,0,1,1,0,2,7,9,0,0,0,0,4,2,0,6,6,1,62,69
Teodora PUSIC,Serbia,Libero,Women,United States,2022-07-01,Pool,0,3,0,0,0,0,0,0,0,0,0,0,0,0,0,6,0,3,9,4,1,0,5,0,0,7,7
Ana BJELICA,Serbia,Opposite Spiker,Women,United States,2022-07-01,Pool,0,3,13,12,11,12,35,1,2,2,5,0,1,6,7,0,0,0,0,1,0,0,1,0,0,2,2
Maja ALEKSIC,Serbia,Middle Blocker,Women,United States,2022-07-01,Pool,0,3,7,4,1,1,6,3,6,3,12,0,1,7,8,0,0,0,0,1,0,0,1,0,0,2,2
Jovana STEVANOVIC,Serbia,Middle Blocker,Women,United States,2022-07-01,Pool,0,3,5,4,2,5,11,0,8,3,11,1,0,11,12,2,0,0,2,2,0,0,2,0,0,2,2
Bojana MILENKOVIC,Serbia,Outside Hitter,Women,United States,2022-07-01,Pool,0,3,8,7,1,8,16,1,0,2,3,0,1,9,10,13,0,12,25,4,1,0,5,0,0,0,0
Jovana KOCIC,Serbia,Middle Blocker,Women,United States,2022-07-01,Pool,0,3,0,0,0,0,0,0,0,0,0,0,0,0,0,0,0,0,0,0,0,0,0,0,0,0,0
Jelena DELIC,Serbia,Middle Blocker,Women,United States,2022-07-01,Pool,0,3,0,0,0,0,0,0,0,0,0,0,0,0,0,0,0,0,0,0,0,0,0,0,0,0,0
Sanja DJURDJEVIC,Serbia,Libero,Women,United States,2022-07-01,Pool,0,3,0,0,0,0,0,0,0,0,0,0,0,0,0,0,0,0,0,0,0,0,0,0,0,0,0
Jovana MIROSAVLJEVIC,Serbia,Outside Hitter,Women,United States,2022-07-01,Pool,0,3,1,0,0,0,0,0,0,0,0,1,0,2,3,0,0,0,0,0,0,0,0,0,0,0,0
Mina MIJATOVIC,Serbia,Outside Hitter,Women,United States,2022-07-01,Pool,0,3,2,2,0,2,4,0,0,0,0,0,1,0,1,0,0,0,0,0,0,0,0,0,0,0,0
Bianka BUSA,Serbia,Outside Hitter,Women,Germany,2022-06-28,Pool,3,4,13,11,2,13,26,1,1,1,3,1,1,12,14,8,3,23,34,7,1,1,9,0,0,2,2
Katarina LAZOVIC,Serbia,Outside Hitter,Women,Germany,2022-06-28,Pool,3,4,11,11,3,12,26,0,1,2,3,0,3,9,12,4,1,10,15,7,0,1,8,0,0,4,4
Ana JAKSIC,Serbia,Setter,Women,Germany,2022-06-28,Pool,3,4,0,0,0,0,0,0,0,0,0,0,0,1,1,0,0,0,0,1,0,0,1,0,0,2,2
Sladjana MIRKOVIC,Serbia,Setter,Women,Germany,2022-06-28,Pool,3,4,7,6,0,2,8,0,2,0,2,1,0,19,20,0,0,0,0,8,0,0,8,16,0,79,95
Teodora PUSIC,Serbia,Libero,Women,Germany,2022-06-28,Pool,3,4,0,0,0,0,0,0,0,0,0,0,0,0,0,3,0,16,19,13,6,1,20,0,0,7,7
Ana BJELICA,Serbia,Opposite Spiker,Women,Germany,2022-06-28,Pool,3,4,15,12,8,15,35,3,2,1,6,0,3,11,14,0,0,0,0,4,1,1,6,0,0,3,3
Maja ALEKSIC,Serbia,Middle Blocker,Women,Germany,2022-06-28,Pool,3,4,13,10,1,3,14,2,6,5,13,1,1,12,14,0,0,2,2,3,0,0,3,1,0,1,2
Jovana STEVANOVIC,Serbia,Middle Blocker,Women,Germany,2022-06-28,Pool,3,4,9,7,4,2,13,2,4,7,13,0,1,11,12,0,0,0,0,4,0,0,4,0,0,1,1
Bojana MILENKOVIC,Serbia,Outside Hitter,Women,Germany,2022-06-28,Pool,3,4,1,1,0,2,3,0,0,0,0,0,0,0,0,2,1,1,4,0,0,0,0,0,0,0,0
Jovana KOCIC,Serbia,Middle Blocker,Women,Germany,2022-06-28,Pool,3,4,0,0,0,0,0,0,0,0,0,0,0,0,0,0,0,0,0,0,0,0,0,0,0,0,0
Jelena DELIC,Serbia,Middle Blocker,Women,Germany,2022-06-28,Pool,3,4,0,0,0,0,0,0,0,0,0,0,0,0,0,0,0,0,0,0,0,0,0,0,0,0,0
Sanja DJURDJEVIC,Serbia,Libero,Women,Germany,2022-06-28,Pool,3,4,0,0,0,0,0,0,0,0,0,0,0,0,0,0,0,0,0,0,0,0,0,0,0,0,0
Jovana MIROSAVLJEVIC,Serbia,Outside Hitter,Women,Germany,2022-06-28,Pool,3,4,0,0,0,0,0,0,0,0,0,0,0,4,4,0,0,0,0,0,0,0,0,0,0,0,0
Mina MIJATOVIC,Serbia,Outside Hitter,Women,Germany,2022-06-28,Pool,3,4,1,1,0,1,2,0,0,0,0,0,0,0,0,0,0,0,0,0,0,0,0,0,0,0,0
Bianka BUSA,Serbia,Outside Hitter,Women,Brazil,2022-06-19,Pool,0,3,1,1,3,3,7,0,1,0,1,0,0,1,1,0,1,0,1,0,1,0,1,0,0,0,0
Katarina LAZOVIC,Serbia,Outside Hitter,Women,Brazil,2022-06-19,Pool,0,3,0,0,0,0,0,0,0,0,0,0,0,2,2,0,0,0,0,0,0,0,0,0,0,0,0
Ana JAKSIC,Serbia,Setter,Women,Brazil,2022-06-19,Pool,0,3,0,0,0,0,0,0,0,0,0,0,0,0,0,0,0,0,0,0,0,0,0,2,0,3,5
Sladjana MIRKOVIC,Serbia,Setter,Women,Brazil,2022-06-19,Pool,0,3,3,3,0,1,4,0,2,3,5,0,1,9,10,0,0,0,0,4,3,1,8,19,1,76,96
Teodora PUSIC,Serbia,Libero,Women,Brazil,2022-06-19,Pool,0,3,0,0,0,0,0,0,0,0,0,0,0,0,0,4,0,4,8,11,5,2,18,0,0,8,8
Ana BJELICA,Serbia,Opposite Spiker,Women,Brazil,2022-06-19,Pool,0,3,8,8,9,22,39,0,1,2,3,0,2,8,10,0,0,0,0,5,1,2,8,0,0,1,1
Maja ALEKSIC,Serbia,Middle Blocker,Women,Brazil,2022-06-19,Pool,0,3,3,2,2,2,6,1,4,3,8,0,0,6,6,0,0,0,0,2,1,0,3,0,0,2,2
Jovana STEVANOVIC,Serbia,Middle Blocker,Women,Brazil,2022-06-19,Pool,0,3,7,4,3,4,11,3,2,5,10,0,1,4,5,0,0,0,0,0,0,0,0,0,0,0,0
Bojana MILENKOVIC,Serbia,Outside Hitter,Women,Brazil,2022-06-19,Pool,0,3,8,8,6,17,31,0,2,2,4,0,0,8,8,4,0,13,17,9,3,0,12,0,0,2,2
Jovana KOCIC,Serbia,Middle Blocker,Women,Brazil,2022-06-19,Pool,0,3,0,0,0,0,0,0,0,0,0,0,0,0,0,0,0,0,0,0,0,0,0,0,0,0,0
Sara LOZO,Serbia,Opposite Spiker,Women,Brazil,2022-06-19,Pool,0,3,6,6,4,5,15,0,0,0,0,0,1,10,11,17,0,26,43,5,1,1,7,0,0,0,0
Jelena DELIC,Serbia,Middle Blocker,Women,Brazil,2022-06-19,Pool,0,3,0,0,0,0,0,0,0,0,0,0,0,0,0,0,0,0,0,0,0,0,0,0,0,0,0
Sanja DJURDJEVIC,Serbia,Libero,Women,Brazil,2022-06-19,Pool,0,3,0,0,0,0,0,0,0,0,0,0,0,0,0,0,0,0,0,0,0,0,0,0,0,0,0
Jovana MIROSAVLJEVIC,Serbia,Outside Hitter,Women,Brazil,2022-06-19,Pool,0,3,0,0,0,1,1,0,1,0,1,0,0,0,0,0,0,0,0,0,0,0,0,0,0,0,0
Bianka BUSA,Serbia,Outside Hitter,Women,Türkiye,2022-06-17,Pool,3,5,7,5,5,8,18,2,1,3,6,0,0,7,7,6,2,16,24,4,0,1,5,0,0,2,2
Katarina LAZOVIC,Serbia,Outside Hitter,Women,Türkiye,2022-06-17,Pool,3,5,3,3,8,7,18,0,1,1,2,0,0,10,10,2,0,6,8,3,2,3,8,0,0,1,1
Ana JAKSIC,Serbia,Setter,Women,Türkiye,2022-06-17,Pool,3,5,0,0,0,0,0,0,1,0,1,0,0,0,0,0,0,0,0,0,0,0,0,3,0,7,10
Sladjana MIRKOVIC,Serbia,Setter,Women,Türkiye,2022-06-17,Pool,3,5,1,0,1,2,3,1,9,1,11,0,1,13,14,0,0,0,0,4,2,1,7,18,1,101,120
Teodora PUSIC,Serbia,Libero,Women,Türkiye,2022-06-17,Pool,3,5,0,0,0,0,0,0,0,0,0,0,0,0,0,7,0,10,17,16,2,4,22,0,0,13,13
Ana BJELICA,Serbia,Opposite Spiker,Women,Türkiye,2022-06-17,Pool,3,5,19,15,5,27,47,2,5,0,7,2,3,13,18,0,0,0,0,6,3,1,10,0,0,0,0
Maja ALEKSIC,Serbia,Middle Blocker,Women,Türkiye,2022-06-17,Pool,3,5,12,7,2,4,13,4,4,4,12,1,1,14,16,1,0,1,2,3,1,0,4,0,0,1,1
Jovana STEVANOVIC,Serbia,Middle Blocker,Women,Türkiye,2022-06-17,Pool,3,5,12,3,3,4,10,9,7,5,21,0,3,11,14,1,0,1,2,0,0,0,0,0,0,0,0
Bojana MILENKOVIC,Serbia,Outside Hitter,Women,Türkiye,2022-06-17,Pool,3,5,0,0,0,3,3,0,0,0,0,0,0,0,0,0,1,0,1,0,0,0,0,0,0,0,0
Jovana KOCIC,Serbia,Middle Blocker,Women,Türkiye,2022-06-17,Pool,3,5,0,0,0,0,0,0,0,0,0,0,0,0,0,0,0,0,0,0,0,0,0,0,0,0,0
Sara LOZO,Serbia,Opposite Spiker,Women,Türkiye,2022-06-17,Pool,3,5,18,17,5,15,37,0,2,1,3,1,0,19,20,10,0,30,40,7,1,0,8,0,0,1,1
Jelena DELIC,Serbia,Middle Blocker,Women,Türkiye,2022-06-17,Pool,3,5,0,0,0,0,0,0,0,0,0,0,0,0,0,0,0,0,0,0,0,0,0,0,0,0,0
Sanja DJURDJEVIC,Serbia,Libero,Women,Türkiye,2022-06-17,Pool,3,5,0,0,0,0,0,0,0,0,0,0,0,0,0,0,0,0,0,0,0,0,0,0,0,0,0
Jovana MIROSAVLJEVIC,Serbia,Outside Hitter,Women,Türkiye,2022-06-17,Pool,3,5,1,1,0,3,4,0,0,0,0,0,0,1,1,0,0,0,0,0,0,1,1,0,0,0,0
Bianka BUSA,Serbia,Outside Hitter,Women,Korea,2022-06-16,Pool,3,3,9,9,4,17,30,0,2,3,5,0,1,13,14,4,2,15,21,1,3,2,6,0,0,2,2
Katarina LAZOVIC,Serbia,Outside Hitter,Women,Korea,2022-06-16,Pool,3,3,1,0,2,0,2,0,1,0,1,1,1,3,5,2,0,4,6,2,1,0,3,0,0,0,0
Ana JAKSIC,Serbia,Setter,Women,Korea,2022-06-16,Pool,3,3,0,0,0,2,2,0,0,1,1,0,0,3,3,0,0,0,0,1,1,0,2,3,1,19,23
Sladjana MIRKOVIC,Serbia,Setter,Women,Korea,2022-06-16,Pool,3,3,2,2,0,0,2,0,2,4,6,0,3,8,11,0,0,0,0,1,0,0,1,21,1,60,82
Teodora PUSIC,Serbia,Libero,Women,Korea,2022-06-16,Pool,3,3,0,0,0,0,0,0,0,0,0,0,0,0,0,11,0,12,23,10,3,1,14,0,0,7,7
Ana BJELICA,Serbia,Opposite Spiker,Women,Korea,2022-06-16,Pool,3,3,23,19,2,12,33,4,2,6,12,0,0,12,12,0,0,0,0,3,1,0,4,0,0,0,0
Maja ALEKSIC,Serbia,Middle Blocker,Women,Korea,2022-06-16,Pool,3,3,5,2,2,8,12,3,7,8,18,0,2,11,13,0,0,0,0,1,0,0,1,0,0,2,2
Jovana STEVANOVIC,Serbia,Middle Blocker,Women,Korea,2022-06-16,Pool,3,3,8,6,1,5,12,1,4,4,9,1,2,11,14,1,0,1,2,4,2,1,7,0,0,0,0
Bojana MILENKOVIC,Serbia,Outside Hitter,Women,Korea,2022-06-16,Pool,3,3,0,0,0,0,0,0,0,0,0,0,0,0,0,0,0,0,0,0,0,0,0,0,0,0,0
Jovana KOCIC,Serbia,Middle Blocker,Women,Korea,2022-06-16,Pool,3,3,0,0,0,0,0,0,0,0,0,0,0,0,0,0,0,0,0,0,0,0,0,0,0,0,0
Sara LOZO,Serbia,Opposite Spiker,Women,Korea,2022-06-16,Pool,3,3,8,7,4,7,18,1,0,0,1,0,0,16,16,6,1,12,19,11,2,2,15,0,0,2,2
Jelena DELIC,Serbia,Middle Blocker,Women,Korea,2022-06-16,Pool,3,3,0,0,0,0,0,0,0,0,0,0,0,0,0,0,0,0,0,0,0,0,0,0,0,0,0
Sanja DJURDJEVIC,Serbia,Libero,Women,Korea,2022-06-16,Pool,3,3,0,0,0,0,0,0,0,0,0,0,0,0,0,0,0,0,0,0,0,0,0,0,0,0,0
Jovana MIROSAVLJEVIC,Serbia,Outside Hitter,Women,Korea,2022-06-16,Pool,3,3,1,1,0,1,2,0,0,0,0,0,0,0,0,0,0,0,0,0,0,0,0,0,0,0,0
Bianka BUSA,Serbia,Outside Hitter,Women,Italy,2022-06-15,Pool,1,4,2,2,0,6,8,0,0,1,1,0,0,1,1,2,0,4,6,3,0,0,3,0,0,0,0
Katarina LAZOVIC,Serbia,Outside Hitter,Women,Italy,2022-06-15,Pool,1,4,13,10,4,13,27,2,0,3,5,1,1,11,13,5,2,15,22,5,0,2,7,0,0,0,0
Ana JAKSIC,Serbia,Setter,Women,Italy,2022-06-15,Pool,1,4,0,0,0,0,0,0,0,0,0,0,0,1,1,0,0,0,0,1,0,0,1,0,3,3,6
Sladjana MIRKOVIC,Serbia,Setter,Women,Italy,2022-06-15,Pool,1,4,2,2,1,1,4,0,0,3,3,0,0,12,12,0,0,1,1,4,0,2,6,0,2,66,68
Teodora PUSIC,Serbia,Libero,Women,Italy,2022-06-15,Pool,1,4,0,0,0,0,0,0,0,0,0,0,0,0,0,12,3,15,30,15,1,5,21,0,0,0,0
Ana BJELICA,Serbia,Opposite Spiker,Women,Italy,2022-06-15,Pool,1,4,17,16,6,14,36,1,0,6,7,0,2,8,10,0,0,0,0,6,0,0,6,0,0,2,2
Maja ALEKSIC,Serbia,Middle Blocker,Women,Italy,2022-06-15,Pool,1,4,6,2,0,6,8,3,1,11,15,1,3,14,18,0,0,0,0,4,0,1,5,0,0,0,0
Jovana STEVANOVIC,Serbia,Middle Blocker,Women,Italy,2022-06-15,Pool,1,4,4,3,4,5,12,1,0,9,10,0,3,7,10,0,0,0,0,6,0,3,9,0,0,1,1
Bojana MILENKOVIC,Serbia,Outside Hitter,Women,Italy,2022-06-15,Pool,1,4,0,0,0,0,0,0,0,0,0,0,0,0,0,0,0,0,0,0,0,0,0,0,0,0,0
Jovana KOCIC,Serbia,Middle Blocker,Women,Italy,2022-06-15,Pool,1,4,0,0,0,0,0,0,0,0,0,0,0,0,0,0,0,0,0,0,0,0,0,0,0,0,0
Sara LOZO,Serbia,Opposite Spiker,Women,Italy,2022-06-15,Pool,1,4,7,6,5,7,18,1,0,3,4,0,2,8,10,8,2,14,24,3,0,0,3,0,0,0,0
Jelena DELIC,Serbia,Middle Blocker,Women,Italy,2022-06-15,Pool,1,4,0,0,0,0,0,0,0,0,0,0,0,0,0,0,0,0,0,0,0,0,0,0,0,0,0
Sanja DJURDJEVIC,Serbia,Libero,Women,Italy,2022-06-15,Pool,1,4,0,0,0,0,0,0,0,0,0,0,0,0,0,0,0,0,0,0,0,0,0,0,0,0,0
Jovana MIROSAVLJEVIC,Serbia,Outside Hitter,Women,Italy,2022-06-15,Pool,1,4,0,0,1,3,4,0,0,0,0,0,0,0,0,0,0,0,0,0,0,0,0,0,0,0,0
Katarina LAZOVIC,Serbia,Outside Hitter,Women,Netherlands,2022-06-05,Pool,3,5,18,17,4,13,34,0,1,2,3,1,0,16,17,12,3,23,38,8,2,5,15,1,0,2,3
Bojana DRCA,Serbia,Setter,Women,Netherlands,2022-06-05,Pool,3,5,6,4,1,4,9,1,2,3,6,1,3,14,18,0,0,0,0,13,4,4,21,56,0,56,112
Sladjana MIRKOVIC,Serbia,Setter,Women,Netherlands,2022-06-05,Pool,3,5,0,0,0,0,0,0,0,0,0,0,0,4,4,0,0,0,0,2,0,0,2,8,0,10,18
Brankica MIHAJLOVIC,Serbia,Outside Hitter,Women,Netherlands,2022-06-05,Pool,3,5,3,3,0,6,9,0,2,0,2,0,0,4,4,0,0,2,2,2,1,0,3,0,0,1,1
Teodora PUSIC,Serbia,Libero,Women,Netherlands,2022-06-05,Pool,3,5,0,0,0,0,0,0,0,0,0,0,0,0,0,5,0,15,20,16,4,3,23,2,0,12,14
Ana BJELICA,Serbia,Opposite Spiker,Women,Netherlands,2022-06-05,Pool,3,5,17,15,8,22,45,1,3,4,8,1,0,12,13,0,0,0,0,14,1,2,17,0,0,2,2
Maja ALEKSIC,Serbia,Middle Blocker,Women,Netherlands,2022-06-05,Pool,3,5,7,6,2,5,13,1,3,5,9,0,2,14,16,0,0,0,0,4,0,3,7,0,0,2,2
Jovana STEVANOVIC,Serbia,Middle Blocker,Women,Netherlands,2022-06-05,Pool,3,5,10,4,1,5,10,5,17,10,32,1,2,15,18,0,0,0,0,3,0,1,4,1,0,0,1
Jovana ZELENOVIC,Serbia,Opposite Spiker,Women,Netherlands,2022-06-05,Pool,3,5,2,2,1,6,9,0,0,2,2,0,0,0,0,0,0,0,0,1,0,0,1,0,0,0,0
Jovana KOCIC,Serbia,Middle Blocker,Women,Netherlands,2022-06-05,Pool,3,5,0,0,0,0,0,0,0,0,0,0,0,0,0,0,0,0,0,0,0,0,0,0,0,0,0
Sara LOZO,Serbia,Opposite Spiker,Women,Netherlands,2022-06-05,Pool,3,5,21,16,4,16,36,4,5,4,13,1,3,12,16,3,2,30,35,14,1,5,20,0,0,3,3
Jelena DELIC,Serbia,Middle Blocker,Women,Netherlands,2022-06-05,Pool,3,5,0,0,0,0,0,0,0,0,0,0,0,0,0,0,0,0,0,0,0,0,0,0,0,0,0
Sanja DJURDJEVIC,Serbia,Libero,Women,Netherlands,2022-06-05,Pool,3,5,0,0,0,0,0,0,0,0,0,0,0,0,0,0,0,0,0,0,0,0,0,0,0,0,0
Jovana MIROSAVLJEVIC,Serbia,Outside Hitter,Women,Netherlands,2022-06-05,Pool,3,5,0,0,0,0,0,0,0,0,0,0,0,0,0,0,0,1,1,0,0,0,0,0,0,0,0
Katarina LAZOVIC,Serbia,Outside Hitter,Women,Bulgaria,2022-06-03,Pool,3,3,12,11,4,4,19,0,4,1,5,1,0,11,12,7,0,13,20,8,2,2,12,0,0,2,2
Bojana DRCA,Serbia,Setter,Women,Bulgaria,2022-06-03,Pool,3,3,2,1,0,1,2,0,3,0,3,1,1,10,12,0,0,1,1,5,3,3,11,14,0,62,76
Sladjana MIRKOVIC,Serbia,Setter,Women,Bulgaria,2022-06-03,Pool,3,3,1,0,0,0,0,0,0,0,0,1,1,2,4,0,0,0,0,2,1,0,3,4,0,15,19
Brankica MIHAJLOVIC,Serbia,Outside Hitter,Women,Bulgaria,2022-06-03,Pool,3,3,0,0,0,0,0,0,0,0,0,0,0,0,0,0,0,0,0,0,0,0,0,0,0,0,0
Teodora PUSIC,Serbia,Libero,Women,Bulgaria,2022-06-03,Pool,3,3,0,0,0,0,0,0,0,0,0,0,0,0,0,4,1,12,17,19,1,0,20,0,0,4,4
Ana BJELICA,Serbia,Opposite Spiker,Women,Bulgaria,2022-06-03,Pool,3,3,17,16,5,18,39,1,3,4,8,0,1,5,6,0,0,0,0,3,1,1,5,0,0,0,0
Maja ALEKSIC,Serbia,Middle Blocker,Women,Bulgaria,2022-06-03,Pool,3,3,7,3,0,4,7,4,3,10,17,0,1,12,13,0,0,0,0,4,1,0,5,0,0,2,2
Jovana STEVANOVIC,Serbia,Middle Blocker,Women,Bulgaria,2022-06-03,Pool,3,3,5,3,1,3,7,1,5,6,12,1,1,12,14,0,0,0,0,1,0,1,2,0,0,3,3
Jovana ZELENOVIC,Serbia,Opposite Spiker,Women,Bulgaria,2022-06-03,Pool,3,3,2,2,3,1,6,0,0,0,0,0,0,0,0,0,0,0,0,0,0,0,0,0,0,1,1
Jovana KOCIC,Serbia,Middle Blocker,Women,Bulgaria,2022-06-03,Pool,3,3,0,0,0,0,0,0,0,0,0,0,0,0,0,0,0,0,0,0,0,0,0,0,0,0,0
Sara LOZO,Serbia,Opposite Spiker,Women,Bulgaria,2022-06-03,Pool,3,3,15,13,2,13,28,2,4,2,8,0,1,12,13,3,2,14,19,6,1,4,11,0,1,3,4
Jelena DELIC,Serbia,Middle Blocker,Women,Bulgaria,2022-06-03,Pool,3,3,0,0,0,0,0,0,0,0,0,0,0,0,0,0,0,0,0,0,0,0,0,0,0,0,0
Sanja DJURDJEVIC,Serbia,Libero,Women,Bulgaria,2022-06-03,Pool,3,3,0,0,0,0,0,0,0,0,0,0,0,0,0,0,0,0,0,0,0,0,0,0,0,0,0
Jovana MIROSAVLJEVIC,Serbia,Outside Hitter,Women,Bulgaria,2022-06-03,Pool,3,3,1,1,0,1,2,0,1,1,2,0,0,2,2,0,0,2,2,0,1,0,1,0,0,0,0
Katarina LAZOVIC,Serbia,Outside Hitter,Women,Thailand,2022-06-02,Pool,2,5,5,4,2,7,13,0,3,1,4,1,0,9,10,0,0,9,9,4,1,2,7,0,0,3,3
Bojana DRCA,Serbia,Setter,Women,Thailand,2022-06-02,Pool,2,5,1,1,0,0,1,0,0,0,0,0,0,6,6,0,0,0,0,4,0,0,4,3,0,21,24
Sladjana MIRKOVIC,Serbia,Setter,Women,Thailand,2022-06-02,Pool,2,5,6,4,0,1,5,1,0,2,3,1,0,16,17,0,0,0,0,0,2,2,4,15,0,98,113
Brankica MIHAJLOVIC,Serbia,Outside Hitter,Women,Thailand,2022-06-02,Pool,2,5,6,5,2,8,15,1,2,2,5,0,1,2,3,1,0,5,6,2,0,2,4,0,1,0,1
Teodora PUSIC,Serbia,Libero,Women,Thailand,2022-06-02,Pool,2,5,0,0,0,0,0,0,0,0,0,0,0,0,0,5,2,17,24,12,5,1,18,0,0,9,9
Ana BJELICA,Serbia,Opposite Spiker,Women,Thailand,2022-06-02,Pool,2,5,6,5,1,14,20,1,0,0,1,0,0,3,3,0,0,0,0,1,0,0,1,0,0,0,0
Maja ALEKSIC,Serbia,Middle Blocker,Women,Thailand,2022-06-02,Pool,2,5,18,11,1,5,17,6,6,4,16,1,2,12,15,0,0,1,1,5,0,0,5,0,0,1,1
Jovana STEVANOVIC,Serbia,Middle Blocker,Women,Thailand,2022-06-02,Pool,2,5,9,4,3,13,20,3,8,10,21,2,0,14,16,0,0,0,0,1,0,0,1,0,0,1,1
Jovana ZELENOVIC,Serbia,Opposite Spiker,Women,Thailand,2022-06-02,Pool,2,5,22,18,6,26,50,2,3,2,7,2,2,10,14,0,0,0,0,3,0,2,5,0,0,0,0
Jovana KOCIC,Serbia,Middle Blocker,Women,Thailand,2022-06-02,Pool,2,5,0,0,0,0,0,0,0,0,0,0,0,0,0,0,0,0,0,0,0,0,0,0,0,0,0
Sara LOZO,Serbia,Opposite Spiker,Women,Thailand,2022-06-02,Pool,2,5,13,11,3,19,33,2,3,3,8,0,1,17,18,16,2,31,49,4,3,0,7,0,0,0,0
Jelena DELIC,Serbia,Middle Blocker,Women,Thailand,2022-06-02,Pool,2,5,0,0,0,0,0,0,0,0,0,0,0,0,0,0,0,0,0,0,0,0,0,0,0,0,0
Sanja DJURDJEVIC,Serbia,Libero,Women,Thailand,2022-06-02,Pool,2,5,0,0,0,0,0,0,0,0,0,0,0,0,0,0,0,0,0,0,0,0,0,0,0,0,0
Jovana MIROSAVLJEVIC,Serbia,Outside Hitter,Women,Thailand,2022-06-02,Pool,2,5,6,4,0,4,8,1,0,0,1,1,0,4,5,2,0,12,14,1,2,0,3,0,0,0,0
Katarina LAZOVIC,Serbia,Outside Hitter,Women,Belgium,2022-06-01,Pool,3,4,13,12,4,17,33,1,4,4,9,0,1,10,11,6,1,10,17,10,6,1,17,0,0,1,1
Bojana DRCA,Serbia,Setter,Women,Belgium,2022-06-01,Pool,3,4,2,1,0,3,4,0,1,1,2,1,0,16,17,0,0,0,0,8,1,4,13,22,1,71,94
Sladjana MIRKOVIC,Serbia,Setter,Women,Belgium,2022-06-01,Pool,3,4,0,0,0,0,0,0,0,0,0,0,0,6,6,0,0,0,0,1,1,1,3,4,0,16,20
Brankica MIHAJLOVIC,Serbia,Outside Hitter,Women,Belgium,2022-06-01,Pool,3,4,1,0,1,3,4,1,0,0,1,0,0,0,0,0,1,1,2,1,0,0,1,0,0,0,0
Teodora PUSIC,Serbia,Libero,Women,Belgium,2022-06-01,Pool,3,4,0,0,0,0,0,0,0,0,0,0,0,0,0,5,1,21,27,11,3,3,17,0,0,10,10
Ana BJELICA,Serbia,Opposite Spiker,Women,Belgium,2022-06-01,Pool,3,4,21,21,4,21,46,0,2,4,6,0,0,9,9,0,0,0,0,5,3,1,9,0,0,0,0
Maja ALEKSIC,Serbia,Middle Blocker,Women,Belgium,2022-06-01,Pool,3,4,11,3,2,1,6,7,4,11,22,1,2,13,16,0,0,1,1,1,0,1,2,0,0,1,1
Jovana STEVANOVIC,Serbia,Middle Blocker,Women,Belgium,2022-06-01,Pool,3,4,4,4,1,6,11,0,8,12,20,0,0,11,11,0,0,0,0,6,1,0,7,0,0,1,1
Jovana ZELENOVIC,Serbia,Opposite Spiker,Women,Belgium,2022-06-01,Pool,3,4,4,3,0,4,7,1,2,2,5,0,0,0,0,0,0,0,0,0,1,0,1,0,0,0,0
Jovana KOCIC,Serbia,Middle Blocker,Women,Belgium,2022-06-01,Pool,3,4,0,0,0,0,0,0,0,0,0,0,0,0,0,0,0,0,0,0,0,0,0,0,0,0,0
Sara LOZO,Serbia,Opposite Spiker,Women,Belgium,2022-06-01,Pool,3,4,19,18,4,15,37,0,2,4,6,1,1,16,18,9,2,15,26,8,5,0,13,0,0,0,0
Jelena DELIC,Serbia,Middle Blocker,Women,Belgium,2022-06-01,Pool,3,4,0,0,0,0,0,0,0,0,0,0,0,0,0,0,0,0,0,0,0,0,0,0,0,0,0
Sanja DJURDJEVIC,Serbia,Libero,Women,Belgium,2022-06-01,Pool,3,4,0,0,0,0,0,0,0,0,0,0,0,0,0,0,0,0,0,0,0,0,0,0,0,0,0
Jovana MIROSAVLJEVIC,Serbia,Outside Hitter,Women,Belgium,2022-06-01,Pool,3,4,0,0,0,0,0,0,0,0,0,0,0,0,0,0,0,0,0,0,0,0,0,0,0,0,0
Wipawee SRITHONG,Thailand,Outside Hitter,Women,United States,2022-06-19,Pool,1,4,0,0,0,0,0,0,0,0,0,0,0,0,0,0,0,0,0,0,0,0,0,0,0,0,0
Piyanut PANNOY,Thailand,Libero,Women,United States,2022-06-19,Pool,1,4,0,0,0,0,0,0,0,0,0,0,0,0,0,4,1,12,17,7,3,2,12,1,1,12,14
Pornpun GUEDPARD,Thailand,Setter,Women,United States,2022-06-19,Pool,1,4,3,2,0,0,2,0,4,3,7,1,0,10,11,0,0,1,1,14,3,2,19,22,0,85,107
Kannika THIPACHOT,Thailand,Outside Hitter,Women,United States,2022-06-19,Pool,1,4,0,0,0,0,0,0,0,0,0,0,0,0,0,0,0,0,0,0,0,0,0,0,0,0,0
Jarasporn BUNDASAK,Thailand,Middle Blocker,Women,United States,2022-06-19,Pool,1,4,0,0,2,7,9,0,6,2,8,0,0,17,17,0,0,0,0,2,1,1,4,0,0,4,4
Khatthalee PINSUWAN,Thailand,Outside Hitter,Women,United States,2022-06-19,Pool,1,4,0,0,0,0,0,0,0,0,0,0,0,0,0,0,0,0,0,0,0,0,0,0,0,0,0
Kaewkalaya KAMULTHALA,Thailand,Middle Blocker,Women,United States,2022-06-19,Pool,1,4,3,3,0,5,8,0,3,7,10,0,2,7,9,1,0,0,1,2,0,2,4,1,0,0,1
Pimpichaya KOKRAM,Thailand,Opposite Spiker,Women,United States,2022-06-19,Pool,1,4,8,8,8,15,31,0,4,2,6,0,0,11,11,1,0,6,7,8,1,3,12,0,0,0,0
Tichaya BOONLERT,Thailand,Setter,Women,United States,2022-06-19,Pool,1,4,0,0,0,0,0,0,0,0,0,0,0,0,0,0,0,0,0,0,0,0,0,0,0,0,0
Ajcharaporn KONGYOT,Thailand,Outside Hitter,Women,United States,2022-06-19,Pool,1,4,25,24,7,21,52,1,1,6,8,0,0,10,10,3,1,12,16,11,3,3,17,0,0,0,0
Chatchu-On MOKSRI,Thailand,Outside Hitter,Women,United States,2022-06-19,Pool,1,4,13,10,3,22,35,1,4,1,6,2,2,18,22,12,3,22,37,12,3,2,17,0,1,4,5
Thanacha SOOKSOD,Thailand,Opposite Spiker,Women,United States,2022-06-19,Pool,1,4,0,0,0,0,0,0,0,0,0,0,0,0,0,0,0,0,0,0,0,0,0,0,0,0,0
Nattaporn SANITKLANG,Thailand,Libero,Women,United States,2022-06-19,Pool,1,4,0,0,0,0,0,0,0,0,0,0,0,0,0,0,0,0,0,9,1,1,11,0,0,7,7
Sirima MANAKIJ,Thailand,Setter,Women,United States,2022-06-19,Pool,1,4,0,0,0,0,0,0,0,0,0,0,0,0,0,0,0,0,0,0,0,1,1,0,0,1,1
Wipawee SRITHONG,Thailand,Outside Hitter,Women,Japan,2022-06-17,Pool,0,3,0,0,0,0,0,0,0,0,0,0,0,0,0,0,0,0,0,0,0,0,0,0,0,0,0
Piyanut PANNOY,Thailand,Libero,Women,Japan,2022-06-17,Pool,0,3,0,0,0,0,0,0,0,0,0,0,0,0,0,2,0,2,4,6,0,1,7,0,2,8,10
Pornpun GUEDPARD,Thailand,Setter,Women,Japan,2022-06-17,Pool,0,3,2,1,0,2,3,1,3,5,9,0,1,8,9,0,0,0,0,4,5,1,10,31,2,56,89
Kannika THIPACHOT,Thailand,Outside Hitter,Women,Japan,2022-06-17,Pool,0,3,0,0,0,0,0,0,0,0,0,0,0,0,0,0,0,0,0,0,0,0,0,0,0,0,0
Jarasporn BUNDASAK,Thailand,Middle Blocker,Women,Japan,2022-06-17,Pool,0,3,5,5,1,2,8,0,5,4,9,0,0,10,10,0,0,1,1,0,0,0,0,0,0,1,1
Khatthalee PINSUWAN,Thailand,Outside Hitter,Women,Japan,2022-06-17,Pool,0,3,0,0,1,2,3,0,0,0,0,0,0,0,0,0,0,0,0,1,0,0,1,0,0,0,0
Kaewkalaya KAMULTHALA,Thailand,Middle Blocker,Women,Japan,2022-06-17,Pool,0,3,4,3,0,14,17,1,3,10,14,0,0,8,8,1,0,1,2,6,0,0,6,1,0,0,1
Pimpichaya KOKRAM,Thailand,Opposite Spiker,Women,Japan,2022-06-17,Pool,0,3,8,8,6,15,29,0,3,3,6,0,1,9,10,3,0,3,6,14,1,1,16,0,0,1,1
Tichaya BOONLERT,Thailand,Setter,Women,Japan,2022-06-17,Pool,0,3,0,0,0,0,0,0,0,0,0,0,0,0,0,0,0,0,0,0,0,0,0,3,0,4,7
Ajcharaporn KONGYOT,Thailand,Outside Hitter,Women,Japan,2022-06-17,Pool,0,3,10,8,2,21,31,2,0,1,3,0,1,7,8,6,0,9,15,9,7,1,17,0,0,1,1
Chatchu-On MOKSRI,Thailand,Outside Hitter,Women,Japan,2022-06-17,Pool,0,3,11,9,3,13,25,2,1,2,5,0,3,5,8,13,0,25,38,10,3,0,13,0,0,2,2
Thanacha SOOKSOD,Thailand,Opposite Spiker,Women,Japan,2022-06-17,Pool,0,3,0,0,0,2,2,0,1,0,1,0,1,0,1,0,0,0,0,0,0,0,0,0,0,0,0
Nattaporn SANITKLANG,Thailand,Libero,Women,Japan,2022-06-17,Pool,0,3,0,0,0,0,0,0,0,0,0,0,0,0,0,0,0,0,0,3,0,1,4,0,0,4,4
Wipawee SRITHONG,Thailand,Outside Hitter,Women,Poland,2022-06-16,Pool,2,5,0,0,1,0,1,0,0,0,0,0,0,3,3,1,0,1,2,1,1,0,2,0,0,1,1
Pornpun GUEDPARD,Thailand,Setter,Women,Poland,2022-06-16,Pool,2,5,1,0,1,3,4,0,2,6,8,1,0,21,22,0,0,0,0,10,2,0,12,19,1,97,117
Kannika THIPACHOT,Thailand,Outside Hitter,Women,Poland,2022-06-16,Pool,2,5,2,1,0,1,2,1,0,0,1,0,0,2,2,0,0,0,0,1,1,0,2,0,0,0,0
Jarasporn BUNDASAK,Thailand,Middle Blocker,Women,Poland,2022-06-16,Pool,2,5,9,4,1,3,8,3,4,5,12,2,0,16,18,0,2,0,2,1,0,1,2,0,0,1,1
Khatthalee PINSUWAN,Thailand,Outside Hitter,Women,Poland,2022-06-16,Pool,2,5,0,0,0,0,0,0,0,0,0,0,0,0,0,0,0,1,1,1,0,1,2,0,0,1,1
Kaewkalaya KAMULTHALA,Thailand,Middle Blocker,Women,Poland,2022-06-16,Pool,2,5,1,1,2,6,9,0,11,13,24,0,2,11,13,0,0,1,1,2,2,1,5,1,0,3,4
Pimpichaya KOKRAM,Thailand,Opposite Spiker,Women,Poland,2022-06-16,Pool,2,5,13,12,3,15,30,0,1,7,8,1,2,12,15,0,0,0,0,12,0,1,13,0,1,2,3
Tichaya BOONLERT,Thailand,Setter,Women,Poland,2022-06-16,Pool,2,5,0,0,0,0,0,0,0,0,0,0,0,0,0,0,0,0,0,0,0,0,0,0,0,0,0
Ajcharaporn KONGYOT,Thailand,Outside Hitter,Women,Poland,2022-06-16,Pool,2,5,9,9,7,24,40,0,0,2,2,0,0,8,8,6,0,9,15,15,2,4,21,0,0,5,5
Chatchu-On MOKSRI,Thailand,Outside Hitter,Women,Poland,2022-06-16,Pool,2,5,26,20,5,27,52,5,4,3,12,1,3,11,15,15,2,42,59,11,1,3,15,0,0,2,2
Thanacha SOOKSOD,Thailand,Opposite Spiker,Women,Poland,2022-06-16,Pool,2,5,5,5,4,4,13,0,1,0,1,0,1,2,3,0,0,1,1,2,2,0,4,0,0,2,2
Nattaporn SANITKLANG,Thailand,Libero,Women,Poland,2022-06-16,Pool,2,5,0,0,0,0,0,0,0,0,0,0,0,0,0,1,3,12,16,11,3,3,17,0,0,11,11
Sirima MANAKIJ,Thailand,Setter,Women,Poland,2022-06-16,Pool,2,5,0,0,0,0,0,0,0,0,0,0,0,0,0,0,0,0,0,2,0,0,2,1,0,5,6
Piyanut PANNOY,Thailand,Libero,Women,Türkiye,2022-07-14,Quarterfinals,1,4,0,0,0,0,0,0,0,0,0,0,0,0,0,5,1,10,16,2,1,4,7,0,0,6,6
Pornpun GUEDPARD,Thailand,Setter,Women,Türkiye,2022-07-14,Quarterfinals,1,4,4,2,0,1,3,2,1,3,6,0,1,8,9,0,1,0,1,4,6,3,13,28,0,74,102
Jarasporn BUNDASAK,Thailand,Middle Blocker,Women,Türkiye,2022-07-14,Quarterfinals,1,4,0,0,1,1,2,0,5,3,8,0,1,9,10,0,0,0,0,1,1,0,2,0,1,1,2
Hattaya BAMRUNGSUK,Thailand,Middle Blocker,Women,Türkiye,2022-07-14,Quarterfinals,1,4,6,4,2,4,10,1,4,4,9,1,3,8,12,0,0,0,0,4,0,3,7,0,0,0,0
Sutadta CHUEWULIM,Thailand,Outside Hitter,Women,Türkiye,2022-07-14,Quarterfinals,1,4,0,0,0,0,0,0,0,0,0,0,0,0,0,0,0,0,0,0,0,0,0,0,0,0,0
Kaewkalaya KAMULTHALA,Thailand,Middle Blocker,Women,Türkiye,2022-07-14,Quarterfinals,1,4,0,0,0,2,2,0,3,1,4,0,0,3,3,1,0,0,1,1,2,0,3,0,0,0,0
Pimpichaya KOKRAM,Thailand,Opposite Spiker,Women,Türkiye,2022-07-14,Quarterfinals,1,4,10,8,5,12,25,1,0,1,2,1,1,12,14,0,0,0,0,5,6,3,14,0,0,2,2
Tichaya BOONLERT,Thailand,Setter,Women,Türkiye,2022-07-14,Quarterfinals,1,4,0,0,0,0,0,0,0,0,0,0,0,0,0,0,0,0,0,0,0,0,0,0,0,0,0
Ajcharaporn KONGYOT,Thailand,Outside Hitter,Women,Türkiye,2022-07-14,Quarterfinals,1,4,21,20,6,18,44,0,2,3,5,1,0,18,19,1,1,14,16,5,2,5,12,0,0,1,1
Chatchu-On MOKSRI,Thailand,Outside Hitter,Women,Türkiye,2022-07-14,Quarterfinals,1,4,16,16,8,14,38,0,2,1,3,0,3,8,11,17,3,31,51,6,3,3,12,0,0,0,0
Supattra PAIROJ,Thailand,Libero,Women,Türkiye,2022-07-14,Quarterfinals,1,4,0,0,0,0,0,0,0,0,0,0,0,0,0,0,0,0,0,7,9,3,19,0,0,5,5
Thanacha SOOKSOD,Thailand,Opposite Spiker,Women,Türkiye,2022-07-14,Quarterfinals,1,4,1,1,0,0,1,0,0,0,0,0,0,1,1,0,0,0,0,0,0,0,0,0,0,0,0
Sirima MANAKIJ,Thailand,Setter,Women,Türkiye,2022-07-14,Quarterfinals,1,4,0,0,0,0,0,0,0,0,0,0,0,0,0,0,0,0,0,0,1,0,1,0,0,3,3
Sasipapron JANTHAWISUT,Thailand,Outside Hitter,Women,Türkiye,2022-07-14,Quarterfinals,1,4,0,0,1,2,3,0,0,0,0,0,0,1,1,0,0,1,1,1,0,1,2,0,0,0,0
Piyanut PANNOY,Thailand,Libero,Women,Italy,2022-07-03,Pool,0,3,0,0,0,0,0,0,0,0,0,0,0,0,0,5,0,2,7,2,1,0,3,0,0,2,2
Pornpun GUEDPARD,Thailand,Setter,Women,Italy,2022-07-03,Pool,0,3,0,0,0,0,0,0,0,0,0,0,0,8,8,0,0,1,1,1,1,1,3,7,1,70,78
Jarasporn BUNDASAK,Thailand,Middle Blocker,Women,Italy,2022-07-03,Pool,0,3,1,1,0,1,2,0,0,0,0,0,0,4,4,0,0,0,0,0,0,0,0,0,0,0,0
Hattaya BAMRUNGSUK,Thailand,Middle Blocker,Women,Italy,2022-07-03,Pool,0,3,5,5,1,7,13,0,3,3,6,0,0,10,10,0,0,0,0,3,0,1,4,0,0,0,0
Sutadta CHUEWULIM,Thailand,Outside Hitter,Women,Italy,2022-07-03,Pool,0,3,0,0,0,1,1,0,0,0,0,0,0,1,1,0,0,0,0,1,1,1,3,0,0,0,0
Kaewkalaya KAMULTHALA,Thailand,Middle Blocker,Women,Italy,2022-07-03,Pool,0,3,2,2,0,1,3,0,0,0,0,0,0,3,3,0,0,0,0,1,0,0,1,0,0,0,0
Pimpichaya KOKRAM,Thailand,Opposite Spiker,Women,Italy,2022-07-03,Pool,0,3,8,8,7,14,29,0,0,0,0,0,1,4,5,0,0,1,1,3,0,2,5,0,0,2,2
Ajcharaporn KONGYOT,Thailand,Outside Hitter,Women,Italy,2022-07-03,Pool,0,3,4,4,1,15,20,0,2,0,2,0,0,6,6,2,1,12,15,5,1,1,7,0,0,1,1
Chatchu-On MOKSRI,Thailand,Outside Hitter,Women,Italy,2022-07-03,Pool,0,3,10,10,4,6,20,0,3,0,3,0,2,4,6,7,5,22,34,6,2,3,11,0,0,0,0
Supattra PAIROJ,Thailand,Libero,Women,Italy,2022-07-03,Pool,0,3,0,0,0,0,0,0,0,0,0,0,0,0,0,0,0,0,0,1,3,0,4,0,0,0,0
Thanacha SOOKSOD,Thailand,Opposite Spiker,Women,Italy,2022-07-03,Pool,0,3,2,2,0,1,3,0,1,0,1,0,0,1,1,0,0,0,0,0,0,0,0,0,0,0,0
Sirima MANAKIJ,Thailand,Setter,Women,Italy,2022-07-03,Pool,0,3,0,0,0,0,0,0,0,0,0,0,0,2,2,0,0,0,0,1,0,0,1,1,0,13,14
Tichakorn BOONLERT,Thailand,Middle Blocker,Women,Italy,2022-07-03,Pool,0,3,0,0,0,2,2,0,1,1,2,0,0,3,3,0,0,0,0,1,1,0,2,0,0,0,0
Sasipapron JANTHAWISUT,Thailand,Outside Hitter,Women,Italy,2022-07-03,Pool,0,3,2,2,1,1,4,0,0,0,0,0,0,1,1,2,1,5,8,1,0,0,1,0,0,0,0
Piyanut PANNOY,Thailand,Libero,Women,Brazil,2022-07-02,Pool,1,4,0,0,0,0,0,0,0,0,0,0,0,0,0,6,0,9,15,7,3,6,16,0,0,5,5
Pornpun GUEDPARD,Thailand,Setter,Women,Brazil,2022-07-02,Pool,1,4,2,1,0,2,3,1,7,4,12,0,1,13,14,0,0,0,0,3,1,0,4,19,2,108,129
Jarasporn BUNDASAK,Thailand,Middle Blocker,Women,Brazil,2022-07-02,Pool,1,4,1,1,2,0,3,0,1,0,1,0,1,1,2,0,0,0,0,0,0,0,0,0,0,0,0
Hattaya BAMRUNGSUK,Thailand,Middle Blocker,Women,Brazil,2022-07-02,Pool,1,4,10,8,2,6,16,2,5,6,13,0,2,13,15,0,0,0,0,1,1,1,3,0,0,0,0
Sutadta CHUEWULIM,Thailand,Outside Hitter,Women,Brazil,2022-07-02,Pool,1,4,0,0,0,0,0,0,0,0,0,0,0,0,0,0,0,0,0,0,0,0,0,0,0,0,0
Kaewkalaya KAMULTHALA,Thailand,Middle Blocker,Women,Brazil,2022-07-02,Pool,1,4,7,5,0,3,8,1,3,3,7,1,2,9,12,0,0,0,0,2,1,1,4,0,0,0,0
Pimpichaya KOKRAM,Thailand,Opposite Spiker,Women,Brazil,2022-07-02,Pool,1,4,23,22,7,16,45,1,5,0,6,0,0,16,16,0,0,0,0,4,0,2,6,0,1,0,1
Ajcharaporn KONGYOT,Thailand,Outside Hitter,Women,Brazil,2022-07-02,Pool,1,4,16,14,6,19,39,0,0,0,0,2,0,12,14,13,0,31,44,9,1,2,12,0,0,1,1
Chatchu-On MOKSRI,Thailand,Outside Hitter,Women,Brazil,2022-07-02,Pool,1,4,14,12,4,13,29,2,1,1,4,0,4,11,15,12,1,22,35,14,2,2,18,0,0,0,0
Supattra PAIROJ,Thailand,Libero,Women,Brazil,2022-07-02,Pool,1,4,0,0,0,0,0,0,0,0,0,0,0,0,0,0,0,0,0,1,2,1,4,0,0,1,1
Thanacha SOOKSOD,Thailand,Opposite Spiker,Women,Brazil,2022-07-02,Pool,1,4,0,0,2,0,2,0,0,0,0,0,1,0,1,0,0,0,0,0,0,0,0,0,0,1,1
Sirima MANAKIJ,Thailand,Setter,Women,Brazil,2022-07-02,Pool,1,4,1,0,0,0,0,0,0,0,0,1,0,1,2,0,0,0,0,0,0,0,0,0,0,2,2
Tichakorn BOONLERT,Thailand,Middle Blocker,Women,Brazil,2022-07-02,Pool,1,4,0,0,0,0,0,0,0,0,0,0,0,0,0,0,0,0,0,0,0,0,0,0,0,0,0
Sasipapron JANTHAWISUT,Thailand,Outside Hitter,Women,Brazil,2022-07-02,Pool,1,4,0,0,0,0,0,0,0,0,0,0,0,0,0,0,0,0,0,0,0,0,0,0,0,0,0
Piyanut PANNOY,Thailand,Libero,Women,Dominican Republic,2022-06-30,Pool,1,4,0,0,0,0,0,0,0,0,0,0,0,0,0,5,1,9,15,5,1,7,13,6,0,0,6
Pornpun GUEDPARD,Thailand,Setter,Women,Dominican Republic,2022-06-30,Pool,1,4,0,0,1,3,4,0,6,1,7,0,2,6,8,0,0,0,0,6,4,6,16,93,0,1,94
Jarasporn BUNDASAK,Thailand,Middle Blocker,Women,Dominican Republic,2022-06-30,Pool,1,4,7,4,0,1,5,2,2,2,6,1,1,15,17,1,0,0,1,0,1,0,1,1,0,1,2
Hattaya BAMRUNGSUK,Thailand,Middle Blocker,Women,Dominican Republic,2022-06-30,Pool,1,4,5,3,1,4,8,2,11,2,15,0,1,9,10,0,0,0,0,2,0,2,4,0,1,0,1
Sutadta CHUEWULIM,Thailand,Outside Hitter,Women,Dominican Republic,2022-06-30,Pool,1,4,0,0,0,0,0,0,0,0,0,0,1,1,2,1,0,1,2,1,1,3,5,0,0,0,0
Kaewkalaya KAMULTHALA,Thailand,Middle Blocker,Women,Dominican Republic,2022-06-30,Pool,1,4,0,0,0,0,0,0,0,0,0,0,0,0,0,0,0,0,0,0,0,0,0,0,0,0,0
Pimpichaya KOKRAM,Thailand,Opposite Spiker,Women,Dominican Republic,2022-06-30,Pool,1,4,30,26,4,17,47,1,3,2,6,3,1,17,21,0,0,0,0,4,1,3,8,2,2,1,5
Ajcharaporn KONGYOT,Thailand,Outside Hitter,Women,Dominican Republic,2022-06-30,Pool,1,4,15,14,4,17,35,1,2,1,4,0,1,9,10,5,3,19,27,7,1,3,11,1,0,0,1
Chatchu-On MOKSRI,Thailand,Outside Hitter,Women,Dominican Republic,2022-06-30,Pool,1,4,9,7,4,19,30,0,2,0,2,2,3,15,20,9,0,31,40,7,3,1,11,3,0,1,4
Supattra PAIROJ,Thailand,Libero,Women,Dominican Republic,2022-06-30,Pool,1,4,0,0,0,0,0,0,0,0,0,0,0,0,0,0,0,0,0,11,1,0,12,3,0,0,3
Thanacha SOOKSOD,Thailand,Opposite Spiker,Women,Dominican Republic,2022-06-30,Pool,1,4,2,2,0,1,3,0,1,0,1,0,0,2,2,0,0,0,0,0,1,0,1,1,0,0,1
Sirima MANAKIJ,Thailand,Setter,Women,Dominican Republic,2022-06-30,Pool,1,4,0,0,0,0,0,0,0,0,0,0,0,1,1,0,0,0,0,0,0,0,0,4,0,0,4
Tichakorn BOONLERT,Thailand,Middle Blocker,Women,Dominican Republic,2022-06-30,Pool,1,4,0,0,0,0,0,0,0,0,0,0,1,1,2,0,0,0,0,0,0,0,0,1,0,0,1
Sasipapron JANTHAWISUT,Thailand,Outside Hitter,Women,Dominican Republic,2022-06-30,Pool,1,4,0,0,0,0,0,0,0,0,0,0,0,0,0,0,0,0,0,0,0,0,0,0,0,0,0
Piyanut PANNOY,Thailand,Libero,Women,Korea,2022-06-29,Pool,3,3,0,0,0,0,0,0,0,0,0,0,0,0,0,1,0,10,11,3,0,0,3,1,0,0,1
Pornpun GUEDPARD,Thailand,Setter,Women,Korea,2022-06-29,Pool,3,3,5,3,0,0,3,2,0,4,6,0,1,16,17,0,0,0,0,3,0,1,4,66,0,2,68
Jarasporn BUNDASAK,Thailand,Middle Blocker,Women,Korea,2022-06-29,Pool,3,3,6,4,2,1,7,2,3,2,7,0,0,12,12,0,0,1,1,1,0,0,1,0,0,0,0
Hattaya BAMRUNGSUK,Thailand,Middle Blocker,Women,Korea,2022-06-29,Pool,3,3,5,3,0,2,5,2,3,2,7,0,2,9,11,0,0,0,0,1,1,0,2,2,0,0,2
Sutadta CHUEWULIM,Thailand,Outside Hitter,Women,Korea,2022-06-29,Pool,3,3,0,0,0,0,0,0,0,0,0,0,0,0,0,0,0,0,0,0,0,0,0,0,0,0,0
Kaewkalaya KAMULTHALA,Thailand,Middle Blocker,Women,Korea,2022-06-29,Pool,3,3,0,0,0,0,0,0,0,0,0,0,0,0,0,0,0,0,0,0,0,0,0,0,0,0,0
Pimpichaya KOKRAM,Thailand,Opposite Spiker,Women,Korea,2022-06-29,Pool,3,3,11,7,2,11,20,4,2,3,9,0,0,11,11,0,0,0,0,3,1,0,4,1,0,0,1
Ajcharaporn KONGYOT,Thailand,Outside Hitter,Women,Korea,2022-06-29,Pool,3,3,13,11,3,12,26,2,3,3,8,0,1,7,8,0,0,11,11,7,3,1,11,1,0,0,1
Chatchu-On MOKSRI,Thailand,Outside Hitter,Women,Korea,2022-06-29,Pool,3,3,14,8,3,9,20,5,4,1,10,1,2,12,15,6,1,13,20,4,0,1,5,3,0,1,4
Supattra PAIROJ,Thailand,Libero,Women,Korea,2022-06-29,Pool,3,3,0,0,0,0,0,0,0,0,0,0,0,0,0,0,0,0,0,5,2,3,10,0,0,1,1
Thanacha SOOKSOD,Thailand,Opposite Spiker,Women,Korea,2022-06-29,Pool,3,3,0,0,0,0,0,0,0,0,0,0,0,0,0,0,0,0,0,0,0,0,0,0,0,0,0
Sirima MANAKIJ,Thailand,Setter,Women,Korea,2022-06-29,Pool,3,3,0,0,0,0,0,0,0,0,0,0,0,0,0,0,0,0,0,0,0,0,0,0,0,0,0
Tichakorn BOONLERT,Thailand,Middle Blocker,Women,Korea,2022-06-29,Pool,3,3,0,0,0,0,0,0,0,0,0,0,0,0,0,0,0,0,0,0,0,0,0,0,0,0,0
Sasipapron JANTHAWISUT,Thailand,Outside Hitter,Women,Korea,2022-06-29,Pool,3,3,0,0,0,0,0,0,0,0,0,0,0,0,0,0,0,0,0,0,0,0,0,0,0,0,0
Piyanut PANNOY,Thailand,Libero,Women,China,2022-06-05,Pool,3,5,0,0,0,0,0,0,0,0,0,0,0,0,0,11,1,10,22,6,1,3,10,2,1,7,10
Pornpun GUEDPARD,Thailand,Setter,Women,China,2022-06-05,Pool,3,5,1,1,0,2,3,0,2,2,4,0,2,9,11,0,0,0,0,8,5,2,15,64,2,42,108
Hattaya BAMRUNGSUK,Thailand,Middle Blocker,Women,China,2022-06-05,Pool,3,5,4,2,0,4,6,1,8,6,15,1,1,14,16,0,0,2,2,6,0,3,9,1,0,1,2
Sutadta CHUEWULIM,Thailand,Outside Hitter,Women,China,2022-06-05,Pool,3,5,0,0,0,0,0,0,0,0,0,0,0,0,0,0,0,0,0,0,0,0,0,0,0,0,0
Kaewkalaya KAMULTHALA,Thailand,Middle Blocker,Women,China,2022-06-05,Pool,3,5,3,1,0,4,5,2,4,8,14,0,1,18,19,0,2,1,3,1,3,4,8,2,0,2,4
Pimpichaya KOKRAM,Thailand,Opposite Spiker,Women,China,2022-06-05,Pool,3,5,29,27,5,23,55,1,2,6,9,1,3,10,14,3,0,4,7,6,0,2,8,2,0,1,3
Tichaya BOONLERT,Thailand,Setter,Women,China,2022-06-05,Pool,3,5,0,0,0,0,0,0,1,0,1,0,1,0,1,0,0,0,0,1,0,0,1,4,0,5,9
Ajcharaporn KONGYOT,Thailand,Outside Hitter,Women,China,2022-06-05,Pool,3,5,8,8,1,7,16,0,1,2,3,0,0,5,5,1,0,11,12,6,0,1,7,1,0,0,1
Chatchu-On MOKSRI,Thailand,Outside Hitter,Women,China,2022-06-05,Pool,3,5,18,16,5,18,39,2,2,4,8,0,2,15,17,8,2,33,43,11,3,3,17,2,0,5,7
Supattra PAIROJ,Thailand,Libero,Women,China,2022-06-05,Pool,3,5,0,0,0,0,0,0,0,0,0,0,0,0,0,0,0,0,0,7,1,1,9,1,0,0,1
Thanacha SOOKSOD,Thailand,Opposite Spiker,Women,China,2022-06-05,Pool,3,5,2,2,0,0,2,0,1,0,1,0,0,0,0,0,0,1,1,0,0,0,0,0,0,0,0
Tichakorn BOONLERT,Thailand,Middle Blocker,Women,China,2022-06-05,Pool,3,5,1,1,1,2,4,0,1,0,1,0,0,2,2,0,0,0,0,1,0,0,1,0,0,0,0
Sasipapron JANTHAWISUT,Thailand,Outside Hitter,Women,China,2022-06-05,Pool,3,5,6,6,2,8,16,0,1,1,2,0,3,3,6,3,2,10,15,3,5,3,11,2,0,2,4
Piyanut PANNOY,Thailand,Libero,Women,Belgium,2022-06-04,Pool,2,5,0,0,0,0,0,0,0,0,0,0,0,0,0,4,1,11,16,12,2,4,18,9,1,6,16
Pornpun GUEDPARD,Thailand,Setter,Women,Belgium,2022-06-04,Pool,2,5,3,3,0,0,3,0,1,6,7,0,1,16,17,0,1,0,1,6,0,3,9,80,1,52,133
Thatdao NUEKJANG,Thailand,Middle Blocker,Women,Belgium,2022-06-04,Pool,2,5,1,1,0,2,3,0,1,2,3,0,2,1,3,0,0,0,0,3,0,0,3,0,0,0,0
Hattaya BAMRUNGSUK,Thailand,Middle Blocker,Women,Belgium,2022-06-04,Pool,2,5,8,5,2,5,12,3,7,10,20,0,0,20,20,0,0,1,1,7,1,2,10,0,0,2,2
Sutadta CHUEWULIM,Thailand,Outside Hitter,Women,Belgium,2022-06-04,Pool,2,5,0,0,0,0,0,0,0,0,0,0,0,1,1,0,0,1,1,1,0,0,1,0,0,2,2
Kaewkalaya KAMULTHALA,Thailand,Middle Blocker,Women,Belgium,2022-06-04,Pool,2,5,0,0,0,4,4,0,2,2,4,0,1,4,5,0,0,0,0,0,0,1,1,0,0,2,2
Pimpichaya KOKRAM,Thailand,Opposite Spiker,Women,Belgium,2022-06-04,Pool,2,5,24,21,9,21,51,2,1,2,5,1,1,19,21,0,0,0,0,15,3,3,21,1,0,2,3
Tichaya BOONLERT,Thailand,Setter,Women,Belgium,2022-06-04,Pool,2,5,0,0,0,0,0,0,0,0,0,0,0,0,0,0,0,0,0,0,0,0,0,4,0,4,8
Ajcharaporn KONGYOT,Thailand,Outside Hitter,Women,Belgium,2022-06-04,Pool,2,5,16,16,3,21,40,0,2,6,8,0,2,14,16,8,2,21,31,21,2,0,23,2,0,1,3
Chatchu-On MOKSRI,Thailand,Outside Hitter,Women,Belgium,2022-06-04,Pool,2,5,28,21,7,23,51,6,3,4,13,1,1,14,16,12,2,33,47,13,5,0,18,0,0,1,1
Supattra PAIROJ,Thailand,Libero,Women,Belgium,2022-06-04,Pool,2,5,0,0,0,0,0,0,0,0,0,0,0,0,0,0,0,0,0,2,2,0,4,0,0,0,0
Thanacha SOOKSOD,Thailand,Opposite Spiker,Women,Belgium,2022-06-04,Pool,2,5,2,2,0,1,3,0,0,2,2,0,1,0,1,0,0,0,0,0,0,0,0,1,0,0,1
Tichakorn BOONLERT,Thailand,Middle Blocker,Women,Belgium,2022-06-04,Pool,2,5,1,1,0,1,2,0,3,5,8,0,1,5,6,0,0,1,1,1,0,1,2,0,0,0,0
Sasipapron JANTHAWISUT,Thailand,Outside Hitter,Women,Belgium,2022-06-04,Pool,2,5,0,0,0,0,0,0,0,0,0,0,0,0,0,0,0,0,0,0,0,0,0,0,0,0,0
Piyanut PANNOY,Thailand,Libero,Women,Serbia,2022-06-02,Pool,3,5,0,0,0,0,0,0,0,0,0,0,0,0,0,8,1,9,18,9,3,4,16,0,0,4,4
Pornpun GUEDPARD,Thailand,Setter,Women,Serbia,2022-06-02,Pool,3,5,3,0,1,2,3,1,1,2,4,2,0,14,16,0,0,0,0,1,4,3,8,40,0,117,157
Thatdao NUEKJANG,Thailand,Middle Blocker,Women,Serbia,2022-06-02,Pool,3,5,10,6,2,4,12,3,6,2,11,1,1,18,20,0,0,0,0,0,1,1,2,0,0,2,2
Hattaya BAMRUNGSUK,Thailand,Middle Blocker,Women,Serbia,2022-06-02,Pool,3,5,10,9,1,13,23,1,2,8,11,0,2,11,13,1,0,1,2,3,3,1,7,0,0,0,0
Sutadta CHUEWULIM,Thailand,Outside Hitter,Women,Serbia,2022-06-02,Pool,3,5,0,0,0,0,0,0,0,0,0,0,0,0,0,0,0,3,3,0,0,0,0,0,0,0,0
Kaewkalaya KAMULTHALA,Thailand,Middle Blocker,Women,Serbia,2022-06-02,Pool,3,5,0,0,0,0,0,0,0,0,0,0,0,0,0,0,0,0,0,0,0,0,0,0,0,0,0
Pimpichaya KOKRAM,Thailand,Opposite Spiker,Women,Serbia,2022-06-02,Pool,3,5,32,31,7,19,57,0,2,4,6,1,0,17,18,0,0,2,2,6,3,5,14,0,0,0,0
Tichaya BOONLERT,Thailand,Setter,Women,Serbia,2022-06-02,Pool,3,5,0,0,0,0,0,0,0,0,0,0,1,0,1,0,0,0,0,0,0,0,0,0,0,0,0
Ajcharaporn KONGYOT,Thailand,Outside Hitter,Women,Serbia,2022-06-02,Pool,3,5,14,11,9,17,37,3,3,3,9,0,1,24,25,12,5,43,60,9,1,0,10,0,0,0,0
Chatchu-On MOKSRI,Thailand,Outside Hitter,Women,Serbia,2022-06-02,Pool,3,5,28,24,4,21,49,4,4,2,10,0,2,15,17,4,2,10,16,8,3,3,14,0,0,1,1
Supattra PAIROJ,Thailand,Libero,Women,Serbia,2022-06-02,Pool,3,5,0,0,0,0,0,0,0,0,0,0,0,0,0,0,0,0,0,3,1,0,4,0,0,0,0
Thanacha SOOKSOD,Thailand,Opposite Spiker,Women,Serbia,2022-06-02,Pool,3,5,0,0,0,0,0,0,0,0,0,0,0,0,0,0,0,0,0,0,0,0,0,0,0,0,0
Tichakorn BOONLERT,Thailand,Middle Blocker,Women,Serbia,2022-06-02,Pool,3,5,0,0,0,0,0,0,0,0,0,0,0,0,0,0,0,0,0,0,0,0,0,0,0,0,0
Sasipapron JANTHAWISUT,Thailand,Outside Hitter,Women,Serbia,2022-06-02,Pool,3,5,0,0,0,0,0,0,0,0,0,0,0,0,0,0,0,0,0,0,0,0,0,0,0,0,0
Piyanut PANNOY,Thailand,Libero,Women,Bulgaria,2022-05-31,Pool,3,3,0,0,0,0,0,0,0,0,0,0,0,0,0,4,0,9,13,3,1,1,5,0,0,2,2
Pornpun GUEDPARD,Thailand,Setter,Women,Bulgaria,2022-05-31,Pool,3,3,1,0,0,2,2,1,3,4,8,0,2,8,10,0,0,0,0,3,2,2,7,28,0,53,81
Thatdao NUEKJANG,Thailand,Middle Blocker,Women,Bulgaria,2022-05-31,Pool,3,3,5,5,0,1,6,0,3,2,5,0,1,9,10,0,0,1,1,1,1,0,2,0,0,0,0
Hattaya BAMRUNGSUK,Thailand,Middle Blocker,Women,Bulgaria,2022-05-31,Pool,3,3,9,7,2,2,11,1,4,3,8,1,1,9,11,1,0,0,1,0,1,1,2,0,0,0,0
Sutadta CHUEWULIM,Thailand,Outside Hitter,Women,Bulgaria,2022-05-31,Pool,3,3,0,0,0,0,0,0,0,0,0,0,0,0,0,0,0,0,0,0,0,0,0,0,0,0,0
Kaewkalaya KAMULTHALA,Thailand,Middle Blocker,Women,Bulgaria,2022-05-31,Pool,3,3,0,0,0,0,0,0,0,0,0,0,0,0,0,0,0,0,0,0,0,0,0,0,0,0,0
Pimpichaya KOKRAM,Thailand,Opposite Spiker,Women,Bulgaria,2022-05-31,Pool,3,3,12,7,2,12,21,2,0,6,8,3,2,16,21,0,0,0,0,7,6,2,15,0,0,0,0
Tichaya BOONLERT,Thailand,Setter,Women,Bulgaria,2022-05-31,Pool,3,3,0,0,0,0,0,0,0,0,0,0,0,0,0,0,0,0,0,0,0,0,0,0,0,0,0
Ajcharaporn KONGYOT,Thailand,Outside Hitter,Women,Bulgaria,2022-05-31,Pool,3,3,20,17,2,13,32,2,4,1,7,1,1,11,13,2,1,10,13,7,3,0,10,0,0,0,0
Chatchu-On MOKSRI,Thailand,Outside Hitter,Women,Bulgaria,2022-05-31,Pool,3,3,13,11,3,10,24,2,2,0,4,0,1,7,8,5,0,20,25,8,4,2,14,0,0,1,1
Supattra PAIROJ,Thailand,Libero,Women,Bulgaria,2022-05-31,Pool,3,3,0,0,0,0,0,0,0,0,0,0,0,0,0,0,0,0,0,7,6,1,14,0,0,4,4
Thanacha SOOKSOD,Thailand,Opposite Spiker,Women,Bulgaria,2022-05-31,Pool,3,3,0,0,0,0,0,0,0,0,0,0,0,0,0,0,0,0,0,0,0,0,0,0,0,0,0
Tichakorn BOONLERT,Thailand,Middle Blocker,Women,Bulgaria,2022-05-31,Pool,3,3,0,0,0,0,0,0,0,0,0,0,0,0,0,0,0,0,0,0,0,0,0,0,0,0,0
Sasipapron JANTHAWISUT,Thailand,Outside Hitter,Women,Bulgaria,2022-05-31,Pool,3,3,0,0,0,0,0,0,0,0,0,0,0,0,0,0,0,0,0,0,0,0,0,0,0,0,0
Pornpun GUEDPARD,Thailand,Setter,Women,Canada,2022-06-14,Pool,3,3,0,0,0,0,0,0,0,0,0,0,0,5,5,0,0,0,0,0,1,0,1,6,0,11,17
Hattaya BAMRUNGSUK,Thailand,Middle Blocker,Women,Canada,2022-06-14,Pool,3,3,5,4,0,4,8,1,2,3,6,0,1,9,10,0,0,0,0,4,0,0,4,0,0,2,2
Natthanicha JAISAEN,Thailand,Setter,Women,Canada,2022-06-14,Pool,3,3,0,0,0,0,0,0,0,0,0,0,0,0,0,0,0,0,0,0,0,0,0,0,0,0,0
Kaewkalaya KAMULTHALA,Thailand,Middle Blocker,Women,Canada,2022-06-14,Pool,3,3,0,0,1,1,2,0,4,3,7,0,0,14,14,0,0,0,0,2,0,0,2,0,0,0,0
Pimpichaya KOKRAM,Thailand,Opposite Spiker,Women,Canada,2022-06-14,Pool,3,3,20,19,1,13,33,0,2,4,6,1,0,14,15,0,0,0,0,4,1,2,7,0,0,2,2
Ajcharaporn KONGYOT,Thailand,Outside Hitter,Women,Canada,2022-06-14,Pool,3,3,7,6,3,18,27,1,2,1,4,0,2,10,12,8,2,13,23,5,2,0,7,0,0,0,0
Chatchu-On MOKSRI,Thailand,Outside Hitter,Women,Canada,2022-06-14,Pool,3,3,18,16,2,14,32,0,2,1,3,2,3,9,14,5,2,15,22,5,1,2,8,0,0,1,1
Thanacha SOOKSOD,Thailand,Opposite Spiker,Women,Canada,2022-06-14,Pool,3,3,0,0,0,1,1,0,0,0,0,0,0,0,0,0,0,0,0,0,0,0,0,0,0,0,0
Nattaporn SANITKLANG,Thailand,Libero,Women,Canada,2022-06-14,Pool,3,3,0,0,0,0,0,0,0,0,0,0,0,0,0,2,1,5,8,5,0,1,6,1,0,5,6
Sirima MANAKIJ,Thailand,Setter,Women,Canada,2022-06-14,Pool,3,3,0,0,0,0,0,0,2,3,5,0,0,6,6,0,1,0,1,4,3,1,8,12,2,60,74
Tichakorn BOONLERT,Thailand,Middle Blocker,Women,Canada,2022-06-14,Pool,3,3,0,0,0,0,0,0,0,0,0,0,0,0,0,0,0,0,0,0,0,0,0,0,0,0,0
Sasipapron JANTHAWISUT,Thailand,Outside Hitter,Women,Canada,2022-06-14,Pool,3,3,0,0,0,0,0,0,0,0,0,0,0,0,0,0,0,0,0,0,0,0,0,0,0,0,0
Beyza ARICI,Türkiye,Middle Blocker,Women,Serbia,2022-07-17,Finals (Bronze),0,3,0,0,0,0,0,0,0,0,0,0,0,0,0,0,0,0,0,0,0,0,0,0,0,0,0
Simge Sebnem AKOZ,Türkiye,Libero,Women,Serbia,2022-07-17,Finals (Bronze),0,3,0,0,0,0,0,0,0,0,0,0,0,0,0,5,0,4,9,6,4,0,10,0,0,10,10
Cansu ÖZBAY,Türkiye,Setter,Women,Serbia,2022-07-17,Finals (Bronze),0,3,0,0,0,1,1,0,3,1,4,0,0,6,6,0,0,0,0,5,0,0,5,6,0,51,57
Tugba SENOGLU,Türkiye,Outside Hitter,Women,Serbia,2022-07-17,Finals (Bronze),0,3,5,5,6,6,17,0,0,2,2,0,0,8,8,2,0,21,23,9,3,0,12,0,0,0,0
Saliha SAHIN,Türkiye,Outside Hitter,Women,Serbia,2022-07-17,Finals (Bronze),0,3,0,0,1,1,2,0,0,0,0,0,0,1,1,0,0,5,5,3,0,0,3,0,0,0,0
Hande BALADIN,Türkiye,Outside Hitter,Women,Serbia,2022-07-17,Finals (Bronze),0,3,5,3,5,4,12,1,2,2,5,1,1,6,8,10,2,12,24,6,3,0,9,0,0,1,1
Meliha ISMAILOGLU,Türkiye,Outside Hitter,Women,Serbia,2022-07-17,Finals (Bronze),0,3,0,0,0,0,0,0,0,0,0,0,0,0,0,1,0,1,2,0,1,0,1,0,0,0,0
Ayca AYKAC,Türkiye,Libero,Women,Serbia,2022-07-17,Finals (Bronze),0,3,0,0,0,0,0,0,0,0,0,0,0,0,0,0,0,0,0,0,1,0,1,0,0,0,0
Elif ŞAHIN,Türkiye,Setter,Women,Serbia,2022-07-17,Finals (Bronze),0,3,0,0,0,1,1,0,2,0,2,0,0,3,3,0,0,0,0,0,1,0,1,1,0,17,18
Meryem BOZ,Türkiye,Opposite Spiker,Women,Serbia,2022-07-17,Finals (Bronze),0,3,1,1,0,3,4,0,0,1,1,0,0,1,1,0,0,0,0,0,0,0,0,0,0,0,0
Eda ERDEM DÜNDAR,Türkiye,Middle Blocker,Women,Serbia,2022-07-17,Finals (Bronze),0,3,10,5,2,1,8,3,7,4,14,2,0,13,15,0,0,1,1,3,1,1,5,0,0,3,3
Zehra GUNES,Türkiye,Middle Blocker,Women,Serbia,2022-07-17,Finals (Bronze),0,3,13,8,0,6,14,5,5,14,24,0,0,11,11,0,0,0,0,3,2,0,5,0,0,3,3
İlkin AYDIN,Türkiye,Outside Hitter,Women,Serbia,2022-07-17,Finals (Bronze),0,3,1,1,0,2,3,0,1,0,1,0,0,5,5,2,0,4,6,2,0,0,2,0,0,4,4
Ebrar KARAKURT,Türkiye,Opposite Spiker,Women,Serbia,2022-07-17,Finals (Bronze),0,3,14,14,5,14,33,0,3,1,4,0,0,10,10,0,0,1,1,6,1,0,7,0,1,4,5
Beyza ARICI,Türkiye,Middle Blocker,Women,Italy,2022-07-16,Semifinals,0,3,0,0,0,0,0,0,0,0,0,0,0,0,0,0,0,0,0,0,0,0,0,0,0,0,0
Simge Sebnem AKOZ,Türkiye,Libero,Women,Italy,2022-07-16,Semifinals,0,3,0,0,0,0,0,0,0,0,0,0,0,0,0,3,2,1,6,11,1,1,13,0,0,9,9
Cansu ÖZBAY,Türkiye,Setter,Women,Italy,2022-07-16,Semifinals,0,3,0,0,0,1,1,0,2,2,4,0,1,9,10,0,0,0,0,7,2,1,10,11,1,56,68
Tugba SENOGLU,Türkiye,Outside Hitter,Women,Italy,2022-07-16,Semifinals,0,3,0,0,0,0,0,0,0,0,0,0,0,0,0,0,0,0,0,0,0,0,0,0,0,0,0
Saliha SAHIN,Türkiye,Outside Hitter,Women,Italy,2022-07-16,Semifinals,0,3,5,4,1,5,10,1,2,1,4,0,0,3,3,2,0,6,8,2,0,0,2,0,0,2,2
Hande BALADIN,Türkiye,Outside Hitter,Women,Italy,2022-07-16,Semifinals,0,3,7,5,5,9,19,2,1,3,6,0,2,7,9,11,0,17,28,4,3,0,7,0,0,1,1
Meliha ISMAILOGLU,Türkiye,Outside Hitter,Women,Italy,2022-07-16,Semifinals,0,3,0,0,0,0,0,0,0,0,0,0,0,0,0,0,0,0,0,0,0,0,0,0,0,0,0
Ayca AYKAC,Türkiye,Libero,Women,Italy,2022-07-16,Semifinals,0,3,0,0,0,0,0,0,0,0,0,0,0,0,0,0,0,0,0,0,0,0,0,0,0,0,0
Elif ŞAHIN,Türkiye,Setter,Women,Italy,2022-07-16,Semifinals,0,3,1,1,0,1,2,0,0,0,0,0,0,2,2,0,0,0,0,0,0,0,0,3,0,9,12
Meryem BOZ,Türkiye,Opposite Spiker,Women,Italy,2022-07-16,Semifinals,0,3,1,1,0,2,3,0,0,0,0,0,0,2,2,0,0,0,0,0,0,0,0,0,0,0,0
Eda ERDEM DÜNDAR,Türkiye,Middle Blocker,Women,Italy,2022-07-16,Semifinals,0,3,11,10,2,3,15,1,6,9,16,0,2,6,8,0,0,0,0,3,2,0,5,0,1,2,3
Zehra GUNES,Türkiye,Middle Blocker,Women,Italy,2022-07-16,Semifinals,0,3,8,7,1,5,13,1,2,7,10,0,1,11,12,0,0,0,0,3,2,1,6,0,0,1,1
İlkin AYDIN,Türkiye,Outside Hitter,Women,Italy,2022-07-16,Semifinals,0,3,1,1,2,2,5,0,1,1,2,0,1,9,10,16,0,10,26,9,2,0,11,0,0,2,2
Ebrar KARAKURT,Türkiye,Opposite Spiker,Women,Italy,2022-07-16,Semifinals,0,3,14,12,5,12,29,0,2,5,7,2,1,8,11,0,0,0,0,2,4,0,6,0,0,1,1
Beyza ARICI,Türkiye,Middle Blocker,Women,Thailand,2022-07-14,Quarterfinals,3,4,0,0,0,0,0,0,0,0,0,0,0,0,0,0,0,0,0,0,0,0,0,0,0,0,0
Simge Sebnem AKOZ,Türkiye,Libero,Women,Thailand,2022-07-14,Quarterfinals,3,4,0,0,0,0,0,0,0,0,0,0,0,0,0,8,0,13,21,13,6,2,21,0,1,4,5
Cansu ÖZBAY,Türkiye,Setter,Women,Thailand,2022-07-14,Quarterfinals,3,4,6,3,0,0,3,2,6,3,11,1,3,10,14,0,0,0,0,6,1,4,11,31,1,67,99
Tugba SENOGLU,Türkiye,Outside Hitter,Women,Thailand,2022-07-14,Quarterfinals,3,4,0,0,0,0,0,0,0,0,0,0,1,1,2,1,0,0,1,0,0,0,0,0,0,0,0
Saliha SAHIN,Türkiye,Outside Hitter,Women,Thailand,2022-07-14,Quarterfinals,3,4,10,9,6,4,19,0,2,3,5,1,2,12,15,7,3,11,21,3,1,2,6,0,0,2,2
Hande BALADIN,Türkiye,Outside Hitter,Women,Thailand,2022-07-14,Quarterfinals,3,4,10,8,1,5,14,2,3,1,6,0,2,18,20,9,0,12,21,5,6,5,16,0,0,6,6
Meliha ISMAILOGLU,Türkiye,Outside Hitter,Women,Thailand,2022-07-14,Quarterfinals,3,4,0,0,0,0,0,0,0,0,0,0,0,4,4,2,0,4,6,1,0,0,1,0,0,0,0
Ayca AYKAC,Türkiye,Libero,Women,Thailand,2022-07-14,Quarterfinals,3,4,0,0,0,0,0,0,0,0,0,0,0,0,0,0,0,0,0,0,0,0,0,0,0,0,0
Elif ŞAHIN,Türkiye,Setter,Women,Thailand,2022-07-14,Quarterfinals,3,4,0,0,0,0,0,0,0,0,0,0,0,0,0,0,0,0,0,0,1,0,1,0,0,0,0
Meryem BOZ,Türkiye,Opposite Spiker,Women,Thailand,2022-07-14,Quarterfinals,3,4,0,0,0,0,0,0,0,0,0,0,0,2,2,0,0,0,0,0,0,0,0,0,0,0,0
Eda ERDEM DÜNDAR,Türkiye,Middle Blocker,Women,Thailand,2022-07-14,Quarterfinals,3,4,17,12,0,6,18,2,7,15,24,3,1,9,13,0,0,1,1,2,1,2,5,0,0,1,1
Zehra GUNES,Türkiye,Middle Blocker,Women,Thailand,2022-07-14,Quarterfinals,3,4,14,11,1,8,20,2,4,8,14,1,1,14,16,0,0,0,0,4,2,2,8,0,0,2,2
İlkin AYDIN,Türkiye,Outside Hitter,Women,Thailand,2022-07-14,Quarterfinals,3,4,0,0,0,0,0,0,0,0,0,0,0,0,0,0,0,0,0,0,0,0,0,0,0,0,0
Ebrar KARAKURT,Türkiye,Opposite Spiker,Women,Thailand,2022-07-14,Quarterfinals,3,4,17,15,4,15,34,2,2,4,8,0,0,10,10,0,0,0,0,7,3,1,11,0,0,1,1
Beyza ARICI,Türkiye,Middle Blocker,Women,Korea,2022-06-19,Pool,3,4,0,0,1,3,4,0,2,1,3,0,0,4,4,0,0,0,0,0,0,0,0,0,0,0,0
Simge Sebnem AKOZ,Türkiye,Libero,Women,Korea,2022-06-19,Pool,3,4,0,0,0,0,0,0,0,0,0,0,0,0,0,0,0,0,0,0,0,0,0,0,0,0,0
Cansu ÖZBAY,Türkiye,Setter,Women,Korea,2022-06-19,Pool,3,4,3,0,0,0,0,1,2,1,4,2,0,9,11,0,0,0,0,4,1,0,5,18,0,65,83
Tugba SENOGLU,Türkiye,Outside Hitter,Women,Korea,2022-06-19,Pool,3,4,2,1,1,4,6,1,1,0,2,0,0,5,5,5,1,5,11,3,1,0,4,0,0,0,0
Bahar AKBAY,Türkiye,Middle Blocker,Women,Korea,2022-06-19,Pool,3,4,0,0,0,0,0,0,0,0,0,0,0,0,0,0,0,0,0,0,0,0,0,0,0,0,0
Hande BALADIN,Türkiye,Outside Hitter,Women,Korea,2022-06-19,Pool,3,4,10,9,6,4,19,1,2,1,4,0,0,10,10,8,1,16,25,4,1,0,5,0,0,0,0
Meliha ISMAILOGLU,Türkiye,Outside Hitter,Women,Korea,2022-06-19,Pool,3,4,0,0,0,0,0,0,0,0,0,0,0,0,0,1,0,2,3,1,0,1,2,0,0,0,0
Ayca AYKAC,Türkiye,Libero,Women,Korea,2022-06-19,Pool,3,4,0,0,0,0,0,0,0,0,0,0,0,0,0,10,1,5,16,9,2,2,13,0,0,6,6
Derya CEBECIOGLU,Türkiye,Outside Hitter,Women,Korea,2022-06-19,Pool,3,4,12,11,4,8,23,1,7,2,10,0,0,16,16,10,0,2,12,7,0,2,9,0,0,0,0
Elif ŞAHIN,Türkiye,Setter,Women,Korea,2022-06-19,Pool,3,4,2,0,0,0,0,1,0,1,2,1,0,5,6,0,0,0,0,0,0,0,0,4,0,15,19
Meryem BOZ,Türkiye,Opposite Spiker,Women,Korea,2022-06-19,Pool,3,4,4,1,0,2,3,2,1,4,7,1,0,3,4,0,0,0,0,0,0,0,0,0,0,0,0
Eda ERDEM DÜNDAR,Türkiye,Middle Blocker,Women,Korea,2022-06-19,Pool,3,4,10,7,1,4,12,1,4,1,6,2,1,11,14,0,0,0,0,0,0,0,0,0,0,0,0
Zehra GUNES,Türkiye,Middle Blocker,Women,Korea,2022-06-19,Pool,3,4,15,11,2,4,17,4,3,8,15,0,3,9,12,1,0,0,1,0,0,1,1,0,0,0,0
Ebrar KARAKURT,Türkiye,Opposite Spiker,Women,Korea,2022-06-19,Pool,3,4,17,14,3,8,25,3,4,2,9,0,3,9,12,0,0,0,0,4,0,0,4,0,0,2,2
Beyza ARICI,Türkiye,Middle Blocker,Women,Germany,2022-06-18,Pool,3,3,0,0,0,0,0,0,0,0,0,0,0,0,0,0,0,0,0,0,0,0,0,0,0,0,0
Simge Sebnem AKOZ,Türkiye,Libero,Women,Germany,2022-06-18,Pool,3,3,0,0,0,0,0,0,0,0,0,0,0,0,0,5,2,6,13,10,2,2,14,0,0,4,4
Cansu ÖZBAY,Türkiye,Setter,Women,Germany,2022-06-18,Pool,3,3,4,3,0,1,4,0,3,3,6,1,2,22,25,0,0,0,0,4,1,1,6,26,0,51,77
Tugba SENOGLU,Türkiye,Outside Hitter,Women,Germany,2022-06-18,Pool,3,3,6,5,3,4,12,1,2,0,3,0,0,14,14,4,3,12,19,6,0,0,6,0,0,0,0
Bahar AKBAY,Türkiye,Middle Blocker,Women,Germany,2022-06-18,Pool,3,3,0,0,0,0,0,0,0,0,0,0,0,0,0,0,0,0,0,0,0,0,0,0,0,0,0
Hande BALADIN,Türkiye,Outside Hitter,Women,Germany,2022-06-18,Pool,3,3,11,8,3,11,22,2,3,3,8,1,0,10,11,6,1,13,20,0,1,0,1,0,0,2,2
Meliha ISMAILOGLU,Türkiye,Outside Hitter,Women,Germany,2022-06-18,Pool,3,3,0,0,0,0,0,0,0,0,0,0,0,0,0,3,0,1,4,0,0,0,0,0,0,0,0
Ayca AYKAC,Türkiye,Libero,Women,Germany,2022-06-18,Pool,3,3,0,0,0,0,0,0,0,0,0,0,0,0,0,0,0,0,0,0,0,0,0,0,0,0,0
Derya CEBECIOGLU,Türkiye,Outside Hitter,Women,Germany,2022-06-18,Pool,3,3,0,0,0,0,0,0,0,0,0,0,0,0,0,0,0,0,0,0,0,0,0,0,0,0,0
Elif ŞAHIN,Türkiye,Setter,Women,Germany,2022-06-18,Pool,3,3,0,0,0,0,0,0,0,0,0,0,0,0,0,0,0,0,0,0,0,0,0,0,0,0,0
Meryem BOZ,Türkiye,Opposite Spiker,Women,Germany,2022-06-18,Pool,3,3,0,0,2,0,2,0,0,0,0,0,0,0,0,0,0,0,0,0,0,0,0,0,0,0,0
Eda ERDEM DÜNDAR,Türkiye,Middle Blocker,Women,Germany,2022-06-18,Pool,3,3,7,7,2,5,14,0,3,8,11,0,2,8,10,0,0,0,0,2,1,0,3,0,0,0,0
Zehra GUNES,Türkiye,Middle Blocker,Women,Germany,2022-06-18,Pool,3,3,21,12,1,3,16,9,3,3,15,0,3,4,7,0,0,1,1,1,0,0,1,0,1,3,4
Ebrar KARAKURT,Türkiye,Opposite Spiker,Women,Germany,2022-06-18,Pool,3,3,9,9,4,6,19,0,0,1,1,0,1,6,7,0,0,0,0,7,0,0,7,0,0,0,0
Beyza ARICI,Türkiye,Middle Blocker,Women,Serbia,2022-06-17,Pool,2,5,2,0,0,1,1,2,5,4,11,0,1,3,4,0,0,0,0,0,1,0,1,0,0,1,1
Simge Sebnem AKOZ,Türkiye,Libero,Women,Serbia,2022-06-17,Pool,2,5,0,0,0,0,0,0,0,0,0,0,0,1,1,3,0,0,3,1,1,1,3,0,0,0,0
Cansu ÖZBAY,Türkiye,Setter,Women,Serbia,2022-06-17,Pool,2,5,4,1,0,0,1,2,1,6,9,1,1,13,15,0,0,1,1,7,1,2,10,14,3,120,137
Tugba SENOGLU,Türkiye,Outside Hitter,Women,Serbia,2022-06-17,Pool,2,5,4,4,3,2,9,0,0,1,1,0,0,4,4,2,0,2,4,1,0,0,1,0,0,0,0
Bahar AKBAY,Türkiye,Middle Blocker,Women,Serbia,2022-06-17,Pool,2,5,0,0,0,0,0,0,0,0,0,0,0,0,0,0,0,0,0,0,0,0,0,0,0,0,0
Hande BALADIN,Türkiye,Outside Hitter,Women,Serbia,2022-06-17,Pool,2,5,18,17,7,13,37,1,1,3,5,0,1,16,17,16,2,22,40,6,2,0,8,0,0,2,2
Meliha ISMAILOGLU,Türkiye,Outside Hitter,Women,Serbia,2022-06-17,Pool,2,5,13,10,7,10,27,1,0,3,4,2,1,15,18,11,2,24,37,7,2,3,12,0,0,0,0
Ayca AYKAC,Türkiye,Libero,Women,Serbia,2022-06-17,Pool,2,5,0,0,0,0,0,0,0,0,0,0,0,0,0,1,0,6,7,18,4,4,26,0,0,8,8
Derya CEBECIOGLU,Türkiye,Outside Hitter,Women,Serbia,2022-06-17,Pool,2,5,0,0,0,0,0,0,0,0,0,0,0,0,0,0,0,0,0,0,0,0,0,0,0,0,0
Elif ŞAHIN,Türkiye,Setter,Women,Serbia,2022-06-17,Pool,2,5,0,0,0,0,0,0,0,0,0,0,0,3,3,0,0,0,0,0,0,0,0,2,0,14,16
Meryem BOZ,Türkiye,Opposite Spiker,Women,Serbia,2022-06-17,Pool,2,5,6,6,3,9,18,0,0,0,0,0,2,4,6,0,0,0,0,3,0,0,3,0,0,0,0
Eda ERDEM DÜNDAR,Türkiye,Middle Blocker,Women,Serbia,2022-06-17,Pool,2,5,8,3,2,10,15,5,4,5,14,0,0,13,13,0,0,0,0,1,0,0,1,0,0,0,0
Zehra GUNES,Türkiye,Middle Blocker,Women,Serbia,2022-06-17,Pool,2,5,10,8,2,2,12,2,9,6,17,0,1,12,13,0,0,0,0,1,2,0,3,0,0,1,1
Ebrar KARAKURT,Türkiye,Opposite Spiker,Women,Serbia,2022-06-17,Pool,2,5,15,14,6,15,35,1,3,5,9,0,3,7,10,0,0,0,0,2,0,0,2,0,0,0,0
Beyza ARICI,Türkiye,Middle Blocker,Women,Brazil,2022-06-16,Pool,1,4,0,0,0,0,0,0,0,0,0,0,0,0,0,0,0,0,0,0,0,0,0,0,0,0,0
Simge Sebnem AKOZ,Türkiye,Libero,Women,Brazil,2022-06-16,Pool,1,4,0,0,0,0,0,0,0,0,0,0,0,0,0,0,0,0,0,0,0,0,0,0,0,0,0
Cansu ÖZBAY,Türkiye,Setter,Women,Brazil,2022-06-16,Pool,1,4,3,0,0,0,0,3,4,0,7,0,1,11,12,0,0,1,1,3,0,0,3,22,0,77,99
Tugba SENOGLU,Türkiye,Outside Hitter,Women,Brazil,2022-06-16,Pool,1,4,10,9,6,8,23,1,1,1,3,0,1,10,11,7,3,13,23,5,1,0,6,0,0,0,0
Bahar AKBAY,Türkiye,Middle Blocker,Women,Brazil,2022-06-16,Pool,1,4,0,0,0,0,0,0,0,0,0,0,0,0,0,0,0,0,0,0,0,0,0,0,0,0,0
Hande BALADIN,Türkiye,Outside Hitter,Women,Brazil,2022-06-16,Pool,1,4,9,8,1,2,11,1,0,1,2,0,1,3,4,4,0,7,11,0,1,1,2,0,0,0,0
Meliha ISMAILOGLU,Türkiye,Outside Hitter,Women,Brazil,2022-06-16,Pool,1,4,5,3,4,2,9,1,1,0,2,1,0,25,26,15,2,23,40,7,1,2,10,0,0,1,1
Ayca AYKAC,Türkiye,Libero,Women,Brazil,2022-06-16,Pool,1,4,0,0,0,0,0,0,0,0,0,0,0,0,0,3,1,4,8,9,4,3,16,0,1,12,13
Derya CEBECIOGLU,Türkiye,Outside Hitter,Women,Brazil,2022-06-16,Pool,1,4,2,1,1,1,3,1,0,0,1,0,0,0,0,1,0,1,2,0,0,1,1,0,0,0,0
Elif ŞAHIN,Türkiye,Setter,Women,Brazil,2022-06-16,Pool,1,4,0,0,0,0,0,0,0,0,0,0,0,2,2,0,0,0,0,0,0,1,1,0,0,5,5
Meryem BOZ,Türkiye,Opposite Spiker,Women,Brazil,2022-06-16,Pool,1,4,0,0,0,0,0,0,0,0,0,0,0,0,0,0,0,0,0,0,0,0,0,0,0,1,1
Eda ERDEM DÜNDAR,Türkiye,Middle Blocker,Women,Brazil,2022-06-16,Pool,1,4,10,8,1,4,13,1,4,5,10,1,3,9,13,0,0,0,0,0,1,1,2,0,0,3,3
Zehra GUNES,Türkiye,Middle Blocker,Women,Brazil,2022-06-16,Pool,1,4,10,7,1,3,11,3,4,7,14,0,0,13,13,0,0,0,0,1,3,0,4,0,0,2,2
Ebrar KARAKURT,Türkiye,Opposite Spiker,Women,Brazil,2022-06-16,Pool,1,4,21,19,8,24,51,1,6,1,8,1,1,12,14,0,0,0,0,3,1,4,8,0,0,2,2
Beyza ARICI,Türkiye,Middle Blocker,Women,Belgium,2022-06-05,Pool,3,4,0,0,0,0,0,0,0,0,0,0,0,0,0,0,0,0,0,0,0,0,0,0,0,0,0
Simge Sebnem AKOZ,Türkiye,Libero,Women,Belgium,2022-06-05,Pool,3,4,0,0,0,0,0,0,0,0,0,0,0,0,0,5,1,9,15,15,1,5,21,0,1,10,11
Cansu ÖZBAY,Türkiye,Setter,Women,Belgium,2022-06-05,Pool,3,4,6,0,1,3,4,5,4,4,13,1,0,13,14,0,0,0,0,8,2,3,13,36,0,61,97
Bahar AKBAY,Türkiye,Middle Blocker,Women,Belgium,2022-06-05,Pool,3,4,0,0,0,0,0,0,0,0,0,0,0,0,0,0,0,0,0,0,0,0,0,0,0,0,0
Saliha SAHIN,Türkiye,Outside Hitter,Women,Belgium,2022-06-05,Pool,3,4,0,0,0,0,0,0,0,0,0,0,0,0,0,0,0,0,0,0,0,0,0,0,0,0,0
Hande BALADIN,Türkiye,Outside Hitter,Women,Belgium,2022-06-05,Pool,3,4,0,0,1,3,4,0,0,0,0,0,0,1,1,1,0,4,5,0,0,0,0,0,0,0,0
Meliha ISMAILOGLU,Türkiye,Outside Hitter,Women,Belgium,2022-06-05,Pool,3,4,3,3,1,11,15,0,3,2,5,0,2,19,21,4,3,16,23,10,1,0,11,1,0,3,4
Ayca AYKAC,Türkiye,Libero,Women,Belgium,2022-06-05,Pool,3,4,0,0,0,0,0,0,0,0,0,0,0,0,0,0,0,0,0,0,0,0,0,0,0,0,0
Eda ERDEM DÜNDAR,Türkiye,Middle Blocker,Women,Belgium,2022-06-05,Pool,3,4,11,7,0,4,11,3,10,9,22,1,0,15,16,0,0,0,0,2,0,2,4,0,0,1,1
Sila CALISKAN,Türkiye,Setter,Women,Belgium,2022-06-05,Pool,3,4,0,0,0,0,0,0,0,0,0,0,0,0,0,0,0,0,0,0,0,0,0,3,0,1,4
Zehra GUNES,Türkiye,Middle Blocker,Women,Belgium,2022-06-05,Pool,3,4,12,7,3,5,15,5,10,12,27,0,2,10,12,0,0,0,0,5,1,4,10,1,0,1,2
Ceren KAPUCU,Türkiye,Opposite Spiker,Women,Belgium,2022-06-05,Pool,3,4,2,2,0,1,3,0,1,0,1,0,0,0,0,0,0,0,0,0,0,0,0,1,0,0,1
İlkin AYDIN,Türkiye,Outside Hitter,Women,Belgium,2022-06-05,Pool,3,4,13,11,2,12,25,1,2,3,6,1,1,10,12,9,0,22,31,11,0,3,14,1,0,1,2
Ebrar KARAKURT,Türkiye,Opposite Spiker,Women,Belgium,2022-06-05,Pool,3,4,20,20,10,18,48,0,6,2,8,0,3,10,13,0,0,0,0,9,1,2,12,0,0,0,0
Beyza ARICI,Türkiye,Middle Blocker,Women,Bulgaria,2022-06-04,Pool,3,3,0,0,0,0,0,0,0,0,0,0,0,0,0,0,0,0,0,0,0,0,0,0,0,0,0
Simge Sebnem AKOZ,Türkiye,Libero,Women,Bulgaria,2022-06-04,Pool,3,3,0,0,0,0,0,0,0,0,0,0,0,0,0,0,0,0,0,0,0,0,0,0,0,0,0
Cansu ÖZBAY,Türkiye,Setter,Women,Bulgaria,2022-06-04,Pool,3,3,0,0,1,2,3,0,1,3,4,0,0,10,10,0,0,0,0,6,1,1,8,29,1,40,70
Bahar AKBAY,Türkiye,Middle Blocker,Women,Bulgaria,2022-06-04,Pool,3,3,0,0,0,0,0,0,0,0,0,0,0,0,0,0,0,0,0,0,0,0,0,0,0,0,0
Saliha SAHIN,Türkiye,Outside Hitter,Women,Bulgaria,2022-06-04,Pool,3,3,8,6,6,10,22,2,2,1,5,0,1,9,10,10,0,11,21,2,2,1,5,0,0,1,1
Hande BALADIN,Türkiye,Outside Hitter,Women,Bulgaria,2022-06-04,Pool,3,3,7,6,5,3,14,1,3,2,6,0,0,14,14,5,1,12,18,8,0,2,10,1,0,2,3
Meliha ISMAILOGLU,Türkiye,Outside Hitter,Women,Bulgaria,2022-06-04,Pool,3,3,0,0,0,0,0,0,0,0,0,0,0,0,0,0,0,0,0,0,0,0,0,0,0,0,0
Ayca AYKAC,Türkiye,Libero,Women,Bulgaria,2022-06-04,Pool,3,3,0,0,0,0,0,0,0,0,0,0,0,0,0,2,0,8,10,12,2,2,16,0,0,3,3
Eda ERDEM DÜNDAR,Türkiye,Middle Blocker,Women,Bulgaria,2022-06-04,Pool,3,3,13,8,1,4,13,3,2,8,13,2,1,7,10,1,0,0,1,2,0,0,2,0,0,1,1
Sila CALISKAN,Türkiye,Setter,Women,Bulgaria,2022-06-04,Pool,3,3,0,0,0,0,0,0,0,0,0,0,0,0,0,0,0,0,0,0,0,0,0,1,0,1,2
Zehra GUNES,Türkiye,Middle Blocker,Women,Bulgaria,2022-06-04,Pool,3,3,9,7,0,3,10,1,2,7,10,1,3,10,14,0,0,1,1,2,0,1,3,0,0,2,2
Ceren KAPUCU,Türkiye,Opposite Spiker,Women,Bulgaria,2022-06-04,Pool,3,3,0,0,0,0,0,0,0,0,0,0,0,0,0,0,0,0,0,0,0,0,0,0,0,0,0
İlkin AYDIN,Türkiye,Outside Hitter,Women,Bulgaria,2022-06-04,Pool,3,3,0,0,0,0,0,0,0,0,0,0,0,0,0,0,0,0,0,0,0,0,0,0,0,0,0
Ebrar KARAKURT,Türkiye,Opposite Spiker,Women,Bulgaria,2022-06-04,Pool,3,3,20,15,2,8,25,5,4,5,14,0,2,14,16,0,0,0,0,5,1,4,10,1,0,1,2
Beyza ARICI,Türkiye,Middle Blocker,Women,China,2022-06-03,Pool,1,4,0,0,0,0,0,0,0,0,0,0,0,0,0,0,0,0,0,0,0,0,0,0,0,0,0
Simge Sebnem AKOZ,Türkiye,Libero,Women,China,2022-06-03,Pool,1,4,0,0,0,0,0,0,0,0,0,0,0,0,0,8,0,3,11,14,6,2,22,2,0,10,12
Cansu ÖZBAY,Türkiye,Setter,Women,China,2022-06-03,Pool,1,4,1,0,0,1,1,1,0,1,2,0,1,7,8,0,0,0,0,4,2,2,8,25,0,40,65
Bahar AKBAY,Türkiye,Middle Blocker,Women,China,2022-06-03,Pool,1,4,0,0,0,0,0,0,0,0,0,0,0,0,0,0,0,0,0,0,0,0,0,0,0,0,0
Saliha SAHIN,Türkiye,Outside Hitter,Women,China,2022-06-03,Pool,1,4,6,4,4,13,21,1,2,0,3,1,2,11,14,8,2,17,27,1,1,1,3,0,0,0,0
Hande BALADIN,Türkiye,Outside Hitter,Women,China,2022-06-03,Pool,1,4,3,3,6,3,12,0,0,1,1,0,2,9,11,4,0,16,20,5,0,0,5,0,0,0,0
Meliha ISMAILOGLU,Türkiye,Outside Hitter,Women,China,2022-06-03,Pool,1,4,3,3,2,1,6,0,1,0,1,0,0,6,6,7,1,11,19,5,1,1,7,0,0,0,0
Ayca AYKAC,Türkiye,Libero,Women,China,2022-06-03,Pool,1,4,0,0,0,0,0,0,0,0,0,0,0,0,0,0,0,0,0,0,0,0,0,0,0,0,0
Eda ERDEM DÜNDAR,Türkiye,Middle Blocker,Women,China,2022-06-03,Pool,1,4,8,7,1,7,15,1,6,7,14,0,2,9,11,0,0,0,0,2,1,0,3,0,0,3,3
Sila CALISKAN,Türkiye,Setter,Women,China,2022-06-03,Pool,1,4,1,1,0,0,1,0,2,1,3,0,0,5,5,0,0,0,0,3,0,0,3,18,1,16,35
Zehra GUNES,Türkiye,Middle Blocker,Women,China,2022-06-03,Pool,1,4,10,9,2,5,16,1,6,7,14,0,3,7,10,0,0,0,0,1,0,0,1,0,0,2,2
Ceren KAPUCU,Türkiye,Opposite Spiker,Women,China,2022-06-03,Pool,1,4,0,0,0,0,0,0,0,0,0,0,0,0,0,0,0,0,0,0,0,0,0,0,0,0,0
İlkin AYDIN,Türkiye,Outside Hitter,Women,China,2022-06-03,Pool,1,4,2,1,3,1,5,1,0,0,1,0,0,2,2,4,0,4,8,0,1,1,2,0,0,2,2
Ebrar KARAKURT,Türkiye,Opposite Spiker,Women,China,2022-06-03,Pool,1,4,22,21,8,17,46,0,1,1,2,1,0,12,13,0,0,0,0,9,1,1,11,0,0,1,1
Beyza ARICI,Türkiye,Middle Blocker,Women,Italy,2022-05-31,Pool,3,3,0,0,0,0,0,0,0,0,0,0,0,0,0,0,0,0,0,0,0,0,0,0,0,0,0
Simge Sebnem AKOZ,Türkiye,Libero,Women,Italy,2022-05-31,Pool,3,3,0,0,0,0,0,0,0,0,0,0,0,0,0,3,0,7,10,7,2,2,11,0,0,6,6
Cansu ÖZBAY,Türkiye,Setter,Women,Italy,2022-05-31,Pool,3,3,1,1,0,2,3,0,4,1,5,0,2,6,8,0,0,0,0,6,0,1,7,14,1,58,73
Bahar AKBAY,Türkiye,Middle Blocker,Women,Italy,2022-05-31,Pool,3,3,0,0,0,0,0,0,0,0,0,0,0,0,0,0,0,0,0,0,0,0,0,0,0,0,0
Saliha SAHIN,Türkiye,Outside Hitter,Women,Italy,2022-05-31,Pool,3,3,8,8,3,5,16,0,1,1,2,0,0,11,11,7,1,16,24,4,0,0,4,0,1,0,1
Hande BALADIN,Türkiye,Outside Hitter,Women,Italy,2022-05-31,Pool,3,3,16,12,3,9,24,1,1,1,3,3,2,10,15,8,0,8,16,2,2,1,5,0,0,2,2
Meliha ISMAILOGLU,Türkiye,Outside Hitter,Women,Italy,2022-05-31,Pool,3,3,0,0,0,0,0,0,0,0,0,0,0,0,0,0,0,0,0,0,0,0,0,0,0,0,0
Ayca AYKAC,Türkiye,Libero,Women,Italy,2022-05-31,Pool,3,3,0,0,0,1,1,0,0,0,0,0,0,0,0,0,0,0,0,0,0,0,0,0,0,0,0
Eda ERDEM DÜNDAR,Türkiye,Middle Blocker,Women,Italy,2022-05-31,Pool,3,3,10,6,3,4,13,3,4,5,12,1,1,13,15,0,0,0,0,3,0,1,4,0,0,1,1
Sila CALISKAN,Türkiye,Setter,Women,Italy,2022-05-31,Pool,3,3,0,0,0,0,0,0,0,0,0,0,0,1,1,0,0,2,2,0,0,0,0,1,0,2,3
Zehra GUNES,Türkiye,Middle Blocker,Women,Italy,2022-05-31,Pool,3,3,8,6,0,4,10,2,5,2,9,0,0,13,13,0,0,0,0,2,2,2,6,0,0,4,4
Ceren KAPUCU,Türkiye,Opposite Spiker,Women,Italy,2022-05-31,Pool,3,3,0,0,0,0,0,0,0,0,0,0,0,0,0,0,0,0,0,0,0,0,0,0,0,0,0
İlkin AYDIN,Türkiye,Outside Hitter,Women,Italy,2022-05-31,Pool,3,3,0,0,0,0,0,0,0,0,0,0,0,0,0,0,0,0,0,0,0,0,0,0,0,0,0
Ebrar KARAKURT,Türkiye,Opposite Spiker,Women,Italy,2022-05-31,Pool,3,3,14,13,2,12,27,1,2,3,6,0,2,8,10,0,0,0,0,5,1,1,7,0,0,0,0
Simge Sebnem AKOZ,Türkiye,Libero,Women,United States,2022-07-02,Pool,2,5,0,0,0,0,0,0,0,0,0,0,0,0,0,0,0,0,0,0,0,0,0,0,0,3,3
Cansu ÖZBAY,Türkiye,Setter,Women,United States,2022-07-02,Pool,2,5,2,1,0,4,5,1,5,1,7,0,2,20,22,0,0,1,1,8,1,0,9,8,1,113,122
Tugba SENOGLU,Türkiye,Outside Hitter,Women,United States,2022-07-02,Pool,2,5,0,0,0,0,0,0,0,0,0,0,0,0,0,0,0,0,0,0,0,0,0,0,0,0,0
Bahar AKBAY,Türkiye,Middle Blocker,Women,United States,2022-07-02,Pool,2,5,0,0,0,0,0,0,0,0,0,0,0,0,0,0,0,0,0,0,0,0,0,0,0,0,0
Saliha SAHIN,Türkiye,Outside Hitter,Women,United States,2022-07-02,Pool,2,5,17,15,1,10,26,1,1,2,4,1,1,19,21,12,0,3,15,4,1,0,5,0,0,2,2
Hande BALADIN,Türkiye,Outside Hitter,Women,United States,2022-07-02,Pool,2,5,0,0,0,0,0,0,0,0,0,0,0,0,0,0,0,0,0,0,0,0,0,0,0,0,0
Meliha ISMAILOGLU,Türkiye,Outside Hitter,Women,United States,2022-07-02,Pool,2,5,5,5,2,7,14,0,4,1,5,0,2,18,20,25,1,22,48,9,2,0,11,0,0,1,1
Ayca AYKAC,Türkiye,Libero,Women,United States,2022-07-02,Pool,2,5,0,0,0,0,0,0,0,0,0,0,0,0,0,10,3,10,23,13,1,0,14,0,1,7,8
Meryem BOZ,Türkiye,Opposite Spiker,Women,United States,2022-07-02,Pool,2,5,2,2,0,1,3,0,0,1,1,0,0,0,0,0,0,0,0,0,0,0,0,0,0,1,1
Eda ERDEM DÜNDAR,Türkiye,Middle Blocker,Women,United States,2022-07-02,Pool,2,5,14,11,2,5,18,2,5,4,11,1,1,15,17,0,0,0,0,0,1,0,1,0,0,0,0
Sila CALISKAN,Türkiye,Setter,Women,United States,2022-07-02,Pool,2,5,0,0,0,0,0,0,0,0,0,0,0,0,0,0,0,0,0,1,0,0,1,1,0,4,5
Zehra GUNES,Türkiye,Middle Blocker,Women,United States,2022-07-02,Pool,2,5,19,14,1,8,23,5,7,4,16,0,3,13,16,0,0,0,0,0,1,0,1,0,1,1,2
Aylin ACAR,Türkiye,Outside Hitter,Women,United States,2022-07-02,Pool,2,5,0,0,0,0,0,0,0,0,0,0,0,0,0,4,1,1,6,3,0,0,3,0,0,0,0
Ebrar KARAKURT,Türkiye,Opposite Spiker,Women,United States,2022-07-02,Pool,2,5,27,24,7,17,48,3,3,4,10,0,3,16,19,0,0,0,0,11,3,0,14,0,0,2,2
Simge Sebnem AKOZ,Türkiye,Libero,Women,Japan,2022-07-01,Pool,3,4,0,0,0,0,0,0,0,0,0,0,0,0,0,24,1,8,33,7,2,0,9,0,0,7,7
Cansu ÖZBAY,Türkiye,Setter,Women,Japan,2022-07-01,Pool,3,4,3,1,1,1,3,2,1,0,3,0,2,19,21,0,0,0,0,8,1,0,9,7,1,104,112
Tugba SENOGLU,Türkiye,Outside Hitter,Women,Japan,2022-07-01,Pool,3,4,5,3,4,2,9,2,1,2,5,0,0,13,13,6,0,10,16,6,0,0,6,0,1,0,1
Bahar AKBAY,Türkiye,Middle Blocker,Women,Japan,2022-07-01,Pool,3,4,0,0,0,0,0,0,0,0,0,0,0,0,0,0,0,0,0,0,0,0,0,0,0,0,0
Saliha SAHIN,Türkiye,Outside Hitter,Women,Japan,2022-07-01,Pool,3,4,4,1,0,7,8,2,2,0,4,1,0,7,8,5,1,3,9,11,0,0,11,0,1,0,1
Hande BALADIN,Türkiye,Outside Hitter,Women,Japan,2022-07-01,Pool,3,4,18,17,3,18,38,1,1,1,3,0,2,8,10,7,0,5,12,8,1,0,9,0,0,1,1
Meliha ISMAILOGLU,Türkiye,Outside Hitter,Women,Japan,2022-07-01,Pool,3,4,0,0,0,0,0,0,0,0,0,0,0,0,0,0,0,0,0,0,0,0,0,0,0,0,0
Ayca AYKAC,Türkiye,Libero,Women,Japan,2022-07-01,Pool,3,4,0,0,0,0,0,0,0,0,0,0,0,0,0,0,0,0,0,0,0,0,0,0,0,0,0
Meryem BOZ,Türkiye,Opposite Spiker,Women,Japan,2022-07-01,Pool,3,4,9,8,5,15,28,1,2,5,8,0,1,6,7,0,0,0,0,5,0,0,5,0,0,1,1
Eda ERDEM DÜNDAR,Türkiye,Middle Blocker,Women,Japan,2022-07-01,Pool,3,4,15,10,3,7,20,5,5,4,14,0,2,11,13,0,0,0,0,4,1,0,5,0,0,2,2
Sila CALISKAN,Türkiye,Setter,Women,Japan,2022-07-01,Pool,3,4,0,0,0,0,0,0,0,0,0,0,0,1,1,0,0,0,0,1,0,0,1,0,0,3,3
Zehra GUNES,Türkiye,Middle Blocker,Women,Japan,2022-07-01,Pool,3,4,16,9,1,3,13,6,4,5,15,1,0,16,17,0,0,0,0,2,0,0,2,0,0,3,3
Aylin ACAR,Türkiye,Outside Hitter,Women,Japan,2022-07-01,Pool,3,4,0,0,0,0,0,0,0,0,0,0,0,0,0,1,0,3,4,1,0,0,1,0,0,0,0
Ebrar KARAKURT,Türkiye,Opposite Spiker,Women,Japan,2022-07-01,Pool,3,4,6,6,0,2,8,0,0,1,1,0,1,1,2,0,0,0,0,0,0,0,0,0,0,0,0
Simge Sebnem AKOZ,Türkiye,Libero,Women,Netherlands,2022-06-30,Pool,3,3,0,0,0,0,0,0,0,0,0,0,0,0,0,6,0,2,8,8,1,0,9,0,0,4,4
Cansu ÖZBAY,Türkiye,Setter,Women,Netherlands,2022-06-30,Pool,3,3,4,1,0,0,1,2,2,0,4,1,0,12,13,0,0,0,0,1,0,0,1,7,1,81,89
Tugba SENOGLU,Türkiye,Outside Hitter,Women,Netherlands,2022-06-30,Pool,3,3,7,4,2,7,13,1,4,2,7,2,0,15,17,4,0,8,12,7,0,0,7,0,0,2,2
Bahar AKBAY,Türkiye,Middle Blocker,Women,Netherlands,2022-06-30,Pool,3,3,0,0,0,0,0,0,0,0,0,0,0,0,0,0,0,0,0,0,0,0,0,0,0,0,0
Saliha SAHIN,Türkiye,Outside Hitter,Women,Netherlands,2022-06-30,Pool,3,3,0,0,0,0,0,0,0,0,0,0,0,0,0,0,0,0,0,0,0,0,0,0,0,0,0
Hande BALADIN,Türkiye,Outside Hitter,Women,Netherlands,2022-06-30,Pool,3,3,17,17,5,11,33,0,1,1,2,0,2,5,7,14,0,10,24,10,0,0,10,0,0,1,1
Meliha ISMAILOGLU,Türkiye,Outside Hitter,Women,Netherlands,2022-06-30,Pool,3,3,0,0,0,0,0,0,0,0,0,0,0,0,0,1,0,2,3,2,1,0,3,0,0,1,1
Ayca AYKAC,Türkiye,Libero,Women,Netherlands,2022-06-30,Pool,3,3,0,0,0,0,0,0,0,0,0,0,0,0,0,0,0,0,0,0,0,0,0,0,0,0,0
Meryem BOZ,Türkiye,Opposite Spiker,Women,Netherlands,2022-06-30,Pool,3,3,12,11,4,7,22,0,4,2,6,1,0,14,15,0,0,0,0,5,0,0,5,0,0,0,0
Eda ERDEM DÜNDAR,Türkiye,Middle Blocker,Women,Netherlands,2022-06-30,Pool,3,3,9,6,1,6,13,2,2,6,10,1,1,9,11,0,0,0,0,2,0,0,2,0,0,2,2
Sila CALISKAN,Türkiye,Setter,Women,Netherlands,2022-06-30,Pool,3,3,0,0,0,0,0,0,0,0,0,0,0,0,0,0,0,0,0,0,0,0,0,0,0,0,0
Zehra GUNES,Türkiye,Middle Blocker,Women,Netherlands,2022-06-30,Pool,3,3,11,8,5,4,17,3,3,3,9,0,2,9,11,0,0,0,0,1,0,0,1,0,0,1,1
Aylin ACAR,Türkiye,Outside Hitter,Women,Netherlands,2022-06-30,Pool,3,3,0,0,0,0,0,0,0,0,0,0,0,0,0,0,0,2,2,3,0,0,3,0,0,1,1
Ebrar KARAKURT,Türkiye,Opposite Spiker,Women,Netherlands,2022-06-30,Pool,3,3,0,0,0,0,0,0,0,0,0,0,0,0,0,0,0,0,0,0,0,0,0,0,0,0,0
Simge Sebnem AKOZ,Türkiye,Libero,Women,Canada,2022-06-29,Pool,1,4,0,0,0,0,0,0,0,0,0,0,0,0,0,8,0,6,14,6,1,0,7,0,0,2,2
Cansu ÖZBAY,Türkiye,Setter,Women,Canada,2022-06-29,Pool,1,4,1,0,0,0,0,1,3,1,5,0,0,9,9,0,0,0,0,7,1,0,8,0,0,78,78
Tugba SENOGLU,Türkiye,Outside Hitter,Women,Canada,2022-06-29,Pool,1,4,3,3,0,7,10,0,2,1,3,0,0,2,2,4,0,3,7,0,0,0,0,0,0,0,0
Bahar AKBAY,Türkiye,Middle Blocker,Women,Canada,2022-06-29,Pool,1,4,0,0,0,0,0,0,0,0,0,0,0,0,0,0,0,0,0,0,0,0,0,0,0,0,0
Saliha SAHIN,Türkiye,Outside Hitter,Women,Canada,2022-06-29,Pool,1,4,2,2,1,0,3,0,0,0,0,0,0,4,4,2,0,1,3,1,0,0,1,0,0,0,0
Hande BALADIN,Türkiye,Outside Hitter,Women,Canada,2022-06-29,Pool,1,4,9,8,2,8,18,0,2,0,2,1,1,10,12,8,3,14,25,3,0,0,3,0,0,1,1
Meliha ISMAILOGLU,Türkiye,Outside Hitter,Women,Canada,2022-06-29,Pool,1,4,4,3,2,2,7,0,2,0,2,1,0,11,12,15,1,13,29,4,0,0,4,0,0,3,3
Ayca AYKAC,Türkiye,Libero,Women,Canada,2022-06-29,Pool,1,4,0,0,0,0,0,0,0,0,0,0,0,0,0,0,0,0,0,0,0,0,0,0,0,0,0
Meryem BOZ,Türkiye,Opposite Spiker,Women,Canada,2022-06-29,Pool,1,4,0,0,0,0,0,0,0,0,0,0,0,3,3,0,0,0,0,0,0,0,0,0,0,1,1
Eda ERDEM DÜNDAR,Türkiye,Middle Blocker,Women,Canada,2022-06-29,Pool,1,4,2,1,4,6,11,1,3,2,6,0,0,12,12,0,0,0,0,0,0,0,0,0,1,0,1
Sila CALISKAN,Türkiye,Setter,Women,Canada,2022-06-29,Pool,1,4,0,0,0,0,0,0,0,0,0,0,1,4,5,0,0,0,0,0,0,0,0,0,0,12,12
Zehra GUNES,Türkiye,Middle Blocker,Women,Canada,2022-06-29,Pool,1,4,17,14,1,8,23,2,7,1,10,1,1,13,15,0,0,0,0,1,0,0,1,0,0,2,2
Aylin ACAR,Türkiye,Outside Hitter,Women,Canada,2022-06-29,Pool,1,4,0,0,0,0,0,0,0,0,0,0,0,0,0,1,0,0,1,1,0,0,1,0,0,0,0
Ebrar KARAKURT,Türkiye,Opposite Spiker,Women,Canada,2022-06-29,Pool,1,4,23,20,8,11,39,1,4,2,7,2,4,13,19,0,0,0,0,8,0,0,8,0,0,0,0
Micha HANCOCK,United States,Setter,Women,Germany,2022-07-03,Pool,3,4,2,1,1,1,3,0,5,2,7,1,3,12,16,0,0,1,1,8,0,0,8,4,0,99,103
Jordyn POULTER,United States,Setter,Women,Germany,2022-07-03,Pool,3,4,0,0,0,0,0,0,0,0,0,0,0,0,0,0,0,0,0,0,0,0,0,0,0,0,0
Kathryn PLUMMER,United States,Outside Hitter,Women,Germany,2022-07-03,Pool,3,4,10,7,2,6,15,2,1,2,5,1,2,8,11,8,2,20,30,7,3,0,10,0,0,2,2
Justine WONG-ORANTES,United States,Libero,Women,Germany,2022-07-03,Pool,3,4,0,0,0,0,0,0,0,0,0,0,0,0,0,0,0,0,0,0,0,0,0,0,0,0,0
Morgan HENTZ,United States,Libero,Women,Germany,2022-07-03,Pool,3,4,0,0,0,0,0,0,0,0,0,0,0,0,0,4,0,11,15,15,3,2,20,0,0,9,9
Tetori DIXON,United States,Middle Blocker,Women,Germany,2022-07-03,Pool,3,4,5,2,0,5,7,2,4,5,11,1,1,13,15,0,0,0,0,3,1,0,4,0,0,1,1
Hannah TAPP,United States,Middle Blocker,Women,Germany,2022-07-03,Pool,3,4,0,0,0,0,0,0,0,0,0,0,0,0,0,0,0,0,0,0,0,0,0,0,0,0,0
Andrea DREWS,United States,Opposite Spiker,Women,Germany,2022-07-03,Pool,3,4,0,0,0,0,0,0,0,0,0,0,0,0,0,0,0,0,0,0,0,0,0,0,0,0,0
Jordan THOMPSON,United States,Opposite Spiker,Women,Germany,2022-07-03,Pool,3,4,14,12,6,13,31,1,3,1,5,1,1,11,13,0,0,0,0,8,1,0,9,0,0,4,4
Sarah WILHITE,United States,Outside Hitter,Women,Germany,2022-07-03,Pool,3,4,24,18,5,20,43,4,3,2,9,2,0,14,16,7,1,11,19,10,2,0,12,0,0,6,6
Haleigh WASHINGTON,United States,Middle Blocker,Women,Germany,2022-07-03,Pool,3,4,0,0,0,0,0,0,0,0,0,0,0,0,0,0,0,0,0,0,0,0,0,0,0,0,0
Dana RETTKE,United States,Middle Blocker,Women,Germany,2022-07-03,Pool,3,4,9,7,2,3,12,2,5,5,12,0,1,9,10,0,0,0,0,4,2,0,6,0,0,1,1
Kara BAJEMA,United States,Outside Hitter,Women,Germany,2022-07-03,Pool,3,4,0,0,0,0,0,0,0,0,0,0,0,0,0,0,0,0,0,0,0,0,0,0,0,0,0
Kelsey ROBINSON,United States,Outside Hitter,Women,Germany,2022-07-03,Pool,3,4,4,4,0,7,11,0,0,2,2,0,0,5,5,3,0,2,5,3,0,0,3,0,0,2,2
Micha HANCOCK,United States,Setter,Women,Türkiye,2022-07-02,Pool,3,5,0,0,0,0,0,0,0,0,0,0,0,0,0,0,0,0,0,0,0,0,0,0,0,0,0
Jordyn POULTER,United States,Setter,Women,Türkiye,2022-07-02,Pool,3,5,1,0,0,1,1,0,3,0,3,1,1,14,16,0,0,0,0,3,2,0,5,8,0,136,144
Kathryn PLUMMER,United States,Outside Hitter,Women,Türkiye,2022-07-02,Pool,3,5,0,0,0,0,0,0,0,0,0,0,0,0,0,0,0,0,0,0,0,0,0,0,0,0,0
Justine WONG-ORANTES,United States,Libero,Women,Türkiye,2022-07-02,Pool,3,5,0,0,0,0,0,0,0,0,0,0,0,0,0,15,0,6,21,17,2,0,19,0,0,9,9
Morgan HENTZ,United States,Libero,Women,Türkiye,2022-07-02,Pool,3,5,0,0,0,0,0,0,0,0,0,0,0,0,0,0,0,0,0,0,0,0,0,0,0,0,0
Tetori DIXON,United States,Middle Blocker,Women,Türkiye,2022-07-02,Pool,3,5,0,0,0,0,0,0,0,0,0,0,0,0,0,0,0,0,0,0,0,0,0,0,0,0,0
Hannah TAPP,United States,Middle Blocker,Women,Türkiye,2022-07-02,Pool,3,5,6,2,3,2,7,4,9,3,16,0,3,14,17,0,1,0,1,5,1,0,6,0,0,1,1
Andrea DREWS,United States,Opposite Spiker,Women,Türkiye,2022-07-02,Pool,3,5,24,20,5,20,45,1,0,3,4,3,3,12,18,0,0,0,0,7,2,0,9,0,0,0,0
Jordan THOMPSON,United States,Opposite Spiker,Women,Türkiye,2022-07-02,Pool,3,5,0,0,0,0,0,0,0,0,0,0,0,0,0,0,0,0,0,0,0,0,0,0,0,0,0
Sarah WILHITE,United States,Outside Hitter,Women,Türkiye,2022-07-02,Pool,3,5,0,0,0,0,0,0,0,0,0,0,0,1,1,0,0,0,0,0,0,0,0,0,0,0,0
Haleigh WASHINGTON,United States,Middle Blocker,Women,Türkiye,2022-07-02,Pool,3,5,11,10,5,5,20,0,7,0,7,1,0,14,15,0,0,1,1,0,1,0,1,0,0,0,0
Dana RETTKE,United States,Middle Blocker,Women,Türkiye,2022-07-02,Pool,3,5,0,0,0,0,0,0,0,0,0,0,0,0,0,0,0,0,0,0,0,0,0,0,0,0,0
Kara BAJEMA,United States,Outside Hitter,Women,Türkiye,2022-07-02,Pool,3,5,26,24,7,16,47,0,3,1,4,2,3,15,20,20,1,30,51,10,0,0,10,0,0,2,2
Kelsey ROBINSON,United States,Outside Hitter,Women,Türkiye,2022-07-02,Pool,3,5,21,19,4,17,40,0,3,1,4,2,2,18,22,16,0,10,26,10,2,0,12,0,0,4,4
Micha HANCOCK,United States,Setter,Women,Serbia,2022-07-01,Pool,3,3,0,0,0,0,0,0,0,0,0,0,0,0,0,0,0,0,0,0,0,0,0,0,0,0,0
Jordyn POULTER,United States,Setter,Women,Serbia,2022-07-01,Pool,3,3,2,0,0,0,0,2,4,1,7,0,0,8,8,0,0,0,0,6,3,1,10,14,0,66,80
Kathryn PLUMMER,United States,Outside Hitter,Women,Serbia,2022-07-01,Pool,3,3,18,16,1,13,30,2,0,0,2,0,2,8,10,13,2,11,26,4,0,0,4,0,0,4,4
Justine WONG-ORANTES,United States,Libero,Women,Serbia,2022-07-01,Pool,3,3,0,0,0,0,0,0,0,0,0,0,0,0,0,4,2,1,7,7,2,1,10,0,1,3,4
Morgan HENTZ,United States,Libero,Women,Serbia,2022-07-01,Pool,3,3,0,0,0,0,0,0,0,0,0,0,0,0,0,0,0,0,0,0,0,0,0,0,0,0,0
Tetori DIXON,United States,Middle Blocker,Women,Serbia,2022-07-01,Pool,3,3,0,0,0,0,0,0,0,0,0,0,0,0,0,0,0,0,0,0,0,0,0,0,0,0,0
Hannah TAPP,United States,Middle Blocker,Women,Serbia,2022-07-01,Pool,3,3,7,4,1,0,5,2,3,0,5,1,0,23,24,0,0,0,0,2,1,0,3,0,0,1,1
Andrea DREWS,United States,Opposite Spiker,Women,Serbia,2022-07-01,Pool,3,3,0,0,0,0,0,0,0,0,0,0,0,0,0,0,0,0,0,0,0,0,0,0,0,0,0
Jordan THOMPSON,United States,Opposite Spiker,Women,Serbia,2022-07-01,Pool,3,3,15,14,3,13,30,0,1,1,2,1,1,9,11,0,0,0,0,10,3,0,13,0,0,1,1
Sarah WILHITE,United States,Outside Hitter,Women,Serbia,2022-07-01,Pool,3,3,12,10,1,6,17,0,2,1,3,2,0,11,13,11,0,13,24,11,2,0,13,0,0,3,3
Haleigh WASHINGTON,United States,Middle Blocker,Women,Serbia,2022-07-01,Pool,3,3,8,4,4,4,12,3,5,4,12,1,1,13,15,0,0,1,1,3,0,0,3,0,0,1,1
Dana RETTKE,United States,Middle Blocker,Women,Serbia,2022-07-01,Pool,3,3,0,0,0,0,0,0,0,0,0,0,0,0,0,0,0,0,0,0,0,0,0,0,0,0,0
Kara BAJEMA,United States,Outside Hitter,Women,Serbia,2022-07-01,Pool,3,3,0,0,0,0,0,0,0,0,0,0,0,0,0,0,0,0,0,0,0,0,0,0,0,0,0
Kelsey ROBINSON,United States,Outside Hitter,Women,Serbia,2022-07-01,Pool,3,3,0,0,0,0,0,0,0,0,0,0,0,0,0,0,0,0,0,0,0,0,0,0,0,0,0
Micha HANCOCK,United States,Setter,Women,Belgium,2022-06-30,Pool,3,3,0,0,0,0,0,0,0,0,0,0,0,0,0,0,0,0,0,0,0,0,0,0,0,0,0
Jordyn POULTER,United States,Setter,Women,Belgium,2022-06-30,Pool,3,3,3,0,0,1,1,3,0,3,6,0,0,7,7,0,0,0,0,3,2,0,5,11,0,77,88
Kathryn PLUMMER,United States,Outside Hitter,Women,Belgium,2022-06-30,Pool,3,3,0,0,0,0,0,0,0,0,0,0,0,0,0,0,0,0,0,0,0,0,0,0,0,0,0
Justine WONG-ORANTES,United States,Libero,Women,Belgium,2022-06-30,Pool,3,3,0,0,0,0,0,0,0,0,0,0,0,0,0,3,1,4,8,5,3,0,8,0,0,2,2
Morgan HENTZ,United States,Libero,Women,Belgium,2022-06-30,Pool,3,3,0,0,0,0,0,0,0,0,0,0,0,0,0,0,0,0,0,0,0,0,0,0,0,0,0
Tetori DIXON,United States,Middle Blocker,Women,Belgium,2022-06-30,Pool,3,3,5,4,1,2,7,1,2,0,3,0,0,16,16,0,0,0,0,5,0,0,5,0,0,3,3
Hannah TAPP,United States,Middle Blocker,Women,Belgium,2022-06-30,Pool,3,3,0,0,0,0,0,0,0,0,0,0,0,0,0,0,0,0,0,0,0,0,0,0,0,0,0
Andrea DREWS,United States,Opposite Spiker,Women,Belgium,2022-06-30,Pool,3,3,15,12,4,11,27,2,3,0,5,1,4,8,13,0,0,0,0,5,3,0,8,0,0,0,0
Jordan THOMPSON,United States,Opposite Spiker,Women,Belgium,2022-06-30,Pool,3,3,0,0,0,0,0,0,0,0,0,0,0,0,0,0,0,0,0,0,0,0,0,0,0,0,0
Sarah WILHITE,United States,Outside Hitter,Women,Belgium,2022-06-30,Pool,3,3,0,0,0,0,0,0,0,0,0,0,0,0,0,0,0,0,0,0,0,0,0,0,0,0,0
Haleigh WASHINGTON,United States,Middle Blocker,Women,Belgium,2022-06-30,Pool,3,3,0,0,0,0,0,0,0,0,0,0,0,0,0,0,0,0,0,0,0,0,0,0,0,0,0
Dana RETTKE,United States,Middle Blocker,Women,Belgium,2022-06-30,Pool,3,3,6,4,1,7,12,1,1,2,4,1,0,8,9,0,0,0,0,2,1,0,3,0,0,0,0
Kara BAJEMA,United States,Outside Hitter,Women,Belgium,2022-06-30,Pool,3,3,20,18,3,7,28,1,1,2,4,1,0,12,13,11,3,11,25,5,0,0,5,0,0,1,1
Kelsey ROBINSON,United States,Outside Hitter,Women,Belgium,2022-06-30,Pool,3,3,12,11,2,9,22,1,1,1,3,0,0,15,15,6,0,12,18,12,2,0,14,0,0,1,1
Micha HANCOCK,United States,Setter,Women,Thailand,2022-06-19,Pool,3,4,0,0,1,1,2,0,0,2,2,0,0,2,2,0,0,0,0,2,0,0,2,6,0,20,26
Kathryn PLUMMER,United States,Outside Hitter,Women,Thailand,2022-06-19,Pool,3,4,0,0,0,0,0,0,0,0,0,0,0,0,0,0,0,0,0,0,0,0,0,0,0,0,0
Justine WONG-ORANTES,United States,Libero,Women,Thailand,2022-06-19,Pool,3,4,0,0,0,0,0,0,0,0,0,0,0,0,0,2,1,16,19,16,3,2,21,0,0,17,17
Morgan HENTZ,United States,Libero,Women,Thailand,2022-06-19,Pool,3,4,0,0,0,0,0,0,0,0,0,0,0,0,0,0,0,0,0,0,0,0,0,0,0,0,0
Lauren CARLINI,United States,Setter,Women,Thailand,2022-06-19,Pool,3,4,3,1,0,0,1,1,1,4,6,1,1,12,14,0,0,0,0,8,1,0,9,26,1,56,83
Hannah TAPP,United States,Middle Blocker,Women,Thailand,2022-06-19,Pool,3,4,0,0,0,0,0,0,0,0,0,0,0,0,0,0,0,0,0,0,0,0,0,0,0,0,0
Madison Kingdon RISHEL,United States,Outside Hitter,Women,Thailand,2022-06-19,Pool,3,4,5,3,1,6,10,1,0,0,1,1,1,3,5,2,1,11,14,3,0,0,3,0,0,0,0
Haleigh WASHINGTON,United States,Middle Blocker,Women,Thailand,2022-06-19,Pool,3,4,0,0,0,0,0,0,0,0,0,0,0,0,0,0,0,0,0,0,0,0,0,0,0,0,0
Danielle CUTTINO,United States,Opposite Spiker,Women,Thailand,2022-06-19,Pool,3,4,0,0,2,4,6,0,0,1,1,0,0,1,1,0,0,0,0,1,0,1,2,0,0,0,0
Kelsey ROBINSON,United States,Outside Hitter,Women,Thailand,2022-06-19,Pool,3,4,11,10,2,16,28,0,3,3,6,1,3,9,13,7,1,11,19,16,2,1,19,1,0,4,5
Chiaka OGBOGU,United States,Middle Blocker,Women,Thailand,2022-06-19,Pool,3,4,10,8,0,5,13,1,6,8,15,1,1,13,15,0,0,0,0,2,0,1,3,0,0,1,1
Alexandra FRANTTI,United States,Outside Hitter,Women,Thailand,2022-06-19,Pool,3,4,27,24,2,19,45,2,1,2,5,1,1,15,17,4,0,20,24,10,1,0,11,0,0,3,3
Anna STEVENSON,United States,Middle Blocker,Women,Thailand,2022-06-19,Pool,3,4,10,7,3,7,17,3,4,8,15,0,5,10,15,0,0,0,0,1,0,0,1,0,0,2,2
Nia REED,United States,Opposite Spiker,Women,Thailand,2022-06-19,Pool,3,4,8,8,5,12,25,0,6,6,12,0,0,9,9,0,0,0,0,9,1,2,12,0,0,0,0
Micha HANCOCK,United States,Setter,Women,China,2022-06-18,Pool,3,3,5,2,0,0,2,0,2,3,5,3,6,3,12,0,0,0,0,2,1,2,5,17,0,68,85
Kathryn PLUMMER,United States,Outside Hitter,Women,China,2022-06-18,Pool,3,3,20,18,5,6,29,0,2,1,3,2,0,10,12,5,0,24,29,6,1,0,7,1,0,3,4
Justine WONG-ORANTES,United States,Libero,Women,China,2022-06-18,Pool,3,3,0,0,0,0,0,0,0,0,0,0,0,0,0,4,2,12,18,11,0,0,11,0,0,3,3
Morgan HENTZ,United States,Libero,Women,China,2022-06-18,Pool,3,3,0,0,0,0,0,0,0,0,0,0,0,0,0,0,0,0,0,0,0,0,0,0,0,0,0
Lauren CARLINI,United States,Setter,Women,China,2022-06-18,Pool,3,3,0,0,0,0,0,0,0,0,0,0,0,0,0,0,0,0,0,0,0,0,0,0,0,0,0
Hannah TAPP,United States,Middle Blocker,Women,China,2022-06-18,Pool,3,3,6,4,3,1,8,2,2,4,8,0,1,7,8,1,0,0,1,3,0,0,3,0,0,0,0
Madison Kingdon RISHEL,United States,Outside Hitter,Women,China,2022-06-18,Pool,3,3,0,0,0,0,0,0,0,0,0,0,0,0,0,0,0,0,0,0,0,0,0,0,0,0,0
Haleigh WASHINGTON,United States,Middle Blocker,Women,China,2022-06-18,Pool,3,3,11,6,1,5,12,3,3,2,8,2,1,14,17,0,0,0,0,4,1,1,6,0,0,1,1
Danielle CUTTINO,United States,Opposite Spiker,Women,China,2022-06-18,Pool,3,3,8,7,3,11,21,1,4,1,6,0,2,11,13,0,0,0,0,6,7,0,13,0,0,0,0
Kelsey ROBINSON,United States,Outside Hitter,Women,China,2022-06-18,Pool,3,3,15,13,3,12,28,1,2,1,4,1,1,9,11,5,1,8,14,6,1,0,7,0,0,6,6
Chiaka OGBOGU,United States,Middle Blocker,Women,China,2022-06-18,Pool,3,3,0,0,0,0,0,0,0,0,0,0,0,0,0,0,0,0,0,0,0,0,0,0,0,0,0
Alexandra FRANTTI,United States,Outside Hitter,Women,China,2022-06-18,Pool,3,3,0,0,0,0,0,0,0,0,0,0,0,0,0,0,0,0,0,0,0,0,0,0,0,0,0
Anna STEVENSON,United States,Middle Blocker,Women,China,2022-06-18,Pool,3,3,0,0,0,0,0,0,0,0,0,0,0,0,0,0,0,0,0,0,0,0,0,0,0,0,0
Nia REED,United States,Opposite Spiker,Women,China,2022-06-18,Pool,3,3,0,0,0,0,0,0,0,0,0,0,0,0,0,0,0,0,0,0,0,0,0,0,0,0,0
Micha HANCOCK,United States,Setter,Women,Poland,2022-06-17,Pool,3,3,0,0,0,0,0,0,0,0,0,0,0,0,0,0,0,0,0,0,0,0,0,0,0,0,0
Kathryn PLUMMER,United States,Outside Hitter,Women,Poland,2022-06-17,Pool,3,3,0,0,0,0,0,0,0,0,0,0,0,0,0,0,0,0,0,0,0,0,0,0,0,0,0
Justine WONG-ORANTES,United States,Libero,Women,Poland,2022-06-17,Pool,3,3,0,0,0,0,0,0,0,0,0,0,0,0,0,0,0,0,0,0,0,0,0,0,0,0,0
Morgan HENTZ,United States,Libero,Women,Poland,2022-06-17,Pool,3,3,0,0,0,0,0,0,0,0,0,0,0,0,0,3,0,1,4,12,4,0,16,0,0,5,5
Lauren CARLINI,United States,Setter,Women,Poland,2022-06-17,Pool,3,3,4,2,0,1,3,1,1,4,6,1,0,10,11,0,0,0,0,8,1,0,9,14,0,60,74
Hannah TAPP,United States,Middle Blocker,Women,Poland,2022-06-17,Pool,3,3,0,0,0,0,0,0,0,0,0,0,0,0,0,0,0,0,0,0,0,0,0,0,0,0,0
Madison Kingdon RISHEL,United States,Outside Hitter,Women,Poland,2022-06-17,Pool,3,3,12,11,3,11,25,1,0,2,3,0,1,10,11,3,1,17,21,5,1,0,6,0,0,2,2
Haleigh WASHINGTON,United States,Middle Blocker,Women,Poland,2022-06-17,Pool,3,3,0,0,0,0,0,0,0,0,0,0,0,0,0,0,0,0,0,0,0,0,0,0,0,0,0
Danielle CUTTINO,United States,Opposite Spiker,Women,Poland,2022-06-17,Pool,3,3,0,0,0,0,0,0,0,0,0,0,0,0,0,0,0,0,0,0,0,0,0,0,0,0,0
Kelsey ROBINSON,United States,Outside Hitter,Women,Poland,2022-06-17,Pool,3,3,0,0,0,0,0,0,0,0,0,0,0,0,0,0,0,0,0,0,0,0,0,0,0,0,0
Chiaka OGBOGU,United States,Middle Blocker,Women,Poland,2022-06-17,Pool,3,3,9,7,0,4,11,2,6,5,13,0,1,14,15,0,0,0,0,1,2,1,4,0,0,0,0
Alexandra FRANTTI,United States,Outside Hitter,Women,Poland,2022-06-17,Pool,3,3,18,15,2,2,19,3,1,2,6,0,0,11,11,7,0,12,19,6,1,1,8,0,0,3,3
Anna STEVENSON,United States,Middle Blocker,Women,Poland,2022-06-17,Pool,3,3,6,5,2,3,10,1,2,4,7,0,1,12,13,0,0,0,0,1,0,0,1,0,0,1,1
Nia REED,United States,Opposite Spiker,Women,Poland,2022-06-17,Pool,3,3,12,11,2,9,22,1,1,5,7,0,0,12,12,0,0,0,0,13,1,1,15,1,0,0,1
Micha HANCOCK,United States,Setter,Women,Bulgaria,2022-06-15,Pool,3,3,3,1,0,0,1,1,3,5,9,1,1,11,13,0,0,1,1,6,1,1,8,12,0,61,73
Kathryn PLUMMER,United States,Outside Hitter,Women,Bulgaria,2022-06-15,Pool,3,3,8,7,4,9,20,1,3,2,6,0,1,8,9,7,4,15,26,9,3,0,12,0,0,1,1
Justine WONG-ORANTES,United States,Libero,Women,Bulgaria,2022-06-15,Pool,3,3,0,0,0,0,0,0,0,0,0,0,0,0,0,3,1,8,12,8,1,0,9,0,0,5,5
Morgan HENTZ,United States,Libero,Women,Bulgaria,2022-06-15,Pool,3,3,0,0,0,0,0,0,0,0,0,0,0,0,0,0,0,0,0,0,0,0,0,0,0,0,0
Lauren CARLINI,United States,Setter,Women,Bulgaria,2022-06-15,Pool,3,3,0,0,0,0,0,0,0,0,0,0,0,0,0,0,0,0,0,0,0,0,0,0,0,0,0
Hannah TAPP,United States,Middle Blocker,Women,Bulgaria,2022-06-15,Pool,3,3,11,9,1,0,10,1,4,5,10,1,2,7,10,1,0,0,1,2,1,0,3,0,0,2,2
Madison Kingdon RISHEL,United States,Outside Hitter,Women,Bulgaria,2022-06-15,Pool,3,3,0,0,0,0,0,0,0,0,0,0,0,0,0,0,0,0,0,0,0,0,0,0,0,0,0
Haleigh WASHINGTON,United States,Middle Blocker,Women,Bulgaria,2022-06-15,Pool,3,3,10,4,1,2,7,2,2,2,6,4,0,15,19,0,0,0,0,1,1,1,3,0,0,0,0
Danielle CUTTINO,United States,Opposite Spiker,Women,Bulgaria,2022-06-15,Pool,3,3,12,10,1,10,21,2,4,5,11,0,2,9,11,0,0,0,0,7,3,1,11,0,0,2,2
Kelsey ROBINSON,United States,Outside Hitter,Women,Bulgaria,2022-06-15,Pool,3,3,14,13,5,11,29,0,2,2,4,1,1,9,11,3,1,12,16,4,1,0,5,0,0,2,2
Chiaka OGBOGU,United States,Middle Blocker,Women,Bulgaria,2022-06-15,Pool,3,3,0,0,0,0,0,0,0,0,0,0,0,0,0,0,0,0,0,0,0,0,0,0,0,0,0
Alexandra FRANTTI,United States,Outside Hitter,Women,Bulgaria,2022-06-15,Pool,3,3,0,0,0,0,0,0,0,0,0,0,0,0,0,0,0,0,0,0,0,0,0,0,0,0,0
Anna STEVENSON,United States,Middle Blocker,Women,Bulgaria,2022-06-15,Pool,3,3,0,0,0,0,0,0,0,0,0,0,0,0,0,0,0,0,0,0,0,0,0,0,0,0,0
Nia REED,United States,Opposite Spiker,Women,Bulgaria,2022-06-15,Pool,3,3,0,0,0,0,0,0,0,0,0,0,0,0,0,0,0,0,0,0,0,0,0,0,0,0,0
Jordyn POULTER,United States,Setter,Women,Serbia,2022-07-13,Quarterfinals,2,5,5,1,0,0,1,2,3,0,5,2,1,19,22,0,0,0,0,8,4,0,12,18,0,82,100
Kathryn PLUMMER,United States,Outside Hitter,Women,Serbia,2022-07-13,Quarterfinals,2,5,6,5,4,4,13,1,3,1,5,0,2,4,6,11,2,21,34,6,2,1,9,0,0,0,0
Justine WONG-ORANTES,United States,Libero,Women,Serbia,2022-07-13,Quarterfinals,2,5,0,0,0,0,0,0,0,0,0,0,0,0,0,6,1,5,12,10,1,0,11,0,1,6,7
Morgan HENTZ,United States,Libero,Women,Serbia,2022-07-13,Quarterfinals,2,5,0,0,0,0,0,0,0,0,0,0,0,0,0,0,0,0,0,0,0,0,0,0,0,0,0
Lauren CARLINI,United States,Setter,Women,Serbia,2022-07-13,Quarterfinals,2,5,0,0,0,0,0,0,0,0,0,0,0,1,1,0,0,0,0,0,0,0,0,2,0,0,2
Hannah TAPP,United States,Middle Blocker,Women,Serbia,2022-07-13,Quarterfinals,2,5,0,0,0,0,0,0,0,0,0,0,0,0,0,0,0,0,0,0,0,0,0,0,0,0,0
Andrea DREWS,United States,Opposite Spiker,Women,Serbia,2022-07-13,Quarterfinals,2,5,11,10,4,5,19,1,6,1,8,0,1,7,8,0,0,0,0,8,1,1,10,0,0,0,0
Jordan THOMPSON,United States,Opposite Spiker,Women,Serbia,2022-07-13,Quarterfinals,2,5,11,9,3,5,17,2,2,1,5,0,1,6,7,0,0,0,0,1,1,0,2,0,0,0,0
Sarah WILHITE,United States,Outside Hitter,Women,Serbia,2022-07-13,Quarterfinals,2,5,1,1,0,0,1,0,0,0,0,0,0,7,7,0,0,0,0,0,0,0,0,0,0,0,0
Haleigh WASHINGTON,United States,Middle Blocker,Women,Serbia,2022-07-13,Quarterfinals,2,5,7,3,1,6,10,3,6,6,15,1,2,27,30,0,0,2,2,1,2,0,3,0,0,2,2
Dana RETTKE,United States,Middle Blocker,Women,Serbia,2022-07-13,Quarterfinals,2,5,0,0,0,0,0,0,0,0,0,0,0,0,0,0,0,0,0,0,0,0,0,0,0,0,0
Kelsey ROBINSON,United States,Outside Hitter,Women,Serbia,2022-07-13,Quarterfinals,2,5,21,17,8,14,39,4,4,4,12,0,0,13,13,6,1,13,20,14,6,1,21,0,0,9,9
Chiaka OGBOGU,United States,Middle Blocker,Women,Serbia,2022-07-13,Quarterfinals,2,5,12,6,3,2,11,6,9,13,28,0,1,12,13,0,1,0,1,1,1,0,2,0,0,3,3
Alexandra FRANTTI,United States,Outside Hitter,Women,Serbia,2022-07-13,Quarterfinals,2,5,16,14,3,5,22,2,0,1,3,0,0,6,6,11,1,19,31,8,3,0,11,0,0,3,3
Morgan HENTZ,United States,Libero,Women,Japan,2022-06-05,Pool,0,3,0,0,0,0,0,0,0,0,0,0,0,0,0,4,2,3,9,15,5,2,22,0,1,15,16
Tetori DIXON,United States,Middle Blocker,Women,Japan,2022-06-05,Pool,0,3,2,2,1,3,6,0,3,1,4,0,0,7,7,2,0,0,2,1,1,0,2,0,0,0,0
Lauren CARLINI,United States,Setter,Women,Japan,2022-06-05,Pool,0,3,1,1,0,4,5,0,3,2,5,0,0,14,14,0,0,1,1,16,0,0,16,24,1,70,95
Madison Kingdon RISHEL,United States,Outside Hitter,Women,Japan,2022-06-05,Pool,0,3,7,7,2,14,23,0,2,1,3,0,0,7,7,6,0,7,13,7,2,0,9,0,0,2,2
Brionne BUTLER,United States,Middle Blocker,Women,Japan,2022-06-05,Pool,0,3,0,0,0,0,0,0,0,0,0,0,0,0,0,0,0,0,0,0,0,0,0,0,0,0,0
Andrea DREWS,United States,Opposite Spiker,Women,Japan,2022-06-05,Pool,0,3,11,11,4,18,33,0,4,1,5,0,2,5,7,0,0,0,0,11,3,1,15,0,0,0,0
Jordan THOMPSON,United States,Opposite Spiker,Women,Japan,2022-06-05,Pool,0,3,0,0,0,0,0,0,0,0,0,0,0,0,0,0,0,0,0,0,0,0,0,0,0,0,0
Sarah WILHITE,United States,Outside Hitter,Women,Japan,2022-06-05,Pool,0,3,6,6,1,5,12,0,1,0,1,0,2,3,5,2,0,2,4,4,1,0,5,0,0,1,1
Dana RETTKE,United States,Middle Blocker,Women,Japan,2022-06-05,Pool,0,3,2,1,1,2,4,1,0,5,6,0,0,3,3,1,0,1,2,0,0,0,0,0,0,0,0
Kara BAJEMA,United States,Outside Hitter,Women,Japan,2022-06-05,Pool,0,3,10,10,2,18,30,0,0,1,1,0,1,7,8,9,1,14,24,5,1,0,6,0,0,2,2
Jenna GRAY,United States,Setter,Women,Japan,2022-06-05,Pool,0,3,0,0,0,0,0,0,0,0,0,0,0,0,0,0,0,0,0,0,0,0,0,0,0,0,0
Kendall WHITE,United States,Libero,Women,Japan,2022-06-05,Pool,0,3,0,0,0,0,0,0,0,0,0,0,0,0,0,0,0,0,0,0,0,0,0,0,0,0,0
Alexandra FRANTTI,United States,Outside Hitter,Women,Japan,2022-06-05,Pool,0,3,2,1,1,0,2,1,1,0,2,0,0,1,1,3,1,3,7,2,0,0,2,0,0,0,0
Anna STEVENSON,United States,Middle Blocker,Women,Japan,2022-06-05,Pool,0,3,10,7,2,4,13,3,0,2,5,0,2,9,11,3,0,3,6,6,0,0,6,0,0,1,1
Morgan HENTZ,United States,Libero,Women,Brazil,2022-06-05,Pool,3,3,0,0,0,0,0,0,0,0,0,0,0,0,0,8,0,2,10,17,3,0,20,0,0,13,13
Tetori DIXON,United States,Middle Blocker,Women,Brazil,2022-06-05,Pool,3,3,0,0,0,0,0,0,0,0,0,0,0,0,0,0,0,0,0,0,0,0,0,0,0,0,0
Lauren CARLINI,United States,Setter,Women,Brazil,2022-06-05,Pool,3,3,3,1,0,0,1,0,4,5,9,2,2,12,16,0,0,0,0,12,2,1,15,13,0,60,73
Madison Kingdon RISHEL,United States,Outside Hitter,Women,Brazil,2022-06-05,Pool,3,3,0,0,0,0,0,0,0,0,0,0,0,0,0,0,0,0,0,0,0,0,0,0,0,0,0
Brionne BUTLER,United States,Middle Blocker,Women,Brazil,2022-06-05,Pool,3,3,0,0,0,0,0,0,0,0,0,0,0,0,0,0,0,0,0,0,0,0,0,0,0,0,0
Andrea DREWS,United States,Opposite Spiker,Women,Brazil,2022-06-05,Pool,3,3,0,0,0,0,0,0,0,0,0,0,0,0,0,0,0,0,0,0,0,0,0,0,0,0,0
Jordan THOMPSON,United States,Opposite Spiker,Women,Brazil,2022-06-05,Pool,3,3,19,15,9,10,34,1,1,0,2,3,1,10,14,0,0,0,0,4,1,0,5,0,0,3,3
Sarah WILHITE,United States,Outside Hitter,Women,Brazil,2022-06-05,Pool,3,3,12,9,3,14,26,3,1,0,4,0,1,11,12,11,1,8,20,5,1,0,6,0,0,4,4
Dana RETTKE,United States,Middle Blocker,Women,Brazil,2022-06-05,Pool,3,3,9,5,3,0,8,3,3,5,11,1,0,13,14,0,0,0,0,1,0,0,1,0,0,2,2
Kara BAJEMA,United States,Outside Hitter,Women,Brazil,2022-06-05,Pool,3,3,0,0,0,0,0,0,0,0,0,0,0,0,0,0,0,0,0,0,0,0,0,0,0,0,0
Jenna GRAY,United States,Setter,Women,Brazil,2022-06-05,Pool,3,3,0,0,0,0,0,0,0,0,0,0,0,0,0,0,0,0,0,0,0,0,0,0,0,0,0
Kendall WHITE,United States,Libero,Women,Brazil,2022-06-05,Pool,3,3,0,0,0,0,0,0,0,0,0,0,0,0,0,0,0,0,0,0,0,0,0,0,0,0,0
Alexandra FRANTTI,United States,Outside Hitter,Women,Brazil,2022-06-05,Pool,3,3,13,11,4,10,25,2,0,1,3,0,0,7,7,11,1,14,26,11,3,0,14,0,0,2,2
Anna STEVENSON,United States,Middle Blocker,Women,Brazil,2022-06-05,Pool,3,3,6,4,0,4,8,2,2,4,8,0,0,10,10,0,0,0,0,1,0,0,1,0,0,1,1
Morgan HENTZ,United States,Libero,Women,Canada,2022-06-04,Pool,3,3,0,0,0,0,0,0,0,0,0,0,0,0,0,0,0,0,0,0,0,0,0,0,0,0,0
Tetori DIXON,United States,Middle Blocker,Women,Canada,2022-06-04,Pool,3,3,3,3,0,4,7,0,2,5,7,0,0,12,12,0,0,0,0,1,0,0,1,0,0,1,1
Lauren CARLINI,United States,Setter,Women,Canada,2022-06-04,Pool,3,3,3,2,0,1,3,0,3,1,4,1,2,7,10,0,0,0,0,14,3,1,18,9,0,55,64
Madison Kingdon RISHEL,United States,Outside Hitter,Women,Canada,2022-06-04,Pool,3,3,12,11,2,11,24,1,0,1,2,0,1,9,10,4,0,5,9,8,3,0,11,0,0,2,2
Brionne BUTLER,United States,Middle Blocker,Women,Canada,2022-06-04,Pool,3,3,9,6,0,2,8,3,3,2,8,0,1,11,12,0,0,0,0,2,0,0,2,0,0,0,0
Andrea DREWS,United States,Opposite Spiker,Women,Canada,2022-06-04,Pool,3,3,15,13,4,10,27,2,2,1,5,0,3,9,12,0,0,0,0,5,0,1,6,0,0,1,1
Jordan THOMPSON,United States,Opposite Spiker,Women,Canada,2022-06-04,Pool,3,3,0,0,0,0,0,0,0,0,0,0,0,0,0,0,0,0,0,0,0,0,0,0,0,0,0
Sarah WILHITE,United States,Outside Hitter,Women,Canada,2022-06-04,Pool,3,3,0,0,0,0,0,0,0,0,0,0,0,0,0,0,0,0,0,0,0,0,0,0,0,0,0
Dana RETTKE,United States,Middle Blocker,Women,Canada,2022-06-04,Pool,3,3,0,0,0,0,0,0,0,0,0,0,0,0,0,0,0,0,0,0,0,0,0,0,0,0,0
Kara BAJEMA,United States,Outside Hitter,Women,Canada,2022-06-04,Pool,3,3,12,9,3,11,23,2,1,1,4,1,1,15,17,18,0,12,30,5,2,0,7,0,1,5,6
Jenna GRAY,United States,Setter,Women,Canada,2022-06-04,Pool,3,3,0,0,0,0,0,0,0,0,0,0,0,0,0,0,0,0,0,0,0,0,0,0,0,0,0
Kendall WHITE,United States,Libero,Women,Canada,2022-06-04,Pool,3,3,0,0,0,0,0,0,0,0,0,0,0,0,0,6,1,1,8,17,3,1,21,0,0,14,14
Alexandra FRANTTI,United States,Outside Hitter,Women,Canada,2022-06-04,Pool,3,3,0,0,0,0,0,0,0,0,0,0,0,0,0,0,0,0,0,0,0,0,0,0,0,0,0
Anna STEVENSON,United States,Middle Blocker,Women,Canada,2022-06-04,Pool,3,3,0,0,0,0,0,0,0,0,0,0,0,0,0,0,0,0,0,0,0,0,0,0,0,0,0
Morgan HENTZ,United States,Libero,Women,Dominican Republic,2022-06-01,Pool,3,3,0,0,0,0,0,0,0,0,0,0,0,0,0,10,0,3,13,15,0,1,16,0,0,13,13
Tetori DIXON,United States,Middle Blocker,Women,Dominican Republic,2022-06-01,Pool,3,3,6,5,1,5,11,0,4,6,10,1,0,10,11,0,0,1,1,0,0,0,0,0,0,2,2
Lauren CARLINI,United States,Setter,Women,Dominican Republic,2022-06-01,Pool,3,3,3,3,1,3,7,0,2,0,2,0,1,13,14,0,0,1,1,12,2,0,14,23,0,46,69
Madison Kingdon RISHEL,United States,Outside Hitter,Women,Dominican Republic,2022-06-01,Pool,3,3,0,0,0,0,0,0,0,0,0,0,0,0,0,0,0,0,0,0,0,0,0,0,0,0,0
Brionne BUTLER,United States,Middle Blocker,Women,Dominican Republic,2022-06-01,Pool,3,3,0,0,0,0,0,0,0,0,0,0,0,0,0,0,0,0,0,0,0,0,0,0,0,0,0
Andrea DREWS,United States,Opposite Spiker,Women,Dominican Republic,2022-06-01,Pool,3,3,0,0,0,0,0,0,0,0,0,0,0,0,0,0,0,0,0,0,0,0,0,0,0,0,0
Jordan THOMPSON,United States,Opposite Spiker,Women,Dominican Republic,2022-06-01,Pool,3,3,15,13,1,14,28,1,3,4,8,1,2,10,13,0,0,0,0,6,6,0,12,0,0,2,2
Sarah WILHITE,United States,Outside Hitter,Women,Dominican Republic,2022-06-01,Pool,3,3,15,10,5,11,26,3,1,1,5,2,1,16,19,8,0,6,14,10,3,0,13,0,0,2,2
Dana RETTKE,United States,Middle Blocker,Women,Dominican Republic,2022-06-01,Pool,3,3,6,3,2,3,8,3,4,3,10,0,2,5,7,1,0,1,2,1,0,0,1,0,0,0,0
Kara BAJEMA,United States,Outside Hitter,Women,Dominican Republic,2022-06-01,Pool,3,3,0,0,0,0,0,0,0,0,0,0,0,0,0,0,0,0,0,0,0,0,0,0,0,0,0
Jenna GRAY,United States,Setter,Women,Dominican Republic,2022-06-01,Pool,3,3,0,0,0,0,0,0,0,0,0,0,0,0,0,0,0,0,0,0,0,0,0,0,0,0,0
Kendall WHITE,United States,Libero,Women,Dominican Republic,2022-06-01,Pool,3,3,0,0,0,0,0,0,0,0,0,0,0,0,0,0,0,0,0,0,0,0,0,0,0,0,0
Alexandra FRANTTI,United States,Outside Hitter,Women,Dominican Republic,2022-06-01,Pool,3,3,15,13,6,8,27,2,0,2,4,0,1,8,9,15,0,8,23,6,0,0,6,0,0,2,2
Anna STEVENSON,United States,Middle Blocker,Women,Dominican Republic,2022-06-01,Pool,3,3,0,0,0,0,0,0,0,0,0,0,0,0,0,0,0,0,0,0,0,0,0,0,0,0,0
